segmentnr	original	folio	stemmed
BO_TZ_Terdzo-OM-P3:0	@#// gsang 'dus thod phreng rtshal gyi sgos sgrub dang 'brel ba zlum po bzhi dbang bzhugs so //	0	gsang du thod phreng rtshal gyi sgos sgrub dang brel ba zlum po bzhi dbang bzhugs so 
BO_TZ_Terdzo-OM-P3:1	na mahpad+ma badzra ya /	0	na mahpad+ma badzra ya 
BO_TZ_Terdzo-OM-P3:2	gang gi mtshhan tsham thos pas kyang //	0	gang gi mtshhan tsham thos ba kyang 
BO_TZ_Terdzo-OM-P3:3	srid zhi'i mtha' las rnam grol ba'i //	0	srid zhi mtha las rnam grol ba 
BO_TZ_Terdzo-OM-P3:4	bde chen mchog stshol thod phreng rtshal //	0	bde chen mchog stshol thod phreng rtshal 
BO_TZ_Terdzo-OM-P3:5	kun 'dus rgyal ba de la 'dud //	0	kun du rgyal ba de la dud 
BO_TZ_Terdzo-OM-P3:6	'dir thugs sgrub gsang ba 'dus pa las khyad par thod phreng rtshal rtsha ba'i sgrub thabs dang 'brel bar dbang bskur ba'i tshhul la gsum ste /	0	dir thugs sgrub gsang ba du ba las khyad ba thod phreng rtshal rtsha ba sgrub thabs dang brel ba dbang skur ba tshhul la gsum ste 
BO_TZ_Terdzo-OM-P3:7	sbyor ba yo byad kyi bsham dang / dngos gzhi sgrub thabs dang / dbang gi cho ga'o //	0	sbyor ba yo byad kyi bsham dang dngos gzhi sgrub thabs dang dbang gi cho ga 
BO_TZ_Terdzo-OM-P3:8	dang po yo byad kyi bsham ni /	0	dang po yo byad kyi bsham ni 
BO_TZ_Terdzo-OM-P3:9	rdul tshhon gyi man+dal bcas pa'am /     byin gyis brlabs pa'i thig tshhon gyis dkyil 'khor lte ba mthing ga ze'u 'bru ljang gu pad 'dab bzhi phyogs mdog rin chen zur brgyad mthing ga gzhi dmar ser phyi skor pad 'dab bcu drug rdor ra me	0	rdul tshhon gyi man+dal cha ba byin gyis brlabs ba thig tshhon gyis dkyil khor lte ba mthing ga zeu bru ljang gu pad dab bzhi phyogs mdog rin chen zur brgyad mthing ga gzhi dmar ser phyi skor pad dab chu drug rdar ra me 
BO_TZ_Terdzo-OM-P3:10	ri dang bcas pa'o /mchan /	1	ri dang cha ba 
BO_TZ_Terdzo-OM-P3:11	stegs bu khebs ldan me tog gi tshhom bu bkod pa'i steng du bum pa bcud ldan /	1	stegs bu khebs ldan me tog gi tshhom bu bkod ba steng du bum ba bcud ldan 
BO_TZ_Terdzo-OM-P3:12	de'i khar bdud rtshi'i thod pa me long sin+d+hu ra'i thig le lha grangs can rtsha sngags bris pas bkab pa dang / de'i steng du gtor ma sku 'bag   dbang gi skabs 'di dang lha bskyed bcas sgrub dus ltar rdor sems cha lugs bya /mchan /dang bcas pa'ang bkod /	1	de khar bdud rtshi thod ba me long sin+d+hu ra thig le lha grangs can rtsha sngags bri ba gebs ba dang de steng du thor ma sku bag dbang gi skabs di dang lha skyed cha sgrub dus ltar rdar sems cha lugs byed cha ba bkod 
BO_TZ_Terdzo-OM-P3:13	mi bde na gtor ma mdun du gzhag	1	mi bde na thor ma mdun du jog 
BO_TZ_Terdzo-OM-P3:14	/de dag gi g.yas g.yon du sman dang rak+ta /	1	dag gi g.yas g.yon du sman dang rak+ta 
BO_TZ_Terdzo-OM-P3:15	nyer spyod lnga sogs mchod pas mtha' bskor /	1	nyer spyod lnga sogs mchod ba mtha skor 
BO_TZ_Terdzo-OM-P3:16	'og tu dgos pa'i yo byad thams cad kyang tshhogs par bya'o //	1	g tu dgos ba yo byad thams cad kyang tshhogs ba byed 
BO_TZ_Terdzo-OM-P3:17	//gnyis pa dngos gzhi sgrub thabs las sngon 'gro ni /	1	ba dngos gzhi sgrub thabs las sngon gro ni 
BO_TZ_Terdzo-OM-P3:18	bgegs gtor byin gyis brlabs nas sngags kyis bsngos la /	1	bgegs thor byin gyis brlabs nas sngags kyis sngo la 
BO_TZ_Terdzo-OM-P3:19	hu~m: bla ma rnams kyi byin rlabs dang : yi dam lha yi ting 'dzin dang : mkha' 'gro rnams kyi mthu rtshal gyis :	1	hu~m: bla ma rnams kyi byin rlabs dang yi dam lha yi ting dzin dang mkha gro rnams kyi mthu rtshal gyis 
BO_TZ_Terdzo-OM-P3:20	dngos grub bar chad byed pa'i bgegs :	2	dngos grub ba chad byed ba bgegs 
BO_TZ_Terdzo-OM-P3:21	log par 'dren pa bdud kyi tshhogs :	2	log ba bgrang ba bdud kyi tshhogs 
BO_TZ_Terdzo-OM-P3:22	'di ru ma 'dug gzhan du dengs :	2	di ru ma dug gzhan du dengs 
BO_TZ_Terdzo-OM-P3:23	hu~m: nga ni ye nas ngang gis khro :	2	hu~m: nga ni ye nas ngang gis khro 
BO_TZ_Terdzo-OM-P3:24	mtshhams gcod khro bos nam mkha' gang :	2	mtshhams gcod khro bod nam mkha gang 
BO_TZ_Terdzo-OM-P3:25	bgegs 'dul khro bo'i rol mtshhams las :	2	bgegs dul khro bo rol mtshhams las 
BO_TZ_Terdzo-OM-P3:26	su yang 'da' bar ma byed cig :	2	su yang da ba ma byed cig 
BO_TZ_Terdzo-OM-P3:27	a+o~m ahhu~m hrihgu ru de ba da ki ni badzra kro d+ha rak+sha rak+sha hu~m phat:	2	a+o~m ahhu~m hrihgu ru de ba da ki ni badzra kro d+ha rak+sha rak+sha hu~m phat: 
BO_TZ_Terdzo-OM-P3:28	ces bka' bsgos la mtshhams bcad /	2	ces bka sgo la mtshhams gcod 
BO_TZ_Terdzo-OM-P3:29	skyabs 'gro ni /	2	skyob gro ni 
BO_TZ_Terdzo-OM-P3:30	na mo : bla ma bde gshegs 'dus pa'i sku :	3	na mo bla ma bde gshegs du ba sku 
BO_TZ_Terdzo-OM-P3:31	dkon mchog gsum gyi rang bzhin la :	3	dkon(d) mchog gsum gyi rang bzhin la 
BO_TZ_Terdzo-OM-P3:32	bdag dang 'gro drug sems can rnams :	3	bdag dang gro drug sems can rnams 
BO_TZ_Terdzo-OM-P3:33	byang chub bar du skyabs su mchi :	3	byang chub ba du skyob su mchi 
BO_TZ_Terdzo-OM-P3:34	sems bskyed pa ni /	3	sems skyed ba ni 
BO_TZ_Terdzo-OM-P3:35	sems bskyed 'gro ba kun don du :	3	sems skyed gro ba kun don du 
BO_TZ_Terdzo-OM-P3:36	bla ma sangs rgyas bsgrubs nas su :	3	bla ma sangs rgya sgrub nas su 
BO_TZ_Terdzo-OM-P3:37	gang la gang 'dul phrin las kyis :	3	gang la gang dul phrin las kyis 
BO_TZ_Terdzo-OM-P3:38	'gro ba bsgral bar dam bca' 'o :	3	gro ba bsgral ba dam chos mang 
BO_TZ_Terdzo-OM-P3:39	zhes pa'i rjes su mchod rdzas byin rlabs gsang 'dus las byang bzhin nam /	3	zhes ba rjes su mchod rdzas byin rlabs gsang du las byang bzhin nam 
BO_TZ_Terdzo-OM-P3:40	yang na / ram yam kham gis bsregs sbyangs bkrus /	4	yang na ram yam kham gis bsregs sbyong khrud 
BO_TZ_Terdzo-OM-P3:41	snying ga nas ahyig gsum 'phros sman gtor rak+ta'i gnas su ka pa la gsum du gyur pa'i nang du a+o~m gsum 'phros pa las sman bdud rtshi'i rgya mtshho dang gtor ma 'dod yon lnga'i phung po dang rak+ta khrag gi rgya mtshho rnams su gyur /	4	snying ga nas ahyig gsum phro sman thor rak+ta gnas su ka ba la gsum du gyur ba nang du a+o~m gsum phro ba las sman bdud rtshi rgya mtshho dang thor ma dod yon lnga phung po dang rak+ta khrag gi rgya mtshho rnams su gyur 
BO_TZ_Terdzo-OM-P3:42	hu~m 'phros pas mgron rnams 'dus par bsam la 'bru gsum mang du brjod par bya'o //	4	hu~m phro ba mgron rnams du ba bsam la bru gsum mang du rjod ba byed 
BO_TZ_Terdzo-OM-P3:43	dngos gzhi las lha bskyed pa ni /	4	dngos gzhi las lha skyed ba ni 
BO_TZ_Terdzo-OM-P3:44	a+o~m/ chos rnams dmigs med spros bral las //	4	chos rnams dmigs med spros bral las 
BO_TZ_Terdzo-OM-P3:45	kun khyab brtshe ba'i snying rje bsgom //	4	kun khyab brtshe ba snying rje bsgom 
BO_TZ_Terdzo-OM-P3:46	rang rig rdo rje hrihbcas gsal //	4	rang rig rdo rje hrihbcas gsal 
BO_TZ_Terdzo-OM-P3:47	rdo rje b+h+ru~m gyur gzhal yas khang //	4	rdo rje b+h+ru~m gyur jal yas khang 
BO_TZ_Terdzo-OM-P3:48	pad+ma rin chen 'od 'bar dbus //	4	pad+ma rin chen d bar dbus 
BO_TZ_Terdzo-OM-P3:49	ti ra nyi zla pad+ma'i steng //	4	ti ra nyi zla pad+ma steng 
BO_TZ_Terdzo-OM-P3:50	bdag nyid dbang chen yab yum sku //	5	bdag nyid dbang chen yab yum sku 
BO_TZ_Terdzo-OM-P3:51	zhal gcig phyag gnyis sku mdog dmar //	5	zhal gcig phyag gnyis sku mdog dmar 
BO_TZ_Terdzo-OM-P3:52	dbu gtshug rta zhal phag gdong mtshhan //	5	dbu gtshug rta zhal phag gdong mtshhan 
BO_TZ_Terdzo-OM-P3:53	g.yas g.yon gri gug thod khrag bsnams //	5	g.yas g.yon gri gug thod khrag snom 
BO_TZ_Terdzo-OM-P3:54	zhabs gnyis brkyang bskum 'khril sbyor tshhul //	5	zhabs gnyis rkyong skum khril sbyor tshhul 
BO_TZ_Terdzo-OM-P3:55	dur khrod rol pa'i chas rnams rdzogs //	5	dur khrod rol ba cha rnams rdzogs 
BO_TZ_Terdzo-OM-P3:56	spyi gtshug pad sdong nyi zla'i steng //	5	spyi gtshug pad sdong nyi zla steng 
BO_TZ_Terdzo-OM-P3:57	rje btshun pad+ma thod phreng rtshal /	5	rje btshun pad+ma thod phreng rtshal 
BO_TZ_Terdzo-OM-P3:58	/a tshar gzhon tshhul dkar dmar zhal //	5	tshar gzhon tshhul dkar dmar zhal 
BO_TZ_Terdzo-OM-P3:59	mthing nag zab ber chos gos dmar //	5	mthing nag zab ber chos gos dmar 
BO_TZ_Terdzo-OM-P3:60	pad zhwa sgro dar me long mtshhan //	6	pad zhwa sgro dar me long mtshhan 
BO_TZ_Terdzo-OM-P3:61	phyag g.yas rdo rje g.yon b+han+d+ha //	6	phyag g.yas rdo rje g.yon b+han+d+ha 
BO_TZ_Terdzo-OM-P3:62	snyan cha mgur chu kha t+wam 'dzin //	6	snyan cha mgur chu kha t+wam dzin 
BO_TZ_Terdzo-OM-P3:63	skyil krung gzi brjid 'od 'bar bsam //	6	skyil krung gzi brjid d bar bsam 
BO_TZ_Terdzo-OM-P3:64	phyogs bzhir pad 'dab mkha' 'gro ging //	6	phyogs bzhir pad dab mkha gro ging 
BO_TZ_Terdzo-OM-P3:65	rdo rje rin chen pad+ma las //	6	rdo rje rin chen pad+ma las 
BO_TZ_Terdzo-OM-P3:66	rigs kyi sku mdog phyag mtshhan 'dzin //	6	rigs kyi sku mdog phyag mtshhan dzin 
BO_TZ_Terdzo-OM-P3:67	brkyang bskum dur khrod chas rdzogs bsam //	6	rkyong skum dur khrod cha rdzogs bsam 
BO_TZ_Terdzo-OM-P3:68	rig 'dzin mkha' 'gro dam can tshhogs //	6	rig dzin mkha gro dam can tshhogs 
BO_TZ_Terdzo-OM-P3:69	bsam gyis mi khyab yongs rdzogs gtibs //	6	bsam gyis mi khyab yongs rdzogs gtibs 
BO_TZ_Terdzo-OM-P3:70	sku gsung thugs su byin rlabs la //	7	sku gsung thugs su byin rlabs la 
BO_TZ_Terdzo-OM-P3:71	ye shes lnga yi dbang rdzogs shog	7	ye shes lnga yi dbang rdzogs shog 
BO_TZ_Terdzo-OM-P3:72	/yang sgrub dus kyi dbang du na /	7	sgrub dus kyi dbang du na 
BO_TZ_Terdzo-OM-P3:73	a tshar gzhon tshhul zhes pa nas /	7	a tshar gzhon tshhul zhes ba nas 
BO_TZ_Terdzo-OM-P3:74	'od 'bar bsam /	7	d bar bsam 
BO_TZ_Terdzo-OM-P3:75	zhes pa'i bar gyi rkang pa drug gi dod du /	7	zhes ba ba gyi rkang ba drug gi dod du 
BO_TZ_Terdzo-OM-P3:76	rdo rje sems dpa'i cha lugs can :	7	rdo rje sems dpa cha lugs can 
BO_TZ_Terdzo-OM-P3:77	mthing nag zhal gcig phyag gnyis pa :	7	mthing nag zhal gcig phyag gnyis ba 
BO_TZ_Terdzo-OM-P3:78	gcer bu spyan gsum rus rgyan can :	7	bcer bu spyan gsum rus rgyan can 
BO_TZ_Terdzo-OM-P3:79	phyag g.yas rdo rje thugs kar 'dzin :	7	phyag g.yas rdo rje thugs kar dzin 
BO_TZ_Terdzo-OM-P3:80	phyag g.yon dril bu dku la brten :	8	phyag g.yon dril bu dku la rten 
BO_TZ_Terdzo-OM-P3:81	pad mdog ye shes mkha' 'gro yum //	8	pad mdog ye shes mkha gro yum 
BO_TZ_Terdzo-OM-P3:82	bdud rtshi stob pa g.yon nas 'khril //	8	bdud rtshi stob ba g.yon nas khril 
BO_TZ_Terdzo-OM-P3:83	zhes bsgyur ro //	8	zhes sgyur ro 
BO_TZ_Terdzo-OM-P3:84	spyan 'dren pa ni /	8	spyan bgrang ba ni 
BO_TZ_Terdzo-OM-P3:85	hu~m: o rgyan yul gyi nub byang mtshhams :	8	hu~m: o rgyan yul gyi nub byang mtshhams 
BO_TZ_Terdzo-OM-P3:86	zhes sogs nas /	8	zhes sogs nas 
BO_TZ_Terdzo-OM-P3:87	a+o~m gu ru pad+ma sid+d+hi hu~m:	8	a+o~m gu ru pad+ma sid+d+hi hu~m: 
BO_TZ_Terdzo-OM-P3:88	zhes tshhig bdun mas spyan drangs la /	8	zhes tshhig bdun mas spyan drangs la 
BO_TZ_Terdzo-OM-P3:89	dzahhu~m bam hos dbyer med du bya'o //	8	dzahhu~m bam hos dbyer med du byed 
BO_TZ_Terdzo-OM-P3:90	mchod pa ni /	9	mchod ba ni 
BO_TZ_Terdzo-OM-P3:91	hu~m: pad+ma thod phreng gshegs su gsol :	9	hu~m: pad+ma thod phreng gshegs su gsol 
BO_TZ_Terdzo-OM-P3:92	gdung ba drag pos bdag gsol 'debs :	9	gdung ba drag pos bdag gsol debs 
BO_TZ_Terdzo-OM-P3:93	mkha' 'gro'i tshhogs dang bcas pa la :	9	mkha gro tshhogs dang cha ba la 
BO_TZ_Terdzo-OM-P3:94	'dod yon lnga ldan mchod pa 'bul :	9	dod yon lnga ldan mchod ba bul 
BO_TZ_Terdzo-OM-P3:95	ba lim gtor ma'i mchod pa 'bul :	9	ba lim thor ma mchod ba bul 
BO_TZ_Terdzo-OM-P3:96	bdud rtshi sman gyi mchod pa 'bul :	9	bdud rtshi sman gyi mchod ba bul 
BO_TZ_Terdzo-OM-P3:97	rak+ta dmar gyi mchod pa 'bul :	9	rak+ta dmar gyi mchod ba bul 
BO_TZ_Terdzo-OM-P3:98	zhal zas tshhogs kyi mchod pa 'bul :	9	zhal zas tshhogs kyi mchod ba bul 
BO_TZ_Terdzo-OM-P3:99	ting 'dzin rtshe gcig mchod pa 'bul :	9	ting dzin rtshe gcig mchod ba bul 
BO_TZ_Terdzo-OM-P3:100	sku gsung thugs kyi dngos grub stshol :	10	sku gsung thugs kyi dngos grub stshol 
BO_TZ_Terdzo-OM-P3:101	ho : dam rdzas mchog gi mchod pa 'di dag kun :	10	ho dam rdzas mchog gi mchod ba di dag kun 
BO_TZ_Terdzo-OM-P3:102	gnyis med mnyam pa'i ngang du 'bul lags na :	10	gnyis med mnyam ba ngang du bul lags na 
BO_TZ_Terdzo-OM-P3:103	blang dor med pa'i tshhul gyis bzhes nas kyang :	10	blang dor med ba tshhul gyis bzhes nas kyang 
BO_TZ_Terdzo-OM-P3:104	thim pa'i tshhul gyis dgyes pa chen por rol :	10	thim ba tshhul gyis dgyes ba chen por rol 
BO_TZ_Terdzo-OM-P3:105	a+o~m ahhu~m badzra gu ru de ba da ki ni ma ha ba lim ta kha hi :	10	a+o~m ahhu~m badzra gu ru de ba da ki ni ma ha ba lim ta kha hi 
BO_TZ_Terdzo-OM-P3:106	ma ha pany+tsha a mr-ita kha hi :	10	ma ha pany+tsha a mr-ita kha hi 
BO_TZ_Terdzo-OM-P3:107	ma ha rak+ta kha hi :	10	ma ha rak+ta kha hi 
BO_TZ_Terdzo-OM-P3:108	ma ha ga na tshakra sarba pu dza me g+ha kha hi :	10	ma ha ga na tshakra sarba pu dza me g+ha kha hi 
BO_TZ_Terdzo-OM-P3:109	zhes mchod / hu~m:	10	zhes mchod hu~m: 
BO_TZ_Terdzo-OM-P3:110	skye 'gag 'gyur med sku gsung thugs dang ldan :	11	skye gag gyur med sku gsung thugs dang ldan 
BO_TZ_Terdzo-OM-P3:111	rang byung thugs rjes 'gro rnams bsgral slad du :	11	rang byung thugs rjes gro rnams bsgral slad du 
BO_TZ_Terdzo-OM-P3:112	phrin las rnam bzhis gdul bya'i re ba skong :	11	phrin las rnam bzhis gdul byed re ba skong 
BO_TZ_Terdzo-OM-P3:113	pad+ma thod phreng rtshal la phyag 'tshhal bstod :	11	pad+ma thod phreng rtshal la phyag tshhal bstod 
BO_TZ_Terdzo-OM-P3:114	ces pa'am / ma bcos spros bral ma gang bde bya'o //	11	ces ba ma chos spros bral ma gang bde byed 
BO_TZ_Terdzo-OM-P3:115	dzapa? bzla ba ni /	11	dzapa? bzla ba ni 
BO_TZ_Terdzo-OM-P3:116	bla ma'i gnas bzhir a+o~m ahhu~m hrihrnams gsal ba las byang sems bdud rtshi'i rgyun babs pa spyi bo nas zhugs /	11	bla ma gnas bzhir a+o~m ahhu~m hrihrnams gsal ba las byang sems bdud rtshi rgyun bab ba spyi bo nas jug 
BO_TZ_Terdzo-OM-P3:117	spyi mgrin snying lte rnams su dbang bzhi thob bde ba chen po'i ye shes nyams su myong ba la sems rtshe gcig pas /	11	spyi mgrin snying lte rnams su dbang bzhi thob bde ba chen po ye shes nyams su myong ba la sems rtshe gcig ba 
BO_TZ_Terdzo-OM-P3:118	a+o~m ahhu~m badzra gu ru pad+ma thod phreng rtshal badzra sa ma ya dzahsid+d+hi pha la hu~m a:	11	a+o~m ahhu~m badzra gu ru pad+ma thod phreng rtshal badzra sa ma ya dzahsid+d+hi pha la hu~m a: 
BO_TZ_Terdzo-OM-P3:119	zhes ci nus bzlas pa'i mthar bla ma rang la bstims nas sku'i gsal snang dang nga rgyal brtan pos kyang sngar bzhin bzla'o //	11	zhes ci nus bzlas ba mthar bla ma rang la stim nas sku gsal snang dang nga rgyal brtan pos kyang sngar bzhin bzla 
BO_TZ_Terdzo-OM-P3:120	gsum pa rjes la tshhogs kyi mchod pa ni /	12	gsum ba rjes la tshhogs kyi mchod ba ni 
BO_TZ_Terdzo-OM-P3:121	gsang 'dus las byang sogs ris mthun gyi cho ga gang 'os nas blang zhing /	12	gsang du las byang sogs ris mthun gyi cho ga gang s nas blang zhing 
BO_TZ_Terdzo-OM-P3:122	gnam skas klu bdud sogs gter srung mchod pa'ang bya'o //	12	gnam skas klu bdud sogs gter srung mchod ba byed 
BO_TZ_Terdzo-OM-P3:123	dngos grub blang ba ni /	12	dngos grub blang ba ni 
BO_TZ_Terdzo-OM-P3:124	gu ru'i gnas gsum nas dngos grub 'od zer gyi rnam pas sgrub rdzas la bstims te rtsha sngags mthar ka ya wa ka tshit+ta sarba sid+d+hi hu~m/	12	gu ru gnas gsum nas dngos grub d zer gyi rnam ba sgrub rdzas la stim te rtsha sngags mthar ka ya wa ka tshit+ta sarba sid+d+hi 
BO_TZ_Terdzo-OM-P3:125	zhes ci rigs bzlas nas /	12	zhes ci rigs bzlas nas 
BO_TZ_Terdzo-OM-P3:126	a+o~m: bde mchog bde spyod nam mkha'i dkyil yangs nas :	12	a+o~m: bde mchog bde spyod nam mkha dkyil yangs nas 
BO_TZ_Terdzo-OM-P3:127	rgyal ba'i dkyil 'khor sras bcas thugs dam can :	12	rgyal ba dkyil khor sras cha thugs dam can 
BO_TZ_Terdzo-OM-P3:128	badzra gu ru pad+ma thod phreng gi :	12	badzra gu ru pad+ma thod phreng gi 
BO_TZ_Terdzo-OM-P3:129	sku gsung thugs dang mnyam sbyor dngos grub stshol :	12	sku gsung thugs dang mnyam sbyor dngos grub stshol 
BO_TZ_Terdzo-OM-P3:130	ces dngos grub blang zhing rdzas la rol /	13	ces dngos grub blang zhing rdzas la rol 
BO_TZ_Terdzo-OM-P3:131	gtor ma gtang /	13	thor ma gtong 
BO_TZ_Terdzo-OM-P3:132	dkyil 'khor rang la bsdus nas 'od gsal du bcug	13	dkyil khor rang la sdud nas d gsal du jug 
BO_TZ_Terdzo-OM-P3:133	/bsngo smon shis brjod kyis mtha' brgyan par bya'o //	13	smon shis rjod kyis mtha rgyan ba byed 
BO_TZ_Terdzo-OM-P3:134	! //gsum pa byin rlabs kyi cho ga ni zlum po bzhi dbang du grags pa ste /	13	ba byin rlabs kyi cho ga ni zlum po bzhi dbang du grags ba ste 
BO_TZ_Terdzo-OM-P3:135	sbyor ba yo byad bsham pa ni sngar ltar las man+dal me tog sogs khyad par gyi rdzas rnams tshhogs par bshams /	13	sbyor ba yo byad bsham ba ni sngar ltar las man+dal me tog sogs khyad ba gyi rdzas rnams tshhogs ba bshams 
BO_TZ_Terdzo-OM-P3:136	sgrub tshhul bdag mdun dbyer med du bsgoms la bzlas pa yan chad sngar ltar byas nas /	13	sgrub tshhul bdag mdun dbyer med du sgom la bzlas ba yan chad sngar ltar byed nas 
BO_TZ_Terdzo-OM-P3:137	bum pa gzhal yas khang du bum bcud gu ru yab yum snyoms par zhugs pa'i byang sems bdud rtshir 'khyil bar bsam la rtsha sngags mthar pa sham ku ru sarba sid+d+hi hu~m a:	13	bum ba jal yas khang du bum bcud gu ru yab yum snyom ba jug ba byang sems bdud rtshir khyil ba bsam la rtsha sngags mthar ba sham ku ru sarba sid+d+hi hu~m a: 
BO_TZ_Terdzo-OM-P3:138	zhes btags pa gzungs thag la brten nas ci rigs pa bzla /	13	zhes dogs ba gzungs thag la rten nas ci rigs ba bzla 
BO_TZ_Terdzo-OM-P3:139	gter srung la gtor ma phul /	13	gter srung la thor ma bul 
BO_TZ_Terdzo-OM-P3:140	tshhogs mchod ni 'dir ram dbang gi mtha' gang 'os su bya /	14	tshhogs mchod ni dir ram dbang gi mtha gang s su byed 
BO_TZ_Terdzo-OM-P3:141	'og gi slob ma'i bya ba rnams ltar bdag 'jug ting nge 'dzin dbang bskur gyi tshhul du len pa'am rig pa'i me tog dor ba gang 'os bya'o //	14	g gi slob ma byed ba rnams ltar bdag jug ting nge dzin dbang skur gyi tshhul du len ba rig ba me tog dor ba gang s byed 
BO_TZ_Terdzo-OM-P3:142	dngos gzhi slob ma'i bya ba ni /	14	dngos gzhi slob ma byed ba ni 
BO_TZ_Terdzo-OM-P3:143	gnas khang gi sgor khrus bya /	14	gnas khang gi sgor khru byed 
BO_TZ_Terdzo-OM-P3:144	bgegs gtor btang nas mtshhams bcad /	14	bgegs thor gtong nas mtshhams gcod 
BO_TZ_Terdzo-OM-P3:145	las kyi rdo rjes me tog bkye bsdu rnams byas la /	14	las kyi rdo rjes me tog gyed sdud rnams byed la 
BO_TZ_Terdzo-OM-P3:146	slob dpon gyis 'di skad ces brjod de /	14	slob dpon gyis di skad ces rjod de 
BO_TZ_Terdzo-OM-P3:147	'o nam mkha' dang mnyam pa'i sems can thams cad kyi don du rnam pa thams cad mkhyen pa sangs rgyas kyi go 'phang 'thob par bya /	14	mang nam mkha dang mnyam ba sems can thams cad kyi don du rnam ba thams cad mkhyen ba sangs rgya kyi go phen thob ba byed 
BO_TZ_Terdzo-OM-P3:148	de'i ched du bla ma rdo rje thod phreng rtshal gyi byin rlabs dbang bskur ba zab mo zhu snyam pa'i mos pa brtan pos ma yengs par gsan pa zhu /	14	de ched du bla ma rdo rje thod phreng rtshal gyi byin rlabs dbang skur ba zab mo ju snyam ba mos ba brtan pos ma yengs ba gsan ba ju 
BO_TZ_Terdzo-OM-P3:149	de yang rang cag gi ston pa thabs mkhas la thugs rje chen po dang ldan pa des /	14	de yang rang cag gi ston ba thabs mkhas la thugs rje chen po dang ldan ba des 
BO_TZ_Terdzo-OM-P3:150	gdul bya rnams bla na med pa'i byang chub kyi go 'phang la 'god par mdzad pa'i thabs kyi sgo bsam gyis mi khyab pa zhig bstan pa rnams kyi mchog tu gyur pa ni lam zab mo bla ma sgrub pa nyid yin te /	15	gdul byed rnams bla na med ba byang chub kyi go phen la god ba mdzad ba thabs kyi sgo bsam gyis mi khyab ba jig ston ba rnams kyi mchog tu gyur ba ni lam zab mo bla ma sgrub ba nyid yin te 
BO_TZ_Terdzo-OM-P3:151	dgongs 'dus las /	15	dgongs du las 
BO_TZ_Terdzo-OM-P3:152	bskal pa stong gi sangs rgyas bas //	15	bskal ba stong gi sangs rgya ba 
BO_TZ_Terdzo-OM-P3:153	bla ma gnyan par shes par bya //	15	bla ma gnyan ba shes ba byed 
BO_TZ_Terdzo-OM-P3:154	ci phyir zhe na bskal pa yi //	15	ci phyir zhe na bskal ba yi 
BO_TZ_Terdzo-OM-P3:155	sangs rgyas ma lus thams cad kun //	15	sangs rgya ma lus thams cad kun 
BO_TZ_Terdzo-OM-P3:156	bla ma dag la bsten nas byung //	15	bla ma dag la sten nas byung 
BO_TZ_Terdzo-OM-P3:157	zhes dang / he badzra las /	15	zhes dang he badzra las 
BO_TZ_Terdzo-OM-P3:158	gzhan gyis brjod min lhan cig skyes //	15	gzhan gyis rjod min lhan cig skye 
BO_TZ_Terdzo-OM-P3:159	gang du yang ni mi rnyed de //	15	gang du yang ni mi rnyed de 
BO_TZ_Terdzo-OM-P3:160	bla ma'i dus thabs bstan pa dang // bdag gi bsod nams las shes bya //	16	bla ma dus thabs ston ba dang bdag gi bsod nams las shes byed 
BO_TZ_Terdzo-OM-P3:161	zhes sogs rgya cher gsungs pa ltar dngos grub thams cad kyi rtsha bar gyur pa ni bla ma sgrub pa nyid yin la /	16	zhes sogs rgya cher gsungs ba ltar dngos grub thams cad kyi rtsha ba gyur ba ni bla ma sgrub ba nyid yin la 
BO_TZ_Terdzo-OM-P3:162	de nyid sgrub pa'i sgo bsam gyis mi khyab pa zhig mchis pa las /	16	de nyid sgrub ba sgo bsam gyis mi khyab ba jig mchis ba las 
BO_TZ_Terdzo-OM-P3:163	khyad par dus gsum sangs rgyas thams cad kyi spyi gzugs o rgyan gyi slob dpon chen po pad+ma 'byung gnas zhes bya ba /	16	khyad ba dus gsum sangs rgya thams cad kyi spyi gzugs o rgyan gyi slob dpon chen po pad+ma byung gnas zhes byed ba 
BO_TZ_Terdzo-OM-P3:164	bskal pa dpag tu med pa'i gong rol nas kun bzang chos kyi skur mngon par rdzogs pa sangs rgyas nas longs spyod rdzogs sku snang ba mtha' yas la sogs pa'i rnam par bzhugs pa las /	16	bskal ba dpog tu med ba gong rol nas kun bzang chos kyi skur mngon ba rdzogs ba sangs rgya nas longs spyod rdzogs sku snang ba mtha yas la sogs ba rnam ba bzhugs ba las 
BO_TZ_Terdzo-OM-P3:165	zhing 'dir gdul bya'i 'gro ba rnams kyi don du sprul pa'i sgyu 'phrul mtha' yas par snang bar mdzad cing /	16	zhing dir gdul byed gro ba rnams kyi don du sprul ba sgyu phrul mtha yas ba snang ba mdzad cing 
BO_TZ_Terdzo-OM-P3:166	khyad par rgya gar dang o rgyan bod yul la sogs par thub pa'i dbang po'i bstan pa la ston pa nyid dang rnam dbyer med pa'i phrin las rnam pa bzhi'i rdzu 'phrul gyi bkod pa bsam gyis mi khyab pas 'khor ba ji srid bar bzhugs nas yid bzhin	16	khyad ba rgya gar dang o rgyan bod yul la sogs ba thub ba dbang po ston ba la ston ba nyid dang rnam dbyer med ba phrin las rnam ba bzhi rdzu phrul gyi bkod ba bsam gyis mi khyab ba khor ba ji srid ba bzhugs nas yid bzhin 
BO_TZ_Terdzo-OM-P3:167	gyi nor bu rin po che lta bu'i don lhun grub tu mdzad pa'i gu ru rin po che de nyid la /	16	gyi nor bu rin po che lta bu don lhun grub tu mdzad ba gu ru rin po che de nyid la 
BO_TZ_Terdzo-OM-P3:168	las can rje 'bangs rnams kyis gsol ba btab pa la brten nas zab rgyas kyi gdams pa khyad par can bsam gyis mi khyab pa zhig bstshal pa /	16	las can rje bang rnams kyis gsol ba debs ba la rten nas zab rgya kyi doms ba khyad ba can bsam gyis mi khyab ba jig bstshal ba 
BO_TZ_Terdzo-OM-P3:169	snyigs dus kyi gdul bya skal ldan rnams kyi don du gter kha du mar sbas pa las /	16	snyigs dus kyi gdul byed skal ldan rnams kyi don du gter kha du mar sbed ba las 
BO_TZ_Terdzo-OM-P3:170	'di ni gter ston chen po chos kyi dbang phyug gis lho brag gnam skas brag nas spyan drangs pa bla ma gsang ba 'dus pa'i skor te /	17	di ni gter ston chen po chos kyi dbang phyug gis lho brag gnam skas brag nas spyan drangs ba bla ma gsang ba du ba skor te 
BO_TZ_Terdzo-OM-P3:171	de yang gter ston nyid nas sras slob brgyud pa'i khyad par gnyis dang ldan pa drin can bla ma dam pa'i bar rim par brgyud pa dang / rdor gling zab gter gyi gsang ba 'dus pa'i skor yang bla ma nyid kyis gsan pa 'di dang tshhig don mtshhungs pa'i phyir chu bo gcig 'dres su yang 'gyur zhing /	17	de yang gter ston nyid nas sras slob brgyud ba khyad ba gnyis dang ldan ba drin can bla ma dam ba ba rim ba brgyud ba dang rdar gling zab gter gyi gsang ba du ba skor yang bla ma nyid kyis gsan ba di dang tshhig don mtshhungs ba phyir chu bo gcig dre su yang gyur zhing 
BO_TZ_Terdzo-OM-P3:172	gang ltar yang rtsha brgyud kyi bla ma dam pa de thams cad kyis thugs nyams su bstar ba las mchog gi sa la bzhugs pa sha stag bar ma chad du byon pa lags /	17	gang ltar yang rtsha brgyud kyi bla ma dam ba de thams cad kyis thugs nyams su bstar ba las mchog gi sa la bzhugs ba sha stag ba ma chad du byon ba lags 
BO_TZ_Terdzo-OM-P3:173	brgyud pa de las byung ba'i gdams pa 'di nyid kyi dbang du byas na /	17	brgyud ba de las byung ba doms ba di nyid kyi dbang du byed na 
BO_TZ_Terdzo-OM-P3:174	bka' gtshigs las /	17	bka gtshigs las 
BO_TZ_Terdzo-OM-P3:175	bla ma'i sgrub thabs mos gus chos mang gi :	17	bla ma sgrub thabs mos gus chos mang gi 
BO_TZ_Terdzo-OM-P3:176	rang dang dbyer med sgrub pa 'di na mchis :	17	rang dang dbyer med sgrub ba di na mchis 
BO_TZ_Terdzo-OM-P3:177	de gang zhe na bla ma gsang 'dus skor :	17	de gang zhe na bla ma gsang du skor 
BO_TZ_Terdzo-OM-P3:178	mthar thug yin no snying gi dkyil du chongs :	17	mthar thug yin no snying gi dkyil du chongs 
BO_TZ_Terdzo-OM-P3:179	zhes dang / nga sgrub sangs rgyas thams cad 'grub :	17	zhes dang nga sgrub sangs rgya thams cad grub 
BO_TZ_Terdzo-OM-P3:180	nga mthong sangs rgyas thams cad mthong :	18	nga mthong sangs rgya thams cad mthong 
BO_TZ_Terdzo-OM-P3:181	nga ni bde gshegs 'dus pa yin :	18	nga ni bde gshegs du ba yin 
BO_TZ_Terdzo-OM-P3:182	zhes gsungs pa ltar /	18	zhes gsungs ba ltar 
BO_TZ_Terdzo-OM-P3:183	spyir gter kha 'di la bla ma sgrub pa'i bka' babs shing khyad par du 'phags par gsungs pa'i mtshhan gzhi yang bla ma gsang ba 'dus pa'i skor 'di nyid yin la /	18	spyir gter kha di la bla ma sgrub ba bka bab shing khyad ba du phag ba gsungs ba mtshhan gzhi yang bla ma gsang ba du ba skor di nyid yin la 
BO_TZ_Terdzo-OM-P3:184	de'i nang nas kyang rtsha ba lta bur gyur pa thod phreng rtshal sgos sgrub dang 'brel ba zlum po bzhi'i dbang bskur du grags pa ste /	18	de nang nas kyang rtsha ba lta bur gyur ba thod phreng rtshal sgos sgrub dang brel ba zlum po bzhi dbang skur du grags ba ste 
BO_TZ_Terdzo-OM-P3:185	rig 'dzin 'dus pa rtsha ba'i rgyud las /	18	rig dzin du ba rtsha ba brgyud las 
BO_TZ_Terdzo-OM-P3:186	rdul tshhon me long bum pa dang // gtor ma la sogs rdzas dag la //	18	rdul tshhon me long bum ba dang thor ma la sogs rdzas dag la 
BO_TZ_Terdzo-OM-P3:187	brten nas mtshhan nyid kun ldan pa'i //	18	rten nas mtshhan nyid kun ldan ba 
BO_TZ_Terdzo-OM-P3:188	bla ma'i byin rlabs dbang bskur na //	18	bla ma byin rlabs dbang skur na 
BO_TZ_Terdzo-OM-P3:189	dkyil 'khor kun gyi snying po mchog	18	dkyil khor kun gyi snying po mchog 
BO_TZ_Terdzo-OM-P3:190	/bzhi pa'i de nyid dbang bzhi thob //	19	ba de nyid dbang bzhi thob 
BO_TZ_Terdzo-OM-P3:191	ces gsungs pa ltar sgrub par byed pa yin la /	19	ces gsungs ba ltar sgrub ba byed ba yin la 
BO_TZ_Terdzo-OM-P3:192	de la slob dpon gyi bya ba rnams sngon du song /	19	de la slob dpon gyi byed ba rnams sngon du gro 
BO_TZ_Terdzo-OM-P3:193	khyed rang rnams kyi ngo skal du gyur pa la byin rlabs dbang bskur zab mo zhu ba'i yon du man+dal 'bul ba zhu zhes brjod /	19	khyed rang rnams kyi ngo skal du gyur ba la byin rlabs dbang skur zab mo ju ba yon du man+dal bul ba ju zhes rjod 
BO_TZ_Terdzo-OM-P3:194	slob mas kyang man+dal phul /	19	slob mas kyang man+dal bul 
BO_TZ_Terdzo-OM-P3:195	a+o~m tshak+shurban+d+ha ba ra ma na ya swa has mig dar bcings /	19	a+o~m tshak+shurban+d+ha ba ra ma na ya swa has mig dar ching 
BO_TZ_Terdzo-OM-P3:196	a kham bi ras me tog gtad la /   phyag len bsdus pa'i skabs mig dar 'ching grol dang me tog gtod 'bul mi mdzad /mchan /	19	a kham bi ras me tog gtod la phyag len sdud ba skabs mig dar ching grol dang me tog gtod bul mi mdzad 
BO_TZ_Terdzo-OM-P3:197	de nas gsol ba 'debs pa 'di'i rjes zlos mdzod /	19	de nas gsol ba debs ba di rjes zlos mdzod 
BO_TZ_Terdzo-OM-P3:198	rdo rje slob dpon dgongs su gsol :	19	rdo rje slob dpon dgongs su gsol 
BO_TZ_Terdzo-OM-P3:199	bdag ming 'di zhes bya ba gu ru thod phreng rtshal gyi dbang dang byin rlabs la 'jug pas :	19	bdag ming di zhes byed ba gu ru thod phreng rtshal gyi dbang dang byin rlabs la jug ba 
BO_TZ_Terdzo-OM-P3:200	rdo rje thod phreng rtshal dgongs su gsol :	20	rdo rje thod phreng rtshal dgongs su gsol 
BO_TZ_Terdzo-OM-P3:201	bdag gi las dang nyon mongs pa thams cad dag par byin gyis brlab tu gsol :	20	bdag gi las dang nyon mongs ba thams cad dag ba byin gyis brlab tu gsol 
BO_TZ_Terdzo-OM-P3:202	khams gsum 'khor ba las dbugs dbyung ba dang : gzengs gtod pa dang : 'khor ba'i rgya mtshho chen po las bsgral bar byin gyis brlab tu gsol :	20	khams gsum khor ba las dbugs byin ba dang gzengs gtod ba dang khor ba rgya mtshho chen po las bsgral ba byin gyis brlab tu gsol 
BO_TZ_Terdzo-OM-P3:203	rang rig ye shes rtogs pa dang 'gro ba'i ded dpon du dbang bskur du gsol :	20	rang rig ye shes rtogs ba dang gro ba ded dpon du dbang skur du gsol 
BO_TZ_Terdzo-OM-P3:204	zhes lan gsum gyis gsol ba btab /	20	zhes lan gsum gyis gsol ba debs 
BO_TZ_Terdzo-OM-P3:205	de nas skyabs sems dang sdom pa gzung ba ni /	20	de nas skyob sems dang sdom ba gzung ba ni 
BO_TZ_Terdzo-OM-P3:206	bla ma dang dkyil 'khor gyi gtsho bo gnyis su med pa'i steng gi cha la brgyud pa'i bla ma rnams dang mtha' skor du yi dam dkyil 'khor gyi lha tshhogs sangs rgyas dang byang sems dpa' bo rnal 'byor ma'i tshhogs thams cad sprin phung gtibs pa bzhin bzhugs	20	bla ma dang dkyil khor gyi gtsho bo gnyis su med ba steng gi cha la brgyud ba bla ma rnams dang mtha skor du yi dam dkyil khor gyi lha tshhogs sangs rgya dang byang sems dpa bo rnal byor ma tshhogs thams cad sprin phung gtibs ba bzhin bzhugs 
BO_TZ_Terdzo-OM-P3:207	par bsam la /	20	ba bsam la 
BO_TZ_Terdzo-OM-P3:208	bdag gzhan sems can thams cad byang chub ma 'thob kyi bar du skyabs su mchi'o snyam pa'i sgo nas 'di'i rjes zlos mdzod /	20	bdag gzhan sems can thams cad byang chub ma thob kyi ba du skyob su mchi snyam ba sgo nas di rjes zlos mdzod 
BO_TZ_Terdzo-OM-P3:209	na mo : bla ma bde gshegs 'dus pa'i sku :	20	na mo bla ma bde gshegs du ba sku 
BO_TZ_Terdzo-OM-P3:210	sogs lan gsum /	21	sogs lan gsum 
BO_TZ_Terdzo-OM-P3:211	sems can thams cad sangs rgyas kyi go 'phang la 'god par bya /	21	sems can thams cad sangs rgya kyi go phen la god ba byed 
BO_TZ_Terdzo-OM-P3:212	de'i ched du lam zab mo bla ma'i dkyil 'khor du zhugs nas nyams su blang bar bgyi'o snyam pas 'di'i rjes zlos mdzod /	21	de ched du lam zab mo bla ma dkyil khor du jug nas nyams su blang ba bgyid snyam ba di rjes zlos mdzod 
BO_TZ_Terdzo-OM-P3:213	sems bskyed 'gro ba kun don du :	21	sems skyed gro ba kun don du 
BO_TZ_Terdzo-OM-P3:214	sogs lan gsum /	21	sogs lan gsum 
BO_TZ_Terdzo-OM-P3:215	de nas rtsha ba'i dam tshhig gzung ba zhes pa ni sdom gzung ste dam tshhig dang sdom pa'ang ldog pas phye ba tsham ste don du bsgrub bya spong ba dang dgag bya sgrub pa gnyis 'gog pa'i sems ni sdom pa dang / rdo rje 'dzin pa'i bslab pa'i mtha' las mi 'da' ba ni dam tshhig yin pas /	21	de nas rtsha ba dam tshhig gzung ba zhes ba ni sdom gzung ste dam tshhig dang sdom ba ldog ba byed ba tsham ste don du sgrub byed spong ba dang gog byed sgrub ba gnyis gog ba sems ni sdom ba dang rdo rje dzin ba bslab ba mtha las mi da ba ni dam tshhig yin ba 
BO_TZ_Terdzo-OM-P3:216	de'i don du sngar gyi skyabs yul rnams kyi spyan sngar tshhig phyir sems rtshe gcig pas 'di'i rjes zlos mdzod /	21	de don du sngar gyi skyob yul rnams kyi spyan sngar tshhig phyir sems rtshe gcig ba di rjes zlos mdzod 
BO_TZ_Terdzo-OM-P3:217	na mo : bla ma sangs rgyas 'khor dang bcas :	21	na mo bla ma sangs rgya khor dang cha 
BO_TZ_Terdzo-OM-P3:218	kun nas bdag la dgongs su gsol :	21	kun nas bdag la dgongs su gsol 
BO_TZ_Terdzo-OM-P3:219	bla ma dkon mchog rnam gsum po :	21	bla ma dkon(d) mchog rnam gsum po 
BO_TZ_Terdzo-OM-P3:220	byang chub ma 'thob bar du ni :	22	byang chub ma thob ba du ni 
BO_TZ_Terdzo-OM-P3:221	skyabs kyi mchog tu gzung bar bgyi :	22	skyob kyi mchog tu gzung ba bgyid 
BO_TZ_Terdzo-OM-P3:222	sngon nas bsags pa'i sdig sgrib bshags :	22	sngon nas bsags ba sdig sgrib chags 
BO_TZ_Terdzo-OM-P3:223	'gro don sangs rgyas 'thob bya snyam :	22	gro don sangs rgya thob byed snyam 
BO_TZ_Terdzo-OM-P3:224	smon pa'i byang chub sems bskyed cing :	22	smon ba byang chub sems skyed cing 
BO_TZ_Terdzo-OM-P3:225	sems can yongs su smin bya'i phyir :	22	sems can yongs su smin byed phyir 
BO_TZ_Terdzo-OM-P3:226	'jug pa'i byang chub sems bskyed de :	22	jug ba byang chub sems skyed de 
BO_TZ_Terdzo-OM-P3:227	gsang sngags spyod pa rlabs chen spyad :	22	gsang sngags spyod ba rlabs chen spyod 
BO_TZ_Terdzo-OM-P3:228	don dam spros bral byang chub sems :	22	don dam spros bral byang chub sems 
BO_TZ_Terdzo-OM-P3:229	rang byung mtha' bral stong gsal sgom :	22	rang byung mtha bral stong gsal sgom 
BO_TZ_Terdzo-OM-P3:230	zhes lan gsum /	23	zhes lan gsum 
BO_TZ_Terdzo-OM-P3:231	de nas ye shes dbab pa ni /	23	de nas ye shes bebs ba ni 
BO_TZ_Terdzo-OM-P3:232	khyed rang rnams lus gnad skyil krung drang por srongs /	23	khyed rang rnams lus gnad skyil krung dren por srongs 
BO_TZ_Terdzo-OM-P3:233	rlung kha sbyor du bzung nas dmigs pa 'di ltar mdzod /	23	rlung kha sbyor du bzung nas dmigs ba di ltar mdzod 
BO_TZ_Terdzo-OM-P3:234	snying gar sems gzung 'dzin gnyis su med pa'i ye shes kyi rang mdangs bla ma rdo rje 'chang yab yum dwangs gsal 'od kyi sku can du gsal ba'i thugs kar g.yung drung dmar po'i lte bar zla ba la yam dang yan lag bzhi la ha ri ni sas	23	snying gar sems gzung dzin gnyis su med ba ye shes kyi rang mdangs bla ma rdo rje chang yab yum dwangs gsal d kyi sku can du gsal ba thugs kar g.yung drung dmar po lte ba zla ba la yam dang yan lag bzhi la ha ri ni sas 
BO_TZ_Terdzo-OM-P3:235	mtshhan par gyur /	23	mtshhan ba gyur 
BO_TZ_Terdzo-OM-P3:236	slob dpon gyis yam zhes brjod pas slob ma'i snying ga'i yam bskul rlung g.yos g.yung drung g.yon du shugs drag por 'khor ba la sems gtad /	23	slob dpon gyis yam zhes rjod ba slob ma snying ga yam skul rlung g.yos g.yung drung g.yon du shugs drag por khor ba la sems gtod 
BO_TZ_Terdzo-OM-P3:237	de'i tshhe ye shes pa sku dang yig 'bru phyag mtshhan gyi rnam pa can 'od zer gyi phung por 'bar ba kha char bu yug 'tshhubs pa bzhin du byon nas khyed rang rnams la sib sib thim par gyur snyam pa'i mos pa gyis zhes brda sbyar la /	23	de tshhe ye shes ba sku dang yig bru phyag mtshhan gyi rnam ba can d zer gyi phung por bar ba kha char bu yug tshhubs ba bzhin du byon nas khyed rang rnams la sib sib thim ba gyur snyam ba mos ba gyis zhes brda sbyor la 
BO_TZ_Terdzo-OM-P3:238	rtsha sngags kyi mthar dz+nya na a be sha ya a ah	23	rtsha sngags kyi mthar dz+nya na a be sha ya a ah 
BO_TZ_Terdzo-OM-P3:239	zhes btags pa bzla zhing rol mo dang bcas pas byin phab /	23	zhes dogs ba bzla zhing rol mo dang cha ba byin bebs 
BO_TZ_Terdzo-OM-P3:240	des ma phebs na slar yang /	24	des ma phebs na slar yang 
BO_TZ_Terdzo-OM-P3:241	a+o~m ahhu~m hrihhu~m hu~m ahhu~m:	24	a+o~m ahhu~m hrihhu~m hu~m ahhu~m: 
BO_TZ_Terdzo-OM-P3:242	bzhengs shig rje btshun pad+ma bzhengs :	24	bzhengs shig rje btshun pad+ma bzhengs 
BO_TZ_Terdzo-OM-P3:243	dgongs shig bla ma slob dpon dgongs :	24	dgongs shig bla ma slob dpon dgongs 
BO_TZ_Terdzo-OM-P3:244	rig 'dzin gnas nas sku skyod la :	24	rig dzin gnas nas sku skyod la 
BO_TZ_Terdzo-OM-P3:245	byin gyis brlab phyir gshegs su gsol :	24	byin gyis brlab phyir gshegs su gsol 
BO_TZ_Terdzo-OM-P3:246	gnas mchog 'di ru byin phob la :	24	gnas mchog di ru byin phob la 
BO_TZ_Terdzo-OM-P3:247	sgrub mchog bdag la dbang bzhi skur :	24	sgrub mchog bdag la dbang bzhi skur 
BO_TZ_Terdzo-OM-P3:248	bgegs dang log 'dren bar chad sol :	24	bgegs dang log bgrang ba chad sol 
BO_TZ_Terdzo-OM-P3:249	mchog dang thun mong dngos grub stshol :	24	mchog dang thun mong dngos grub stshol 
BO_TZ_Terdzo-OM-P3:250	bzhengs shig yi dam lha tshhogs bzhengs :	25	bzhengs shig yi dam lha tshhogs bzhengs 
BO_TZ_Terdzo-OM-P3:251	dgongs shig rgyal ba rigs lnga'i tshhogs :	25	dgongs shig rgyal ba rigs lnga tshhogs 
BO_TZ_Terdzo-OM-P3:252	chos kyi dbyings nas sku skyod la :	25	chos kyi dbyings nas sku skyod la 
BO_TZ_Terdzo-OM-P3:253	byin gyis brlab phyir gshegs su gsol :	25	byin gyis brlab phyir gshegs su gsol 
BO_TZ_Terdzo-OM-P3:254	gnas mchog 'di ru byin phob la :	25	gnas mchog di ru byin phob la 
BO_TZ_Terdzo-OM-P3:255	sgrub mchog bdag la dbang bzhi skur :	25	sgrub mchog bdag la dbang bzhi skur 
BO_TZ_Terdzo-OM-P3:256	bgegs dang log 'dren bar chad sol :	25	bgegs dang log bgrang ba chad sol 
BO_TZ_Terdzo-OM-P3:257	mchog dang thun mong dngos grub stshol :	25	mchog dang thun mong dngos grub stshol 
BO_TZ_Terdzo-OM-P3:258	bzhengs shig ye shes mkha' 'gro bzhengs :	25	bzhengs shig ye shes mkha gro bzhengs 
BO_TZ_Terdzo-OM-P3:259	dgongs shig da ki sde lnga'i tshhogs :	25	dgongs shig da ki sde lnga tshhogs 
BO_TZ_Terdzo-OM-P3:260	dur khrod gnas nas sku skyod la :	26	dur khrod gnas nas sku skyod la 
BO_TZ_Terdzo-OM-P3:261	byin gyis brlab phyir gshegs su gsol :	26	byin gyis brlab phyir gshegs su gsol 
BO_TZ_Terdzo-OM-P3:262	gnas mchog 'di ru byin phob la :	26	gnas mchog di ru byin phob la 
BO_TZ_Terdzo-OM-P3:263	sgrub mchog bdag la dbang bzhi skur :	26	sgrub mchog bdag la dbang bzhi skur 
BO_TZ_Terdzo-OM-P3:264	bgegs dang log 'dren bar chad sol :	26	bgegs dang log bgrang ba chad sol 
BO_TZ_Terdzo-OM-P3:265	mchog dang thun mong dngos grub stshol :	26	mchog dang thun mong dngos grub stshol 
BO_TZ_Terdzo-OM-P3:266	rgyas par / a+o~m:	26	rgya ba a+o~m: 
BO_TZ_Terdzo-OM-P3:267	sku yis byin gyis rlob tu gsol :   nyang gter phag mo zhal gnyis ma ltar /mchan /sogs kyang brjod cing /	26	sku yis byin gyis rlob tu gsol nyang gter phag mo zhal gnyis ma ltar kyang rjod cing 
BO_TZ_Terdzo-OM-P3:268	byi la nag po'i brun /	26	byi la nag po brun 
BO_TZ_Terdzo-OM-P3:269	pad+ma rak+ta / sha chen /	26	pad+ma rak+ta sha chen 
BO_TZ_Terdzo-OM-P3:270	gu gul / klad pa /	27	gu gul klad ba 
BO_TZ_Terdzo-OM-P3:271	bdud rtshi lnga /	27	bdud rtshi lnga 
BO_TZ_Terdzo-OM-P3:272	rang gi skra rnams bsregs pa'i dud pas bdug cing rol mo'i sgra yun ring du bya'o //	27	rang gi skra rnams bsregs ba dud ba bdug cing rol mo sgra yun ring du byed 
BO_TZ_Terdzo-OM-P3:273	de'i tshhe sku phebs na 'phar g.yo /	27	de tshhe sku phebs na phar g.yo 
BO_TZ_Terdzo-OM-P3:274	gsung phebs na smra rgod /	27	gsung phebs na smra rgod 
BO_TZ_Terdzo-OM-P3:275	thugs phebs na brjod med kyi rtogs pa skye zhing /	27	thugs phebs na rjod med kyi rtogs ba skye zhing 
BO_TZ_Terdzo-OM-P3:276	nyams thod rgal du 'bar na de nyid skyong du bcug	27	nyams thod rgal du bar na de nyid skyong du jug 
BO_TZ_Terdzo-OM-P3:277	/tish+tha badzra zhes spyi bor rdo rje bzhag pas brtan par byin gyis brlabs /	27	badzra zhes spyi bor rdo rje jog ba brtan ba byin gyis brlabs 
BO_TZ_Terdzo-OM-P3:278	a+o~m pra titsh+tshha badzra hoh	27	a+o~m pra titsh+tshha badzra hoh 
BO_TZ_Terdzo-OM-P3:279	zhes pas me tog 'bul du bcug la rigs ngos gzung /	27	zhes ba me tog bul du jug la rigs ngos gzung 
BO_TZ_Terdzo-OM-P3:280	pra ti gr-ih+na i mam satwa ma ha ba la /	28	pra ti gr-ih+na i mam satwa ma ha ba la 
BO_TZ_Terdzo-OM-P3:281	zhes me tog slob ma'i mgo bor bcings /	28	zhes me tog slob ma mgo bor ching 
BO_TZ_Terdzo-OM-P3:282	a+o~m dz+nya na tshak+shuhpra be sha ya phat/	28	a+o~m dz+nya na tshak+shuhpra be sha ya 
BO_TZ_Terdzo-OM-P3:283	ces mig dar bsal /	28	ces mig dar bsal 
BO_TZ_Terdzo-OM-P3:284	rten dang brten pa'i dkyil 'khor thams cad bstan la lha ngo sprad /	28	rten dang rten ba dkyil khor thams cad ston la lha ngo sprod 
BO_TZ_Terdzo-OM-P3:285	de nas dbang dngos gzhi'i don du man+dal phul la /	28	de nas dbang dngos gzhi don du man+dal bul la 
BO_TZ_Terdzo-OM-P3:286	gsol ba 'debs pa 'di'i rjes zlos mdzod /	28	gsol ba debs ba di rjes zlos mdzod 
BO_TZ_Terdzo-OM-P3:287	bla ma sangs rgyas dgongs su gsol :	28	bla ma sangs rgya dgongs su gsol 
BO_TZ_Terdzo-OM-P3:288	ji ltar sngon gyi sangs rgyas rnams :	28	ji ltar sngon gyi sangs rgya rnams 
BO_TZ_Terdzo-OM-P3:289	bla ma'i rjes gnang dbang thob nas :	28	bla ma rjes gnang dbang thob nas 
BO_TZ_Terdzo-OM-P3:290	sangs rgyas sa la gshegs pa ltar :	29	sangs rgya sa la gshegs ba ltar 
BO_TZ_Terdzo-OM-P3:291	de rjes bdag kyang 'jug par 'tshhal :	29	de rjes bdag kyang jug ba tshhal 
BO_TZ_Terdzo-OM-P3:292	bdag la dbang bskur mdzad du gsol :	29	bdag la dbang skur mdzad du gsol 
BO_TZ_Terdzo-OM-P3:293	zhes lan gsum gsol ba btab la me tog 'thor /	29	zhes lan gsum gsol ba debs la me tog thor 
BO_TZ_Terdzo-OM-P3:294	de nas dbang bskur ba dngos ni /	29	de nas dbang skur ba dngos ni 
BO_TZ_Terdzo-OM-P3:295	'di ltar bum pa la sogs pa'i dbang rdzas lnga po re re bzhin yang gnas gsum du bzhag nas mthar tshhig don ngo sprod rnams rim pa bzhin dbang bzhi'i bdag nyid can du bskur ba la rnam pa nyi shus byang chub pa zhes bya ba yin la /	29	di ltar bum ba la sogs ba dbang rdzas lnga po re re bzhin yang gnas gsum du jog nas mthar tshhig don ngo sprod rnams rim ba bzhin dbang bzhi bdag nyid can du skur ba la rnam ba nyi shus byang chub ba zhes byed ba yin la 
BO_TZ_Terdzo-OM-P3:296	de la dang po bum pas dbang bskur ba ni /	29	de la dang po bum ba dbang skur ba ni 
BO_TZ_Terdzo-OM-P3:297	bla ma dang dkyil 'khor gyi lha dbyer ma mchis pas 'di ltar dbang rnams rim bzhin bskur ba las spang bya'i dri ma rnams dag cing 'thob bya'i yon tan thams cad thob par gyur snyam pa'i mos pa mdzod /	29	bla ma dang dkyil khor gyi lha dbyer ma mchis ba di ltar dbang rnams rim bzhin skur ba las spong byed dri ma rnams dag cing thob byed yon tan thams cad thob ba gyur snyam ba mos ba mdzod 
BO_TZ_Terdzo-OM-P3:298	a+o~m: bum pa spros bral zlum po na :	29	a+o~m: bum ba spros bral zlum po na 
BO_TZ_Terdzo-OM-P3:299	skye med byang chub sems kyi chus :	29	skye med byang chub sems kyi chus 
BO_TZ_Terdzo-OM-P3:300	rnam rtog ma rig dri ma bkru :	30	rnam rtogs ma rig dri ma khrud 
BO_TZ_Terdzo-OM-P3:301	chos sku spros bral bde chen chus :	30	chos sku spros bral bde chen chus 
BO_TZ_Terdzo-OM-P3:302	gzung 'dzin 'khor ba'i bag chags bkru :	30	gzung dzin khor ba bag chags khrud 
BO_TZ_Terdzo-OM-P3:303	rang byung ye shes sems nyid chus :	30	rang byung ye shes sems nyid chus 
BO_TZ_Terdzo-OM-P3:304	dug lnga dug gsum dri ma bkru :	30	dug lnga dug gsum dri ma khrud 
BO_TZ_Terdzo-OM-P3:305	nyon mongs bag chags kun byang nas :	30	nyon mongs bag chags kun byang nas 
BO_TZ_Terdzo-OM-P3:306	dbang bzhi'i ye shes rdzogs par shog :	30	dbang bzhi ye shes rdzogs ba shog 
BO_TZ_Terdzo-OM-P3:307	a+o~m ahhu~m badzra gu ru pad+ma thod phreng rtshal badzra sa ma ya dzahsid+d+hi pha la hu~m a:	30	a+o~m ahhu~m badzra gu ru pad+ma thod phreng rtshal badzra sa ma ya dzahsid+d+hi pha la hu~m a: 
BO_TZ_Terdzo-OM-P3:308	gu ru de ba da ki ni ka ya wa ka tshit+ta a b+hi shiny+tsha a+o~m ahhu~m hrih	30	gu ru de ba da ki ni ka ya wa ka tshit+ta a b+hi shiny+tsha a+o~m ahhu~m hrih 
BO_TZ_Terdzo-OM-P3:309	zhes lan gsum brjod /	30	zhes lan gsum rjod 
BO_TZ_Terdzo-OM-P3:310	dang po spyi bor bzhag nas khrus byas pa bum dbang /	31	dang po spyi bor jog nas khru byed ba bum dbang 
BO_TZ_Terdzo-OM-P3:311	gnyis pa mgrin par gtad nas bum chu blud pa gsang dbang /	31	gnyis ba mgrin ba gtod nas bum chu blud ba gsang dbang 
BO_TZ_Terdzo-OM-P3:312	snying gar gtad nas tshhig don ngo sprad pa ni /	31	snying gar gtod nas tshhig don ngo sprod ba ni 
BO_TZ_Terdzo-OM-P3:313	sems nyid spros pa thams cad dang bral ba mtshhon pa'i bum pa zlum po de /	31	sems nyid spros ba thams cad dang bral ba mtshhon ba bum ba zlum po de 
BO_TZ_Terdzo-OM-P3:314	skye med rtogs pa don dam mtshhon byed chus bkang ste dbang bskur pas /	31	skye med rtogs ba don dam mtshhon byed chus geng ste dbang skur ba 
BO_TZ_Terdzo-OM-P3:315	dug gsum bag chags dang bcas pa dag par shes pa ni shes rab ye shes kyi dbang /	31	dug gsum bag chags dang cha ba dag ba shes ba ni shes rab ye shes kyi dbang 
BO_TZ_Terdzo-OM-P3:316	des bde gsal mi rtog pa'i nyams skyes pa ni dbang bzhi pa'o //	31	des bde gsal mi rtogs ba nyams skye ba ni dbang bzhi ba 
BO_TZ_Terdzo-OM-P3:317	gnyis pa gsang ba'i dbang ni /	31	gnyis ba gsang ba dbang ni 
BO_TZ_Terdzo-OM-P3:318	thod pa spyi bor bzhag la /	31	thod ba spyi bor jog la 
BO_TZ_Terdzo-OM-P3:319	a: thod pa zlum po chos kyi dbyings kyi ngang :	31	a: thod ba zlum po chos kyi dbyings kyi ngang 
BO_TZ_Terdzo-OM-P3:320	'chi med bdud rtshi chang gis rab tu bkang :	32	chi med bdud rtshi chang gis rab tu geng 
BO_TZ_Terdzo-OM-P3:321	sha lnga bdud rtshi rigs lnga ye shes lnga :	32	sha lnga bdud rtshi rigs lnga ye shes lnga 
BO_TZ_Terdzo-OM-P3:322	nyon mongs bdud 'joms rigs lnga sku lngar bskyed :	32	nyon mongs bdud joms rigs lnga sku lngar skyed 
BO_TZ_Terdzo-OM-P3:323	gnyis med ngang du chos nyid rol par sbyor :	32	gnyis med ngang du chos nyid rol ba sbyor 
BO_TZ_Terdzo-OM-P3:324	ma bcos rang byung bde chen byang chub sems :	32	ma chos rang byung bde chen byang chub sems 
BO_TZ_Terdzo-OM-P3:325	chos nyid bdud rtshi rnam rtog bdud las rgyal :	32	chos nyid bdud rtshi rnam rtogs bdud las rgyal 
BO_TZ_Terdzo-OM-P3:326	dbang bzhi'i ye shes rdzogs pa'i dbang thob shog :	32	dbang bzhi ye shes rdzogs ba dbang thob shog 
BO_TZ_Terdzo-OM-P3:327	rtsha sngags lan gsum brjod la /	32	rtsha sngags lan gsum rjod la 
BO_TZ_Terdzo-OM-P3:328	dang po thod pa spyi bor bzhag pa bum dbang /	32	dang po thod ba spyi bor jog ba bum dbang 
BO_TZ_Terdzo-OM-P3:329	gnyis pas mgrin par gtad nas bdud rtshi blud pa gsang dbang /	32	gnyis ba mgrin ba gtod nas bdud rtshi blud ba gsang dbang 
BO_TZ_Terdzo-OM-P3:330	snying gar gtad nas tshhig don ngo sprad pa ni /	33	snying gar gtod nas tshhig don ngo sprod ba ni 
BO_TZ_Terdzo-OM-P3:331	sems chos dbyings thig le nyag gcig mtshhon pa'i thod pa zlum po'i nang du /	33	sems chos dbyings thig le nyag gcig mtshhon ba thod ba zlum po nang du 
BO_TZ_Terdzo-OM-P3:332	gzhi nyon mongs pa lnga ngo bo sha lnga bdud rtshi lnga ye shes lnga rang rig pa sku lnga'i bdag nyid 'chi med kyi go 'phang brnyes pa mtshhon byed bdud rtshis bkang ste dbang bskur pas /	33	gzhi nyon mongs ba lnga ngo bo sha lnga bdud rtshi lnga ye shes lnga rang rig ba sku lnga bdag nyid chi med kyi go phen brnyes ba mtshhon byed bdud rtshis geng ste dbang skur ba 
BO_TZ_Terdzo-OM-P3:333	mtshhan 'dzin gyi rnam rtog dag par shes pa ni shes rab ye shes kyi dbang /	33	mtshhan dzin gyi rnam rtogs dag ba shes ba ni shes rab ye shes kyi dbang 
BO_TZ_Terdzo-OM-P3:334	des bde gsal mi rtog pa'i nyams skyes pa ni dbang bzhi pa'o //	33	des bde gsal mi rtogs ba nyams skye ba ni dbang bzhi ba 
BO_TZ_Terdzo-OM-P3:335	gsum pa me long gi dbang ni /	33	gsum ba me long gi dbang ni 
BO_TZ_Terdzo-OM-P3:336	hu~m: me long zlum po chos dbyings dri ma med :	33	hu~m: me long zlum po chos dbyings dri ma med 
BO_TZ_Terdzo-OM-P3:337	dag cing gsal la rnyog pa med par dwangs :	33	dag cing gsal la rnyog ba med ba dwangs 
BO_TZ_Terdzo-OM-P3:338	gzugs brnyan gsal la ngos gzung 'dzin pa bral :	33	gzugs rnyan gsal la ngos gzung dzin ba bral 
BO_TZ_Terdzo-OM-P3:339	sems nyid rnam dag gsal la mi 'gag pa :	33	sems nyid rnam dag gsal la mi gag ba 
BO_TZ_Terdzo-OM-P3:340	gzung 'dzin mtshhan ma'i dngos po'i yul las 'das :	34	gzung dzin mtshhan ma dngos po yul las da 
BO_TZ_Terdzo-OM-P3:341	byang chub sems kyi cho 'phrul cir yang snang :	34	byang chub sems kyi cho phrul cir yang snang 
BO_TZ_Terdzo-OM-P3:342	gsal stong ma 'gags dbyings nas gsal 'grib med :	34	gsal stong ma gag dbyings nas gsal grib med 
BO_TZ_Terdzo-OM-P3:343	dbang bzhi'i ye shes rdzogs pa'i dbang thob shog :	34	dbang bzhi ye shes rdzogs ba dbang thob shog 
BO_TZ_Terdzo-OM-P3:344	rtsha sngags brjod pas spyi bor bzhag	34	rtsha sngags rjod ba spyi bor jog 
BO_TZ_Terdzo-OM-P3:345	/mgrin par 'jog pa dang mnyam du slob dpon gyi snying ga nas sngags kyi phreng ba thon pa zhal gyi sgo nas slob ma'i khar zhugs snying ga'i sa bon la thim par bsgom du bcug nas sngags kyi rjes zlos lan gsum byas la /	34	ba jog ba dang mnyam du slob dpon gyi snying ga nas sngags kyi phreng ba thon ba zhal gyi sgo nas slob ma khar jug snying ga sa bon la thim ba bsgom du jug nas sngags kyi rjes zlos lan gsum byed la 
BO_TZ_Terdzo-OM-P3:346	me long spyi bor bzhag pa bum dbang /	34	me long spyi bor jog ba bum dbang 
BO_TZ_Terdzo-OM-P3:347	mgrin par gtad nas sngags kyi rjes gnang sbyin pa gsang dbang /	34	mgrin ba gtod nas sngags kyi rjes gnang sbyin ba gsang dbang 
BO_TZ_Terdzo-OM-P3:348	snying gar bzhag nas rig pa gsal la ma 'gags par ngo sprad pa ni /	34	snying gar jog nas rig ba gsal la ma gag ba ngo sprod ba ni 
BO_TZ_Terdzo-OM-P3:349	sems nyid chos sku dri med mtshhon byed me long g.ya' dag zlum po la /	34	sems nyid chos sku dri med mtshhon byed me long g.ya dag zlum po la 
BO_TZ_Terdzo-OM-P3:350	kun rdzob sgyu ma lta bu dang rnam kun mchog ldan stong nyid kyi gzugs brnyan cir yang shar ba mtshhon byed tshhom bu sngags bcas kyis brgyan pas dbang bskur pas /	35	kun rdzob sgyu ma lta bu dang rnam kun mchog ldan stong nyid kyi gzugs rnyan cir yang char ba mtshhon byed tshhom bu sngags cha kyis rgyan ba dbang skur ba 
BO_TZ_Terdzo-OM-P3:351	gsal ba la stong pas rgyas thebs par shes pa shes rab ye shes kyi dbang /	35	gsal ba la stong ba rgya thebs ba shes ba shes rab ye shes kyi dbang 
BO_TZ_Terdzo-OM-P3:352	sems bde gsal mi rtog pa'i nyams skyes pa ni dbang bzhi pa'o //	35	sems bde gsal mi rtogs ba nyams skye ba ni dbang bzhi ba 
BO_TZ_Terdzo-OM-P3:353	bzhi pa gtor ma'i dbang ni /	35	bzhi ba thor ma dbang ni 
BO_TZ_Terdzo-OM-P3:354	hri: gtor snod b+han+d+ha gzhal yas chos kyi dbyings :	35	hri: thor snod b+han+d+ha jal yas chos kyi dbyings 
BO_TZ_Terdzo-OM-P3:355	gtor ma 'dod yon rnam lnga ye shes lnga :	35	thor ma dod yon rnam lnga ye shes lnga 
BO_TZ_Terdzo-OM-P3:356	gu ru'i sku mchog bde chen 'du 'bral med :	35	gu ru sku mchog bde chen du bral med 
BO_TZ_Terdzo-OM-P3:357	rnam dag bdud rtshi bla ma mchod pa'i rdzas :	35	rnam dag bdud rtshi bla ma mchod ba rdzas 
BO_TZ_Terdzo-OM-P3:358	gnyis med dbyings su dam tshhig gnyan po bsre :	35	gnyis med dbyings su dam tshhig gnyan po bsre 
BO_TZ_Terdzo-OM-P3:359	ma mo mkha' 'gro dbang du bsdu ba dang : phrin las rnam bzhis 'gro ba 'dul slad du :	35	ma mo mkha gro dbang du sdud ba dang phrin las rnam bzhis gro ba dul slad du 
BO_TZ_Terdzo-OM-P3:360	sprul pa mang po las la 'gyed pa'i phyir :	36	sprul ba mang po las la gyed ba phyir 
BO_TZ_Terdzo-OM-P3:361	dbang bzhi'i ye shes rdzogs pa'i dbang thob shog :	36	dbang bzhi ye shes rdzogs ba dbang thob shog 
BO_TZ_Terdzo-OM-P3:362	sngags brjod bzhin du gtor ma spyi bor bzhag pa bum dbang /	36	sngags rjod bzhin du thor ma spyi bor jog ba bum dbang 
BO_TZ_Terdzo-OM-P3:363	mgrin par gtad nas gtor zan myang ba gsang dbang /	36	mgrin ba gtod nas thor zan myang ba gsang dbang 
BO_TZ_Terdzo-OM-P3:364	snying gar gtad de tshhig don ngo sprad pa ni /	36	snying gar gtod de tshhig don ngo sprod ba ni 
BO_TZ_Terdzo-OM-P3:365	sems nyid chos kyi dbyings ris su ma chad pa mtshhon pa'i gtor snod b+hany+dza zlum po'i nang du /	36	sems nyid chos kyi dbyings ris su ma chad ba mtshhon ba thor snod b+hany+dza zlum po nang du 
BO_TZ_Terdzo-OM-P3:366	gang shar thams cad bde chen du rang rig pa gu ru'i sku dang 'dod yon rnam lnga ye shes lnga'i rang bzhin du rnam par dag pa bdud rtshi'i mchod rdzas dbyer med du mtshhon pa gtor ma'i dbang bskur pas /	36	gang char thams cad bde chen du rang rig ba gu ru sku dang dod yon rnam lnga ye shes lnga rang bzhin du rnam ba dag ba bdud rtshi mchod rdzas dbyer med du mtshhon ba thor ma dbang skur ba 
BO_TZ_Terdzo-OM-P3:367	sems nyid snang stong zung 'jug tu rtogs pas 'khor 'das gnyis med kyi dbyings su dam tshhig gnyan po 'dres pas /	36	sems nyid snang stong zung jug tu rtogs ba khor da gnyis med kyi dbyings su dam tshhig gnyan po dre ba 
BO_TZ_Terdzo-OM-P3:368	phyi nang gi ma mo da ki dbang du 'dus te phrin las bzhis 'gro ba ma lus pa 'dul ba'i phyir du sprul pa dang yang sprul las la bkye bar shes pa ni shes rab ye shes kyi dbang /	36	phyi nang gi ma mo da ki dbang du du te phrin las bzhis gro ba ma lus ba dul ba phyir du sprul ba dang yang sprul las la gyed ba shes ba ni shes rab ye shes kyi dbang 
BO_TZ_Terdzo-OM-P3:369	des bde gsal mi rtog pa'i nyams skyes pa ni dbang bzhi pa'o //	36	des bde gsal mi rtogs ba nyams skye ba ni dbang bzhi ba 
BO_TZ_Terdzo-OM-P3:370	lnga pa sku 'bag gi dbang bskur ba ni /	37	lnga ba sku bag gi dbang skur ba ni 
BO_TZ_Terdzo-OM-P3:371	sku spyi bor bzhag la /	37	sku spyi bor jog la 
BO_TZ_Terdzo-OM-P3:372	a+o~m: chos sku skye med dbyings las ma g.yos kyang :	37	a+o~m: chos sku skye med dbyings las ma g.yos kyang 
BO_TZ_Terdzo-OM-P3:373	longs sku gsal la ma 'dres gu ru'i sku :	37	longs sku gsal la ma dre gu ru sku 
BO_TZ_Terdzo-OM-P3:374	sprul sku sna tshhogs thabs kyis 'gro ba 'dul :	37	sprul sku sna tshhogs thabs kyis gro ba dul 
BO_TZ_Terdzo-OM-P3:375	sku gsum ngang du mnyam nyid ma 'dres gsal :	37	sku gsum ngang du mnyam nyid ma dre gsal 
BO_TZ_Terdzo-OM-P3:376	sngon tshhe pad 'byung khyed dang smon lam gcig :	37	sngon tshhe pad byung khyed dang smon lam gcig 
BO_TZ_Terdzo-OM-P3:377	da lta bdag dang slob ma'i stangs zungs shig :	37	da lta bdag dang slob ma stangs zungs shig 
BO_TZ_Terdzo-OM-P3:378	srog gi phyir yang mi gtong sgrub lags so :	37	srog gi phyir yang mi gtong sgrub lags so 
BO_TZ_Terdzo-OM-P3:379	ye shes dbang chen rab 'byams bskur rdzogs shog :	37	ye shes dbang chen rab byam skur rdzogs shog 
BO_TZ_Terdzo-OM-P3:380	rtsha sngags brjod pas spyi bor bzhag	38	rtsha sngags rjod ba spyi bor jog 
BO_TZ_Terdzo-OM-P3:381	/mgrin par 'jog pa dang mnyam du me tog phog pa'i rigs dang mthun pa'i gsang ming 'dogs te badzra gu ru rtshal zhes pas mtshhon no //	38	ba jog ba dang mnyam du me tog bogs ba rigs dang mthun ba gsang ming dogs te badzra gu ru rtshal zhes ba mtshhon no 
BO_TZ_Terdzo-OM-P3:382	de ltar sku spyi bor bzhag pa bum dbang /	38	de ltar sku spyi bor jog ba bum dbang 
BO_TZ_Terdzo-OM-P3:383	mgrin par bzhag ste gsang mtshhan btags pa ni gsang dbang /	38	mgrin ba jog ste gsang mtshhan dogs ba ni gsang dbang 
BO_TZ_Terdzo-OM-P3:384	snying gar bzhag ste bla ma dang rang sems dbyer med du ngo sprad pa ni /	38	snying gar jog ste bla ma dang rang sems dbyer med du ngo sprod ba ni 
BO_TZ_Terdzo-OM-P3:385	sems nyid ye thog ma nas sku bzhi lhun grub tu gnas pa 'di gu ru rdo rje thod phreng rtshal sku bzhi dbyer med mtshhon pa gu ru'i sku'i dbang bskur pas /	38	sems nyid ye thogs ma nas sku bzhi lhun grub tu gnas ba di gu ru rdo rje thod phreng rtshal sku bzhi dbyer med mtshhon ba gu ru sku dbang skur ba 
BO_TZ_Terdzo-OM-P3:386	rang tha mal du 'dzin pa dag nas /	38	rang tha mal du dzin ba dag nas 
BO_TZ_Terdzo-OM-P3:387	rang sems gdod ma nas dag pa gu ru pad+ma 'byung gnas dang 'dra yang /	38	rang sems gdod ma nas dag ba gu ru pad+ma byung gnas dang dra yang 
BO_TZ_Terdzo-OM-P3:388	de ltar ma rtogs pas sgo gsum tha mal du gyur pa 'di sbyong ba'i phyir /	38	de ltar ma rtogs ba sgo gsum tha mal du gyur ba di sbyong ba phyir 
BO_TZ_Terdzo-OM-P3:389	bdag dang slob ma la byin gyis rlob par shes pa ni shes rab ye shes kyi dbang /	38	bdag dang slob ma la byin gyis rlob ba shes ba ni shes rab ye shes kyi dbang 
BO_TZ_Terdzo-OM-P3:390	des bde gsal mi rtog pa'i nyams skyes pa ni dbang bzhi pa'o //	39	des bde gsal mi rtogs ba nyams skye ba ni dbang bzhi ba 
BO_TZ_Terdzo-OM-P3:391	de ltar rtsha ba'i dbang rnam pa lnga la bzhi bzhir phye bas na rnam pa nyi shus byang chub pa zhes bya ba dbang bzhi'i mngon par rtogs pa'i byin rlabs thod rgal du thob par 'gyur ba yin no //	39	de ltar rtsha ba dbang rnam ba lnga la bzhi bzhir byed ba na rnam ba nyi shus byang chub ba zhes byed ba dbang bzhi mngon ba rtogs ba byin rlabs thod rgal du thob ba gyur ba yin no 
BO_TZ_Terdzo-OM-P3:392	des na rdo rje theg pa'i dam tshhig spyi dang / khyad par yab kyi dbang rtags su sku 'bag dang rdo rje gzung zhing bcang /	39	des na rdo rje theg ba dam tshhig spyi dang khyad ba yab kyi dbang rtags su sku bag dang rdo rje gzung zhing chang 
BO_TZ_Terdzo-OM-P3:393	yum gyi dbang rtags su me long dang ka pa la dum bu bzhi pa 'chang /	39	yum gyi dbang rtags su me long dang ka ba la dum bu bzhi ba chang 
BO_TZ_Terdzo-OM-P3:394	yab yum gnyis su med pa'i dbang rtags su tshhes bcu'i mchod pa ma chag par gyis shig ces brjod /	39	yab yum gnyis su med ba dbang rtags su tshhes chu mchod ba ma chag ba gyis shig ces rjod 
BO_TZ_Terdzo-OM-P3:395	slob mas kyang khas blang zhing man+dal 'bul lo //	39	slob mas kyang khas blang zhing man+dal bul lo 
BO_TZ_Terdzo-OM-P3:396	'di'i dbang rdzas snying gar 'jog skabs tshhig don ngo sprod rgyas par byed pa'i lugs kyang yod pas spro na zur du bris pa ltar bya'o /   'dir ni lo chen gsung las 'byung ba ltar dkyus su btshud yod do /mchan /	39	di dbang rdzas snying gar jog skabs tshhig don ngo sprod rgya ba byed ba lugs kyang yod ba spro na zur du bri ba ltar byed dir ni lo chen gsung las byung ba ltar dkyu su btshud yod do 
BO_TZ_Terdzo-OM-P3:397	mig dar 'ching 'grol sogs tshhig gis dngos zin la med kyang don gyis thob pas smros so //	39	mig dar ching grol sogs tshhig gis dngos zin la med kyang don gyis thob ba smros so 
BO_TZ_Terdzo-OM-P3:398	gong du tshhogs mchod ma btang na skabs 'dir gtong zhing /	39	gong du tshhogs mchod ma gtong na skabs dir gtong zhing 
BO_TZ_Terdzo-OM-P3:399	rjes gtang rag gi mchod bstod /	39	rjes gtong rag gi mchod bstod 
BO_TZ_Terdzo-OM-P3:400	nongs bshags gshegs gsol /	40	nongs chags gshegs gsol 
BO_TZ_Terdzo-OM-P3:401	nyer bsdu smon lam shis brjod rnams bya ste las byang bzhin no //	40	nyer sdud smon lam shis rjod rnams byed ste las byang bzhin no 
BO_TZ_Terdzo-OM-P3:402	gsang 'dus bla sgrub snying po'i bcud //	40	gsang du bla sgrub snying po bcud 
BO_TZ_Terdzo-OM-P3:403	'a~xgyur me~xd bde chen lam bzang mchog	40	a~xgyur me~xd bde chen lam bzang mchog 
BO_TZ_Terdzo-OM-P3:404	/rdo~x rje~x'i gsung bzhin 'jug bder spel //	40	rje~x gsung bzhin jug bder spel 
BO_TZ_Terdzo-OM-P3:405	skal bzang rnams kyis nyams su longs //	40	skal bzang rnams kyis nyams su longs 
BO_TZ_Terdzo-OM-P3:406	gsang 'dus thod phreng rtshal gyi sgos sgrub dang 'brel ba zlum po bzhi dbang gi le tshhan no ///	40	gsang du thod phreng rtshal gyi sgos sgrub dang brel ba zlum po bzhi dbang gi le tshhan no 
