segmentnr	original	folio	stemmed
BO_TZ_PEMA-SANGTHIG-P25:0	@#// gu ru'i thugs sgrub bder gshegs 'dus pa dang pad+ma gsang ba'i thig le gang la'ang sbyar du rung ba'i /	0	gu ru thugs sgrub bder gshegs du ba dang pad+ma gsang ba thig le gang la sbyor du rung ba 
BO_TZ_PEMA-SANGTHIG-P25:1	zhi khro'i skong bshags kyi cho ga kun bzang khrus chab ces bya ba bzhugs so //	0	zhi khro skong chags kyi cho ga kun bzang khru chab ces byed ba bzhugs so 
BO_TZ_PEMA-SANGTHIG-P25:2	rtsha gsum kun 'dus pad+ma tshhe yi lha la phyag 'tshhal lo //	0	rtsha gsum kun du pad+ma tshhe yi lha la phyag tshhal lo 
BO_TZ_PEMA-SANGTHIG-P25:3	rnal 'byor gang zhig dam tshhig nyams pa gso zhing dngos grub kyi skal pa rang gi rgyud la nye bar 'gyur ba'i phyir skong bshags kyi cho ga bya bar 'dod pas /	0	rnal byor gang jig dam tshhig nyams ba gso zhing dngos grub kyi skal ba rang gi brgyud la nye ba gyur ba phyir skong chags kyi cho ga byed ba dod ba 
BO_TZ_PEMA-SANGTHIG-P25:4	gter gzhung rdo rje'i tshhig rkang las /	0	gter gzhung rdo rje tshhig rkang las 
BO_TZ_PEMA-SANGTHIG-P25:5	gzhan yang dkyil 'khor gtsho bo yi :	0	gzhan yang dkyil khor gtsho bo yi 
BO_TZ_PEMA-SANGTHIG-P25:6	dung khang 'bar bar khro bo dang : mgrin par rig 'dzin bla ma'i tshhogs :	0	dung khang bar ba khro bo dang mgrin ba rig dzin bla ma tshhogs 
BO_TZ_PEMA-SANGTHIG-P25:7	snying khar zhi ba dbyings kyi lha :	0	snying khar zhi ba dbyings kyi lha 
BO_TZ_PEMA-SANGTHIG-P25:8	ma 'dres tshhom bu'i tshhul du bsgom :	0	ma dre tshhom bu tshhul du bsgom 
BO_TZ_PEMA-SANGTHIG-P25:9	phyi nang gsang ba'i mchod pa ni :	0	phyi nang gsang ba mchod ba ni 
BO_TZ_PEMA-SANGTHIG-P25:10	brgya rtsha 'bul zhing lha tshhogs kyi :	1	brgya rtsha bul zhing lha tshhogs kyi 
BO_TZ_PEMA-SANGTHIG-P25:11	mtshhan nas brjod la phyag kyang 'tshhal :	1	mtshhan nas rjod la phyag kyang tshhal 
BO_TZ_PEMA-SANGTHIG-P25:12	ngag gi sgrib pa bzlas pas sbyangs :	1	ngag gi sgrib ba bzlas ba sbyong 
BO_TZ_PEMA-SANGTHIG-P25:13	yid kyi rtog sgrib lta bas bshags :	1	yid kyi rtogs sgrib lta ba chags 
BO_TZ_PEMA-SANGTHIG-P25:14	thun mong tshhogs kyi mchod pas bskang :	1	thun mong tshhogs kyi mchod ba skong 
BO_TZ_PEMA-SANGTHIG-P25:15	des ni nyams chag ma lus bshags :	1	des ni nyams chag ma lus chags 
BO_TZ_PEMA-SANGTHIG-P25:16	mchog thun dngos grub nges par thob :	1	mchog thun dngos grub nges ba thob 
BO_TZ_PEMA-SANGTHIG-P25:17	ces gsungs pa'i bstan don nyams su blang bar 'dod pas /	1	ces gsungs ba ston don nyams su blang ba dod ba 
BO_TZ_PEMA-SANGTHIG-P25:18	sgrub gzhi rtsha gsum tshhe lha'i dkyil 'khor gyi steng du zhi ba dang khro bo'i dkyil 'khor steng 'og gi tshhul du rab rdul tshhon /	1	sgrub gzhi rtsha gsum tshhe lha dkyil khor gyi steng du zhi ba dang khro bo dkyil khor steng g gi tshhul du rab rdul tshhon 
BO_TZ_PEMA-SANGTHIG-P25:19	'bring ras bris /	1	bring ras bri 
BO_TZ_PEMA-SANGTHIG-P25:20	tha ma lha grangs kyi tshhom bu bkod pa'i steng bum pa bcud ldan chas kyis spras pa'i khar thod pa bdud rtshi'i bkang ba /	2	tha ma lha grangs kyi tshhom bu bkod ba steng bum ba bcud ldan cha kyis spras ba khar thod ba bdud rtshi geng ba 
BO_TZ_PEMA-SANGTHIG-P25:21	de steng me long sin+d+hu ras brdal bar chos 'byung mu~mhyig gis mtshhan pa dar dmar gyis bkab pa'i steng 'ja' shel dang bcas pa bshams /	2	de steng me long sin+d+hu ras rdal ba chos byung mu~mhyig gis mtshhan ba dar dmar gyis gebs ba steng ja shel dang cha ba bshams 
BO_TZ_PEMA-SANGTHIG-P25:22	(tshhe 'brang dang ril chang mda' dar rnams kyang dgos na bshams /mchan /)	2	(tshhe brang dang ril chang mda dar rnams kyang dgos na bshams 
BO_TZ_PEMA-SANGTHIG-P25:23	dkyil 'khor gyi mtha' skor du tshhe lha'i sgrub gtor dang zhi ba dang khro bo'i gtor ma /	2	dkyil khor gyi mtha skor du tshhe lha sgrub thor dang zhi ba dang khro bo thor ma 
BO_TZ_PEMA-SANGTHIG-P25:24	sman dang rak+ta gtor tshhogs nyer spyod bcas brgya rtsha la sogs pa ci 'byor ba'i mchod pa'i rnam grangs dag gtshang bkod legs su bkram /	2	sman dang rak+ta thor tshhogs nyer spyod cha brgya rtsha la sogs ba ci byor ba mchod ba rnam grangs dag gtshang bkod legs su grem 
BO_TZ_PEMA-SANGTHIG-P25:25	sgrub gzhi lha yi dkyil 'khor snang srid dag pa rab 'byams ye grol lhun rdzogs kyi dgongs pa srog tu gzung /	2	sgrub gzhi lha yi dkyil khor snang srid dag ba rab byam ye grol lhun rdzogs kyi dgongs ba srog tu gzung 
BO_TZ_PEMA-SANGTHIG-P25:26	bskyed rim lha yi snang cha bdag nyid 'chi med pad+ma tshhe dpag med kyi sku yi gnas su zhi khro'i lha tshhogs gsal 'debs pa /	2	skyed rim lha yi snang cha bdag nyid chi med pad+ma tshhe dpog med kyi sku yi gnas su zhi khro lha tshhogs gsal debs ba 
BO_TZ_PEMA-SANGTHIG-P25:27	a : chos sku skye ba med pa las :	2	a chos sku skye ba med ba las 
BO_TZ_PEMA-SANGTHIG-P25:28	sogs nas / dkyil 'khor chen por lhun grub gyur :	2	sogs nas dkyil khor chen por lhun grub gyur 
BO_TZ_PEMA-SANGTHIG-P25:29	zhes pa'i 'don 'phros su /	2	zhes ba don phro su 
BO_TZ_PEMA-SANGTHIG-P25:30	b+h+ru~m bi shwa bi shud+d+he :	3	b+h+ru~m bi shwa bi shud+d+he 
BO_TZ_PEMA-SANGTHIG-P25:31	bdag nyid 'chi med tshhe dpag med mgon gyi :	3	bdag nyid chi med tshhe dpog med mgon gyi 
BO_TZ_PEMA-SANGTHIG-P25:32	klad pa dung khang dur khrod gzhal yas khang :	3	klad ba dung khang dur khrod jal yas khang 
BO_TZ_PEMA-SANGTHIG-P25:33	lte bar 'khor lo rtshibs bzhir pad nyi'i steng :	3	lte ba khor lo rtshibs bzhir pad nyi steng 
BO_TZ_PEMA-SANGTHIG-P25:34	khyung dom khyu mchog stag gzig rnams kyi khrir :	3	khyung dom khyu mchog stag gzig rnams kyi khrir 
BO_TZ_PEMA-SANGTHIG-P25:35	dbus su bud+d+ha he ru kahdpal ni :	3	dbus su bud+d+ha he ru kahdpal ni 
BO_TZ_PEMA-SANGTHIG-P25:36	smug nag 'khor lo g.yas la dung khrag g.yon :	3	smug nag khor lo g.yas la dung khrag g.yon 
BO_TZ_PEMA-SANGTHIG-P25:37	bud+d+ha kro d+hi shwa ri gnyis med 'khril :	3	bud+d+ha kro d+hi shwa ri gnyis med khril 
BO_TZ_PEMA-SANGTHIG-P25:38	shar du badzra he ru kahdpal ni :	3	char du badzra he ru kahdpal ni 
BO_TZ_PEMA-SANGTHIG-P25:39	mthing nag rdo rje g.yas la dung khrag g.yon :	3	mthing nag rdo rje g.yas la dung khrag g.yon 
BO_TZ_PEMA-SANGTHIG-P25:40	badzra kro d+hi shwa ri gnyis med 'khril :	4	badzra kro d+hi shwa ri gnyis med khril 
BO_TZ_PEMA-SANGTHIG-P25:41	lho ru rat+na he ru kahdpal ni :	4	lho ru rat+na he ru kahdpal ni 
BO_TZ_PEMA-SANGTHIG-P25:42	ser nag rin chen g.yas la dung khrag g.yon :	4	ser nag rin chen g.yas la dung khrag g.yon 
BO_TZ_PEMA-SANGTHIG-P25:43	rat+na kro d+hi shwa ri gnyis med 'khril :	4	rat+na kro d+hi shwa ri gnyis med khril 
BO_TZ_PEMA-SANGTHIG-P25:44	nub tu pad+ma he ru kahdpal ni :	4	nub tu pad+ma he ru kahdpal ni 
BO_TZ_PEMA-SANGTHIG-P25:45	dmar nag pad+ma g.yas la dung khrag g.yon :	4	dmar nag pad+ma g.yas la dung khrag g.yon 
BO_TZ_PEMA-SANGTHIG-P25:46	pad+ma kro d+hi shwa ri gnyis med 'khril :	4	pad+ma kro d+hi shwa ri gnyis med khril 
BO_TZ_PEMA-SANGTHIG-P25:47	byang du karma he ru kahdpal ni :	4	byang du karma he ru kahdpal ni 
BO_TZ_PEMA-SANGTHIG-P25:48	ljang nag rgya gram g.yas la dung khrag g.yon :	4	ljang nag rgya grams g.yas la dung khrag g.yon 
BO_TZ_PEMA-SANGTHIG-P25:49	karma kro d+hi shwa ri gnyis med 'khril :	4	karma kro d+hi shwa ri gnyis med khril 
BO_TZ_PEMA-SANGTHIG-P25:50	rtshibs mchan dur khrod rnams su zhing gi gdan :	5	rtshibs mchan dur khrod rnams su zhing gi gdan 
BO_TZ_PEMA-SANGTHIG-P25:51	shar lhor go'u ri dkar mo zhing dbyug 'dzin :	5	char lhor gou ri dkar mo zhing dbyug dzin 
BO_TZ_PEMA-SANGTHIG-P25:52	lho nub tsho'u ri ser mo mda' gzhu 'gengs :	5	lho nub tshou ri ser mo mda gzhu gengs 
BO_TZ_PEMA-SANGTHIG-P25:53	nub byang pra mo dmar mo chu srin 'dzin :	5	nub byang pra mo dmar mo chu srin dzin 
BO_TZ_PEMA-SANGTHIG-P25:54	byang shar bai ta ljang nag rdo rje 'dzin :	5	byang char bai ta ljang nag rdo rje dzin 
BO_TZ_PEMA-SANGTHIG-P25:55	phyi yi mtshhams kyi gru chad bzhi po la :	5	phyi yi mtshhams kyi gru chad bzhi po la 
BO_TZ_PEMA-SANGTHIG-P25:56	shar lhor tshan+da ser skya zhing dbyug 'dzin :	5	char lhor tshan+da ser skya zhing dbyug dzin 
BO_TZ_PEMA-SANGTHIG-P25:57	lho nub sme sha ljang dmar b+han gri 'dzin :	5	lho nub sme sha ljang dmar b+han gri dzin 
BO_TZ_PEMA-SANGTHIG-P25:58	nub byang g+hasma ljang khu ral gri 'dzin :	5	nub byang g+hasma ljang khu ral gri dzin 
BO_TZ_PEMA-SANGTHIG-P25:59	byang shar puk+ka mthing skya rgyu ma 'dren :	5	byang char puk+ka mthing skya rgyu ma bgrang 
BO_TZ_PEMA-SANGTHIG-P25:60	khyams kyi phyogs mtshhams brgyad la zhing gdan la :	6	khyams kyi phyogs mtshhams brgyad la zhing gdan la 
BO_TZ_PEMA-SANGTHIG-P25:61	shar du seng ha dkar mo zhing chen za :	6	char du seng ha dkar mo zhing chen za 
BO_TZ_PEMA-SANGTHIG-P25:62	lho ru bya gr-i dmar mo lag gnyis bsnol :	6	lho ru byed gr-i dmar mo lag gnyis snol 
BO_TZ_PEMA-SANGTHIG-P25:63	nub tu sr-i la wa gdong rgyu ma za :	6	nub tu sr-i la wa gdong rgyu ma za 
BO_TZ_PEMA-SANGTHIG-P25:64	byang du shwa na mthing nag byis snying 'dren :	6	byang du shwa na mthing nag byis snying bgrang 
BO_TZ_PEMA-SANGTHIG-P25:65	shar lhor gr-i d+ha rgod mgo zhing lus phral :	6	char lhor gr-i d+ha rgod mgo zhing lus phral 
BO_TZ_PEMA-SANGTHIG-P25:66	lho nub kam ka mthing nag zhing phrag khur :	6	lho nub kam ka mthing nag zhing phrag khur 
BO_TZ_PEMA-SANGTHIG-P25:67	nub byang kha kha nag mo ral gri phyar :	6	nub byang kha kha nag mo ral gri phyar 
BO_TZ_PEMA-SANGTHIG-P25:68	byang shar u lu mthing nag rdo rje 'dzin :	6	byang char u lu mthing nag rdo rje dzin 
BO_TZ_PEMA-SANGTHIG-P25:69	shar sgor rta gdong dkar mo lcags kyu 'dzin :	6	char sgor rta gdong dkar mo lcags kyu dzin 
BO_TZ_PEMA-SANGTHIG-P25:70	lho sgor phag gdong ser mo zhags pa 'dzin :	7	lho sgor phag gdong ser mo zhags ba dzin 
BO_TZ_PEMA-SANGTHIG-P25:71	nub sgor seng gdong dmar mo lcags sgrog bsnams :	7	nub sgor seng gdong dmar mo lcags sgrog snom 
BO_TZ_PEMA-SANGTHIG-P25:72	byang sgor sbrul gdong ljang mo dril bu 'dzin :	7	byang sgor sbrul gdong ljang mo dril bu dzin 
BO_TZ_PEMA-SANGTHIG-P25:73	de yi phyi rim 'khor yug chen mo ru :	7	de yi phyi rim khor yug chen mo ru 
BO_TZ_PEMA-SANGTHIG-P25:74	dbang phyug chen mo nyi shu rtsha brgyad ni :	7	dbang phyug chen mo nyi shu rtsha brgyad ni 
BO_TZ_PEMA-SANGTHIG-P25:75	phyogs kyi mdog can rdo rje rin po che :	7	phyogs kyi mdog can rdo rje rin po che 
BO_TZ_PEMA-SANGTHIG-P25:76	pad+ma rgya gram 'dzin cing sna tshhogs gzugs :	7	pad+ma rgya grams dzin cing sna tshhogs gzugs 
BO_TZ_PEMA-SANGTHIG-P25:77	gdod nas lhun gyis grub pa'i sku ru bsam :	7	gdod nas lhun gyis grub ba sku ru bsam 
BO_TZ_PEMA-SANGTHIG-P25:78	mgrin pa ro 'dus 'khor lo'i gzhal yas su //	7	mgrin ba ro du khor lo jal yas su 
BO_TZ_PEMA-SANGTHIG-P25:79	pad+ma 'dab brgyad lte ba'i ge sar la //	7	pad+ma dab brgyad lte ba ge sar la 
BO_TZ_PEMA-SANGTHIG-P25:80	rnam par smin pa'i rig 'dzin chen po ni //	8	rnam ba smin ba rig dzin chen po ni 
BO_TZ_PEMA-SANGTHIG-P25:81	sku mdog dmar gsal rang 'od yum dang 'khril //	8	sku mdog dmar gsal rang d yum dang khril 
BO_TZ_PEMA-SANGTHIG-P25:82	shar du sa la gnas pa'i rig 'dzin ni //	8	char du sa la gnas ba rig dzin ni 
BO_TZ_PEMA-SANGTHIG-P25:83	dkar gsal mdangs ldan rang 'od yum dang 'khril //	8	dkar gsal mdangs ldan rang d yum dang khril 
BO_TZ_PEMA-SANGTHIG-P25:84	lho phyogs tshhe la dbang ba'i rig 'dzin ni //	8	lho phyogs tshhe la dbang ba rig dzin ni 
BO_TZ_PEMA-SANGTHIG-P25:85	ser gsal mdangs ldan rang 'od yum dang 'khril //	8	ser gsal mdangs ldan rang d yum dang khril 
BO_TZ_PEMA-SANGTHIG-P25:86	nub phyogs phyag rgya chen po'i rig 'dzin ni //	8	nub phyogs phyag rgya chen po rig dzin ni 
BO_TZ_PEMA-SANGTHIG-P25:87	dmar gsal mdangs ldan rang 'od yum dang 'khril //	8	dmar gsal mdangs ldan rang d yum dang khril 
BO_TZ_PEMA-SANGTHIG-P25:88	byang phyogs lhun gyis grub pa'i rig 'dzin ni //	8	byang phyogs lhun gyis grub ba rig dzin ni 
BO_TZ_PEMA-SANGTHIG-P25:89	ljang gsal mdzes 'dzum rang 'od yum dang 'khril //	8	ljang gsal mdzes dzum rang d yum dang khril 
BO_TZ_PEMA-SANGTHIG-P25:90	yab yum rdor dril gri gug thod khrag 'dzin //	9	yab yum rdar dril gri gug thod khrag dzin 
BO_TZ_PEMA-SANGTHIG-P25:91	brkyang bskum gar gyis 'ja' 'od klong du bzhugs //	9	rkyong skum gar gyis ja d klong du bzhugs 
BO_TZ_PEMA-SANGTHIG-P25:92	snying khar rin chen 'bar ba'i gzhal yas khang :	9	snying khar rin chen bar ba jal yas khang 
BO_TZ_PEMA-SANGTHIG-P25:93	'khor lo rtshibs bzhi'i dbus dang phyogs rnams su :	9	khor lo rtshibs bzhi dbus dang phyogs rnams su 
BO_TZ_PEMA-SANGTHIG-P25:94	seng ge glang chen rta mchog rma bya dang : shang shang khri dang pad+ma zla ba'i steng :	9	seng ge glang chen rta mchog rma byed dang shang shang khri dang pad+ma zla ba steng 
BO_TZ_PEMA-SANGTHIG-P25:95	dbus su rnam par snang mdzad sku mdog dkar :	9	dbus su rnam ba snang mdzad sku mdog dkar 
BO_TZ_PEMA-SANGTHIG-P25:96	'khor lo dril bu 'dzin cing skyil krung bzhugs :	9	khor lo dril bu dzin cing skyil krung bzhugs 
BO_TZ_PEMA-SANGTHIG-P25:97	dbyings phyug sngon mo 'khor lo dril 'dzin 'khyud :	9	dbyings phyug sngon mo khor lo dril dzin khyud 
BO_TZ_PEMA-SANGTHIG-P25:98	shar du mi bskyod rdor sems sku mdog mthing :	9	char du mi skyod rdar sems sku mdog mthing 
BO_TZ_PEMA-SANGTHIG-P25:99	rdo rje dril bu 'dzin cing skyil krung bzhugs :	9	rdo rje dril bu dzin cing skyil krung bzhugs 
BO_TZ_PEMA-SANGTHIG-P25:100	spyan ma dkar mo rdo rje dril 'dzin 'khyud :	10	spyan ma dkar mo rdo rje dril dzin khyud 
BO_TZ_PEMA-SANGTHIG-P25:101	lho ru rin chen 'byung ldan sku mdog ser :	10	lho ru rin chen byung ldan sku mdog ser 
BO_TZ_PEMA-SANGTHIG-P25:102	rin chen dril bu 'dzin cing skyil krung bzhugs :	10	rin chen dril bu dzin cing skyil krung bzhugs 
BO_TZ_PEMA-SANGTHIG-P25:103	ma ki ser mo rin chen dril 'dzin 'khyud :	10	ma ki ser mo rin chen dril dzin khyud 
BO_TZ_PEMA-SANGTHIG-P25:104	nub tu snang ba mtha' yas sku mdog dmar :	10	nub tu snang ba mtha yas sku mdog dmar 
BO_TZ_PEMA-SANGTHIG-P25:105	pad+ma dril bu 'dzin cing skyil krung bzhugs :	10	pad+ma dril bu dzin cing skyil krung bzhugs 
BO_TZ_PEMA-SANGTHIG-P25:106	gos dkar dmar mo pad+ma dril 'dzin 'khyud :	10	gos dkar dmar mo pad+ma dril dzin khyud 
BO_TZ_PEMA-SANGTHIG-P25:107	byang du don yod grub pa sku mdog ljang :	10	byang du don yod grub ba sku mdog ljang 
BO_TZ_PEMA-SANGTHIG-P25:108	ral gri dril bu 'dzin cing skyil krung bzhugs :	10	ral gri dril bu dzin cing skyil krung bzhugs 
BO_TZ_PEMA-SANGTHIG-P25:109	sgrol ma ljang gsal ral gri dril 'dzin 'khyud :	10	sgrol ma ljang gsal ral gri dril dzin khyud 
BO_TZ_PEMA-SANGTHIG-P25:110	rtshibs mchan rnams su nang gi sems dpa' ni :	11	rtshibs mchan rnams su nang gi sems dpa ni 
BO_TZ_PEMA-SANGTHIG-P25:111	shar lhor sa snying dkar po myu gu 'dzin :	11	char lhor sa snying dkar po myu gu dzin 
BO_TZ_PEMA-SANGTHIG-P25:112	la s+yai dkar mo me long 'dzin pas 'khyud :	11	la s+yai dkar mo me long dzin ba khyud 
BO_TZ_PEMA-SANGTHIG-P25:113	lho nub nam snying ser gsal rin chen 'dzin :	11	lho nub nam snying ser gsal rin chen dzin 
BO_TZ_PEMA-SANGTHIG-P25:114	ma l+ye ser mo phreng ba 'dzin pas 'khyud :	11	ma l+ye ser mo phreng ba dzin ba khyud 
BO_TZ_PEMA-SANGTHIG-P25:115	nub byang spyan ras gzigs dmar pad+ma 'dzin :	11	nub byang spyan ras gzigs dmar pad+ma dzin 
BO_TZ_PEMA-SANGTHIG-P25:116	girti dmar mo pad+ma 'dzin pas 'khyud :	11	girti dmar mo pad+ma dzin ba khyud 
BO_TZ_PEMA-SANGTHIG-P25:117	byang shar gsang bdag mthing ga rdo rje 'dzin :	11	byang char gsang bdag mthing ga rdo rje dzin 
BO_TZ_PEMA-SANGTHIG-P25:118	nirti ljang mo gar bsgyur mdzad cing 'khyud :	11	nirti ljang mo gar sgyur mdzad cing khyud 
BO_TZ_PEMA-SANGTHIG-P25:119	gru chad rnams su phyi yi sems dpa' ni :	11	gru chad rnams su phyi yi sems dpa ni 
BO_TZ_PEMA-SANGTHIG-P25:120	shar lhor byams pa dkar ser klu shing 'dzin :	12	char lhor byams ba dkar ser klu shing dzin 
BO_TZ_PEMA-SANGTHIG-P25:121	push+pe dkar mo me tog 'dzin pas 'khyud :	12	push+pe dkar mo me tog dzin ba khyud 
BO_TZ_PEMA-SANGTHIG-P25:122	lho nub sgrib sel dmar ser me tog 'dzin :	12	lho nub sgrib sel dmar ser me tog dzin 
BO_TZ_PEMA-SANGTHIG-P25:123	d+hu pe ser mo spos phor 'dzin pas 'khyud :	12	d+hu pe ser mo spros phor dzin ba khyud 
BO_TZ_PEMA-SANGTHIG-P25:124	nub byang kun bzang dmar ljang snye ma 'dzin :	12	nub byang kun bzang dmar ljang snye ma dzin 
BO_TZ_PEMA-SANGTHIG-P25:125	mar me dmar mo mar me 'dzin pas 'khyud :	12	mar me dmar mo mar me dzin ba khyud 
BO_TZ_PEMA-SANGTHIG-P25:126	byang shar 'jam dpal ljang skya ut+pal 'dzin :	12	byang char jam dpal ljang skya ut+pal dzin 
BO_TZ_PEMA-SANGTHIG-P25:127	dri chab ljang mo dung phor 'dzin pas 'khyud :	12	dri chab ljang mo dung phor dzin ba khyud 
BO_TZ_PEMA-SANGTHIG-P25:128	kun kyang g.yon pas dril bu 'dzin pa 'o :	12	kun kyang g.yon ba dril bu dzin ba mang 
BO_TZ_PEMA-SANGTHIG-P25:129	shar nub gnyis su rin chen pad+ma dang : nyi zla'i gdan la kun bzang yab yum ni :	12	char nub gnyis su rin chen pad+ma dang nyi zla gdan la kun bzang yab yum ni 
BO_TZ_PEMA-SANGTHIG-P25:130	mthing gsal mnyam gzhag mdzad cing skyil krung bzhugs :	13	mthing gsal mnyam jog mdzad cing skyil krung bzhugs 
BO_TZ_PEMA-SANGTHIG-P25:131	khyams kyi phyogs mtshhams rnams su thub pa drug :	13	khyams kyi phyogs mtshhams rnams su thub ba drug 
BO_TZ_PEMA-SANGTHIG-P25:132	brgya byin dkar po rin chen pi wam sgreng :	13	brgya byin dkar po rin chen pi wam sgreng 
BO_TZ_PEMA-SANGTHIG-P25:133	thags bzang ljang khu ral gri go cha bsnams :	13	thags bzang ljang khu ral gri go cha snom 
BO_TZ_PEMA-SANGTHIG-P25:134	shaka thub ser po gseg shang par bu 'dzin :	13	shaka thub ser po gseg shang ba bu dzin 
BO_TZ_PEMA-SANGTHIG-P25:135	seng ge rab brtan mthing gsal glegs bam 'dzin :	13	seng ge rab brtan mthing gsal glegs bam dzin 
BO_TZ_PEMA-SANGTHIG-P25:136	kha 'bar dmar po zas kyi sgrom bu bsnams :	13	kha bar dmar po zas kyi sgrom bu snom 
BO_TZ_PEMA-SANGTHIG-P25:137	chos rgyal nag po me chu 'dzin pa rnams :	13	chos rgyal nag po me chu dzin ba rnams 
BO_TZ_PEMA-SANGTHIG-P25:138	chags bral chos gos gsum gsol sprul sku'i tshhul :	13	chags bral chos gos gsum gsol sprul sku tshhul 
BO_TZ_PEMA-SANGTHIG-P25:139	sgo bzhir nyi ma 'bar ba'i gdan re la :	13	sgo bzhir nyi ma bar ba gdan re la 
BO_TZ_PEMA-SANGTHIG-P25:140	shar sgor khro bo stobs chen sku mdog smug :	14	char sgor khro bo stobs chen sku mdog smug 
BO_TZ_PEMA-SANGTHIG-P25:141	g.yas pas rdo rje g.yon pas dung khrag 'dzin :	14	g.yas ba rdo rje g.yon ba dung khrag dzin 
BO_TZ_PEMA-SANGTHIG-P25:142	gnod sbyin dkar mo lcags kyu 'dzin pas 'khril :	14	gnod sbyin dkar mo lcags kyu dzin ba khril 
BO_TZ_PEMA-SANGTHIG-P25:143	lho sgor khro bo gshin rje sku mdog ser :	14	lho sgor khro bo gshin rje sku mdog ser 
BO_TZ_PEMA-SANGTHIG-P25:144	g.yas pas be con g.yon pas thod khrag bsnams :	14	g.yas ba be con g.yon ba thod khrag snom 
BO_TZ_PEMA-SANGTHIG-P25:145	'jigs byed ser mo zhags pa 'dzin pas 'khril :	14	jigs byed ser mo zhags ba dzin ba khril 
BO_TZ_PEMA-SANGTHIG-P25:146	nub sgor khro bo rta mgrin sku mdog dmar :	14	nub sgor khro bo rta mgrin sku mdog dmar 
BO_TZ_PEMA-SANGTHIG-P25:147	g.yas pas thod dbyug sbrul dkris thod khrag bsnams :	14	g.yas ba thod dbyug sbrul dkri thod khrag snom 
BO_TZ_PEMA-SANGTHIG-P25:148	gsod byed dmar mo lcags sgrog 'dzin pas 'khril :	14	gsod byed dmar mo lcags sgrog dzin ba khril 
BO_TZ_PEMA-SANGTHIG-P25:149	byang sgor khro bo bdud rtshi 'khyil pa ljang :	14	byang sgor khro bo bdud rtshi khyil ba ljang 
BO_TZ_PEMA-SANGTHIG-P25:150	g.yas pas rgya gram g.yon pas thod khrag 'dzin :	15	g.yas ba rgya grams g.yon ba thod khrag dzin 
BO_TZ_PEMA-SANGTHIG-P25:151	mthar byed ljang mo dril bu 'dzin pas 'khril :	15	mthar byed ljang mo dril bu dzin ba khril 
BO_TZ_PEMA-SANGTHIG-P25:152	'od zer 'bar zhing thig le 'khrugs pa'i klong :	15	d zer bar zhing thig le khrugs ba klong 
BO_TZ_PEMA-SANGTHIG-P25:153	cha lugs rgyan rdzogs bde chen ngo bor bsam :	15	cha lugs rgyan rdzogs bde chen ngo bor bsam 
BO_TZ_PEMA-SANGTHIG-P25:154	gdod nas dag pa'i ye shes pa :	15	gdod nas dag ba ye shes ba 
BO_TZ_PEMA-SANGTHIG-P25:155	zhes sogs nas /	15	zhes sogs nas 
BO_TZ_PEMA-SANGTHIG-P25:156	om ahhu~m: om hu~m tram hriha:	15	om ahhu~m: om hu~m tram hriha: 
BO_TZ_PEMA-SANGTHIG-P25:157	de ltar gsal ba'i gnas gsum dang thugs ka'i sa bon las 'od zer lcags kyu'i dbyibs can dpag tu med pa 'phros pas /	15	de ltar gsal ba gnas gsum dang thugs ka sa bon las d zer lcags kyu dbyibs can dpog tu med ba phro ba 
BO_TZ_PEMA-SANGTHIG-P25:158	phyogs bcu dus bzhi'i bla ma rgyal ba zhi khro rab 'byams kyi lha tshhogs dpag tu med pa spyan drangs badzra sa ma dzah	15	phyogs chu dus bzhi bla ma rgyal ba zhi khro rab byam kyi lha tshhogs dpog tu med ba spyan drangs badzra sa ma dzah 
BO_TZ_PEMA-SANGTHIG-P25:159	dbyangs dang rol mo'i 'gyur ba dang bcas te /	15	dbyangs dang rol mo gyur ba dang cha te 
BO_TZ_PEMA-SANGTHIG-P25:160	hu~m: o rgyan yul gyi nub byang mtshhams :	16	hu~m: o rgyan yul gyi nub byang mtshhams 
BO_TZ_PEMA-SANGTHIG-P25:161	zhes sogs nas /	16	zhes sogs nas 
BO_TZ_PEMA-SANGTHIG-P25:162	blo 'das chos zad dngos grub stshol :	16	blo da chos zad dngos grub stshol 
BO_TZ_PEMA-SANGTHIG-P25:163	hu~m/ 'og min me ri 'bar ba'i zhing //	16	g min me ri bar ba zhing 
BO_TZ_PEMA-SANGTHIG-P25:164	gsang chen rol pa'i dur khrod nas //	16	gsang chen rol ba dur khrod nas 
BO_TZ_PEMA-SANGTHIG-P25:165	lnga bcu rtsha brgyad khro bo'i lha //	16	lnga chu rtsha brgyad khro bo lha 
BO_TZ_PEMA-SANGTHIG-P25:166	gnas 'dir spyan 'dren gshegs su gsol //	16	gnas dir spyan bgrang gshegs su gsol 
BO_TZ_PEMA-SANGTHIG-P25:167	hu~m/ 'og min chos dbyings pho brang na //	16	g min chos dbyings pho brang na 
BO_TZ_PEMA-SANGTHIG-P25:168	rig pa 'dzin pa'i sar bzhugs pa'i //	16	rig ba dzin ba sar bzhugs ba 
BO_TZ_PEMA-SANGTHIG-P25:169	dbyings las rig rtshal skur bzhengs pa //	16	dbyings las rig rtshal skur bzhengs ba 
BO_TZ_PEMA-SANGTHIG-P25:170	rig 'dzin dpa' bo mkha' 'gro'i tshhogs //	17	rig dzin dpa bo mkha gro tshhogs 
BO_TZ_PEMA-SANGTHIG-P25:171	dad dang gdung bas spyan 'dren na //	17	dad dang gdung ba spyan bgrang na 
BO_TZ_PEMA-SANGTHIG-P25:172	mos pa'i gnas 'dir gshegs su gsol //	17	mos ba gnas dir gshegs su gsol 
BO_TZ_PEMA-SANGTHIG-P25:173	hu~m/ dwangs ma lnga ldan 'od lnga'i zhing //	17	dwangs ma lnga ldan d lnga zhing 
BO_TZ_PEMA-SANGTHIG-P25:174	mi shigs thig le'i zhing khams nas //	17	mi shigs thig le zhing khams nas 
BO_TZ_PEMA-SANGTHIG-P25:175	bzhi bcu rtsha gnyis rgyal ba'i lha //	17	bzhi chu rtsha gnyis rgyal ba lha 
BO_TZ_PEMA-SANGTHIG-P25:176	ma lus 'khor bcas gshegs su gsol //	17	ma lus khor cha gshegs su gsol 
BO_TZ_PEMA-SANGTHIG-P25:177	hu~m/ lhun grub thig le chen po'i klong //	17	lhun grub thig le chen po klong 
BO_TZ_PEMA-SANGTHIG-P25:178	'od gsal ka dag zhing khams nas //	17	d gsal ka dag zhing khams nas 
BO_TZ_PEMA-SANGTHIG-P25:179	rtsha gsum rgyal ba'i lha tshhogs rnams //	17	rtsha gsum rgyal ba lha tshhogs rnams 
BO_TZ_PEMA-SANGTHIG-P25:180	gnas 'dir spyan 'dren gshegs su gsol //	18	gnas dir spyan bgrang gshegs su gsol 
BO_TZ_PEMA-SANGTHIG-P25:181	gnas mchog 'di ru byin phob la //	18	gnas mchog di ru byin phob la 
BO_TZ_PEMA-SANGTHIG-P25:182	sgrub mchog rnal 'byor bdag cag gi //	18	sgrub mchog rnal byor bdag cag gi 
BO_TZ_PEMA-SANGTHIG-P25:183	lus ngag yid la ye shes skyed //	18	lus ngag yid la ye shes skyed 
BO_TZ_PEMA-SANGTHIG-P25:184	mchog thun dngos grub bstshal du gsol //	18	mchog thun dngos grub bstshal du gsol 
BO_TZ_PEMA-SANGTHIG-P25:185	om ahhu~m badzra gu ru pad+ma sid+d+hi dz+nya na a yu she hu~m b+h+ru~m nr-i dza :	18	om ahhu~m badzra gu ru pad+ma sid+d+hi dz+nya na a yu she hu~m b+h+ru~m nr-i dza 
BO_TZ_PEMA-SANGTHIG-P25:186	om bo d+hi tshit+ta ma ha su kha dz+nya na d+ha tu a:	18	om bo d+hi tshit+ta ma ha su kha dz+nya na d+ha tu a: 
BO_TZ_PEMA-SANGTHIG-P25:187	om ru lu ru lu hu~m b+h+yo hu~m:	18	om ru lu ru lu hu~m b+h+yo hu~m: 
BO_TZ_PEMA-SANGTHIG-P25:188	om ahhu~m ma ha gu ru sarba sid+d+hi hu~m:	18	om ahhu~m ma ha gu ru sarba sid+d+hi hu~m: 
BO_TZ_PEMA-SANGTHIG-P25:189	badzra sa ma ya a be sha ya a a a:	18	badzra sa ma ya a be sha ya a a a: 
BO_TZ_PEMA-SANGTHIG-P25:190	dbyings nas spyan drangs ye shes lha :	19	dbyings nas spyan drangs ye shes lha 
BO_TZ_PEMA-SANGTHIG-P25:191	zhes sogs nas phyag 'tshhal mchod pa rnams gzhung ltar nas /	19	zhes sogs nas phyag tshhal mchod ba rnams gzhung ltar nas 
BO_TZ_PEMA-SANGTHIG-P25:192	bdud rtshi sman mchod kyi skabs brgyud mchod ni /	19	bdud rtshi sman mchod kyi skabs brgyud mchod ni 
BO_TZ_PEMA-SANGTHIG-P25:193	om ahhu~m/ chos sku snang mtha' longs sku spyan ras gzigs //	19	om chos sku snang mtha longs sku spyan ras gzigs 
BO_TZ_PEMA-SANGTHIG-P25:194	sprul pa'i skur snang pad+ma kun tu 'chang //	19	sprul ba skur snang pad+ma kun tu chang 
BO_TZ_PEMA-SANGTHIG-P25:195	gsang ba'i gzungs ma rgyal yum mkhar chen bza'//	19	gsang ba gzungs ma rgyal yum mkhar chen 
BO_TZ_PEMA-SANGTHIG-P25:196	sman mchod 'bul lo mchog thun dngos grub stshol //	19	sman mchod bul lo mchog thun dngos grub stshol 
BO_TZ_PEMA-SANGTHIG-P25:197	om sarba pany+tsha a mr-ita kha hi /	19	om sarba pany+tsha a mr-ita kha hi 
BO_TZ_PEMA-SANGTHIG-P25:198	lang 'gro lo tsha mnyam med grags pa dpal //	19	lang gro lo tsha mnyam med grags ba dpal 
BO_TZ_PEMA-SANGTHIG-P25:199	sprul pa'i gter ston chos bdag brgyud par bcas //	19	sprul ba gter ston chos bdag brgyud ba cha 
BO_TZ_PEMA-SANGTHIG-P25:200	rab 'byams tshhe lha'i dkyil 'khor lha tshhogs la //	20	rab byam tshhe lha dkyil khor lha tshhogs la 
BO_TZ_PEMA-SANGTHIG-P25:201	sman mchod 'bul lo mchog thun dngos grub stshol //	20	sman mchod bul lo mchog thun dngos grub stshol 
BO_TZ_PEMA-SANGTHIG-P25:202	om sarba pany+tsha a mr-ita kha hi /	20	om sarba pany+tsha a mr-ita kha hi 
BO_TZ_PEMA-SANGTHIG-P25:203	khrag 'thung rigs lnga gnas yul zhing skyong ma //	20	khrag thung rigs lnga gnas yul zhing skyong ma 
BO_TZ_PEMA-SANGTHIG-P25:204	spor byed sgo skyong dbang phyug ma mo'i tshhogs /	20	spor byed sgo skyong dbang phyug ma mo tshhogs 
BO_TZ_PEMA-SANGTHIG-P25:205	khrag 'thung 'bar ba'i dkyil 'khor lha tshhogs la //	20	khrag thung bar ba dkyil khor lha tshhogs la 
BO_TZ_PEMA-SANGTHIG-P25:206	sman mchod 'bul lo mchog thun dngos grub stshol //	20	sman mchod bul lo mchog thun dngos grub stshol 
BO_TZ_PEMA-SANGTHIG-P25:207	om sarba pany+tsha a mr-ita kha hi /	20	om sarba pany+tsha a mr-ita kha hi 
BO_TZ_PEMA-SANGTHIG-P25:208	rnam smin tshhe dbang sar gnas rig pa 'dzin //	20	rnam smin tshhe dbang sar gnas rig ba dzin 
BO_TZ_PEMA-SANGTHIG-P25:209	phyag rgya chen po lhun gyi grub pa yi //	20	phyag rgya chen po lhun gyi grub ba yi 
BO_TZ_PEMA-SANGTHIG-P25:210	rig 'dzin dpa' bo mkha' 'gro'i tshhogs rnams la //	21	rig dzin dpa bo mkha gro tshhogs rnams la 
BO_TZ_PEMA-SANGTHIG-P25:211	sman mchod 'bul lo mchog thun dngos grub stshol //	21	sman mchod bul lo mchog thun dngos grub stshol 
BO_TZ_PEMA-SANGTHIG-P25:212	om sarba pany+tsha a mr-ita kha hi /	21	om sarba pany+tsha a mr-ita kha hi 
BO_TZ_PEMA-SANGTHIG-P25:213	zhi ba rigs lnga sems dpa' sems ma dang // 'gro 'dul thub drug sprul pa'i sgo ba bzhi //	21	zhi ba rigs lnga sems dpa sems ma dang gro dul thub drug sprul ba sgo ba bzhi 
BO_TZ_PEMA-SANGTHIG-P25:214	bzhi bcu rtsha gnyis zhi ba'i lha tshhogs la //	21	bzhi chu rtsha gnyis zhi ba lha tshhogs la 
BO_TZ_PEMA-SANGTHIG-P25:215	sman mchod 'bul lo mchog thun dngos grub stshol //	21	sman mchod bul lo mchog thun dngos grub stshol 
BO_TZ_PEMA-SANGTHIG-P25:216	om sarba pany+tsha a mr-ita kha hi /	21	om sarba pany+tsha a mr-ita kha hi 
BO_TZ_PEMA-SANGTHIG-P25:217	ma mgon gza' rdor zhing skyong ma mo bcas //	21	ma mgon gza rdar zhing skyong ma mo cha 
BO_TZ_PEMA-SANGTHIG-P25:218	gter gyi gnyer 'dzin lha yi dge bsnyen sogs //	21	gter gyi gnyer dzin lha yi dge snyen sogs 
BO_TZ_PEMA-SANGTHIG-P25:219	snang srid dag pa rab 'byams dkyil 'khor la //	21	snang srid dag ba rab byam dkyil khor la 
BO_TZ_PEMA-SANGTHIG-P25:220	sman mchod 'bul lo mchog thun dngos grub stshol //	22	sman mchod bul lo mchog thun dngos grub stshol 
BO_TZ_PEMA-SANGTHIG-P25:221	om sarba pany+tsha a mr-ita kha hi /	22	om sarba pany+tsha a mr-ita kha hi 
BO_TZ_PEMA-SANGTHIG-P25:222	ka ya sid+d+hi om/	22	ka ya sid+d+hi 
BO_TZ_PEMA-SANGTHIG-P25:223	wa ka sid+d+hi ah	22	wa ka sid+d+hi ah 
BO_TZ_PEMA-SANGTHIG-P25:224	tshit+ta sid+d+hi hu~m/ sarba sid+d+hi hrih	22	tshit+ta sid+d+hi sarba sid+d+hi hrih 
BO_TZ_PEMA-SANGTHIG-P25:225	zhes bdud rtshi gnas gsum du reg la dngos grub blang /	22	zhes bdud rtshi gnas gsum du reg la dngos grub blang 
BO_TZ_PEMA-SANGTHIG-P25:226	gtor ma dang rak+ta'i mchod pa nas brtsham bstod pa'i mjug brjod med gzhi don rig par shog :	22	thor ma dang rak+ta mchod ba nas brtsham bstod ba mjug rjod med gzhi don rig ba shog 
BO_TZ_PEMA-SANGTHIG-P25:227	ces pa'i 'phros su /	22	ces ba phro su 
BO_TZ_PEMA-SANGTHIG-P25:228	hu~m/ rig rtshal rol pa'i 'phro 'du las //	22	rig rtshal rol ba phro du las 
BO_TZ_PEMA-SANGTHIG-P25:229	dung khang 'bar ba'i gzhal yas su /	22	dung khang bar ba jal yas su 
BO_TZ_PEMA-SANGTHIG-P25:230	khrag 'thung rol pa'i lha tshhogs rnams //	23	khrag thung rol ba lha tshhogs rnams 
BO_TZ_PEMA-SANGTHIG-P25:231	sgeg cing dpa' ba mi sdug sku //	23	sgeg cing dpa ba mi sdug sku 
BO_TZ_PEMA-SANGTHIG-P25:232	rgod pa drag shul 'jigs rung gsung //	23	rgod ba drag shul jigs rung gsung 
BO_TZ_PEMA-SANGTHIG-P25:233	snying rje rngams zhi ye shes thugs //	23	snying rje rngams zhi ye shes thugs 
BO_TZ_PEMA-SANGTHIG-P25:234	'khor ba dbyings sgrol phrin las ldan //	23	khor ba dbyings sgrol phrin las ldan 
BO_TZ_PEMA-SANGTHIG-P25:235	lnga bcu rtsha brgyad lha la bstod //	23	lnga chu rtsha brgyad lha la bstod 
BO_TZ_PEMA-SANGTHIG-P25:236	hu~m/ longs spyod 'khor lo'i gzhal yas su //	23	longs spyod khor lo jal yas su 
BO_TZ_PEMA-SANGTHIG-P25:237	rig 'dzin dpa' bo mkha' 'gro'i tshhogs //	23	rig dzin dpa bo mkha gro tshhogs 
BO_TZ_PEMA-SANGTHIG-P25:238	zhi chags khro bo'i nyams brgyas sgeg	23	zhi chags khro bo nyams brgyas sgeg 
BO_TZ_PEMA-SANGTHIG-P25:239	/khams gsum 'khor ba'i bag chags bsgral //	23	gsum khor ba bag chags bsgral 
BO_TZ_PEMA-SANGTHIG-P25:240	ye shes rig rtshal gong du spar //	24	ye shes rig rtshal gong du spor 
BO_TZ_PEMA-SANGTHIG-P25:241	rig 'dzin dpa' bo mkha' 'gro la //	24	rig dzin dpa bo mkha gro la 
BO_TZ_PEMA-SANGTHIG-P25:242	lus ngag yid gsum gus pas bstod //	24	lus ngag yid gsum gus ba bstod 
BO_TZ_PEMA-SANGTHIG-P25:243	hu~m/ thugs nyid dwangs ma'i thig le ru //	24	thugs nyid dwangs ma thig le ru 
BO_TZ_PEMA-SANGTHIG-P25:244	lnga ldan 'od kyi gur khang dbus //	24	lnga ldan d kyi gur khang dbus 
BO_TZ_PEMA-SANGTHIG-P25:245	phung lnga rnam dag gshegs pa lnga //	24	phung lnga rnam dag gshegs ba lnga 
BO_TZ_PEMA-SANGTHIG-P25:246	'byung lnga dag pa'i yum dang 'khril //	24	byung lnga dag ba yum dang khril 
BO_TZ_PEMA-SANGTHIG-P25:247	dbang yul sems dpa' sems ma dang // yid chos gnas dag kun bzang yum //	24	dbang yul sems dpa sems ma dang yid chos gnas dag kun bzang yum 
BO_TZ_PEMA-SANGTHIG-P25:248	nyon drug thub drug lus chos bzhi //	24	nyon drug thub drug lus chos bzhi 
BO_TZ_PEMA-SANGTHIG-P25:249	rtag chad mtha' dag sgo srung brgyad //	24	rtag chad mtha dag sgo srung brgyad 
BO_TZ_PEMA-SANGTHIG-P25:250	bzhi bcu rtsha gnyis zhi ba'i tshhogs //	25	bzhi chu rtsha gnyis zhi ba tshhogs 
BO_TZ_PEMA-SANGTHIG-P25:251	'khor 'das rang grol lha la bstod //	25	khor da rang grol lha la bstod 
BO_TZ_PEMA-SANGTHIG-P25:252	de nas / hu~m:	25	de nas hu~m: 
BO_TZ_PEMA-SANGTHIG-P25:253	ma bcos rig pa 'du ma byas :	25	ma chos rig ba du ma byed 
BO_TZ_PEMA-SANGTHIG-P25:254	zhes sogs dzapa? bskul nas brtsham bzlas pa'i thog mar /	25	zhes sogs dzapa? skul nas brtsham bzlas ba thogs mar 
BO_TZ_PEMA-SANGTHIG-P25:255	rang snang ye shes kyi 'khor lo las gnyis pa zhig 'phros te mdun gyi nam mkhar me ri 'dabs 'byar gyi tshhul du bzhugs par bsam la /	25	rang snang ye shes kyi khor lo las gnyis ba jig phro te mdun gyi nam mkhar me ri dabs byor gyi tshhul du bzhugs ba bsam la 
BO_TZ_PEMA-SANGTHIG-P25:256	bdag mdun lha yi skur gsal ba'i :	25	bdag mdun lha yi skur gsal ba 
BO_TZ_PEMA-SANGTHIG-P25:257	zhes sogs nas gzhung gi bzlas pa song nas /	25	zhes sogs nas gzhung gi bzlas ba gro nas 
BO_TZ_PEMA-SANGTHIG-P25:258	om ahhu~m/ rang nyid rtsha gsum kun 'dus mtshho skyes rje'i //	25	om rang nyid rtsha gsum kun du mtshho skye rje 
BO_TZ_PEMA-SANGTHIG-P25:259	dung khang 'bar bar khro bo'i dkyil 'khor dang // mgrin pa'i 'khor lor rig 'dzin bla ma'i tshhogs //	25	dung khang bar ba khro bo dkyil khor dang mgrin ba khor lor rig dzin bla ma tshhogs 
BO_TZ_PEMA-SANGTHIG-P25:260	snying khar zhi ba rdo rje dbyings kyi lha //	26	snying khar zhi ba rdo rje dbyings kyi lha 
BO_TZ_PEMA-SANGTHIG-P25:261	de dag sku las 'od zer rab 'phros shing //	26	de dag sku las d zer rab phro shing 
BO_TZ_PEMA-SANGTHIG-P25:262	dug lnga sgrib pa'i 'khrul snang kun bcom ste //	26	dug lnga sgrib ba khrul snang kun joms ste 
BO_TZ_PEMA-SANGTHIG-P25:263	'od gsal ye shes klong du gsal bar bsam /	26	d gsal ye shes klong du gsal ba bsam 
BO_TZ_PEMA-SANGTHIG-P25:264	om bo d+hi tshit+ta ma ha su kha dz+nya na d+ha tu a:	26	om bo d+hi tshit+ta ma ha su kha dz+nya na d+ha tu a: 
BO_TZ_PEMA-SANGTHIG-P25:265	om ru lu ru lu hu~m b+h+yo hu~m:	26	om ru lu ru lu hu~m b+h+yo hu~m: 
BO_TZ_PEMA-SANGTHIG-P25:266	om ahhu~m ma ha gu ru sarba sid+d+hi hu~m:	26	om ahhu~m ma ha gu ru sarba sid+d+hi hu~m: 
BO_TZ_PEMA-SANGTHIG-P25:267	zhes gang mang bzla /	26	zhes gang mang bzla 
BO_TZ_PEMA-SANGTHIG-P25:268	bum pa / a mr-itas bsang /	26	bum ba a mr-itas bsang 
BO_TZ_PEMA-SANGTHIG-P25:269	swa b+ha was sbyang /	26	swa b+ha was sbyong 
BO_TZ_PEMA-SANGTHIG-P25:270	bum pa b+h+ru~m las gzhal yas khang :	27	bum ba b+h+ru~m las jal yas khang 
BO_TZ_PEMA-SANGTHIG-P25:271	tshhad dang mtshhan nyid yongs rdzogs dbus :	27	tshhad dang mtshhan nyid yongs rdzogs dbus 
BO_TZ_PEMA-SANGTHIG-P25:272	rtsha gsum tshhe yi lha tshhogs dang : zhi khro rab 'byams dkyil 'khor lha //	27	rtsha gsum tshhe yi lha tshhogs dang zhi khro rab byam dkyil khor lha 
BO_TZ_PEMA-SANGTHIG-P25:273	chu zla 'ja' tshhon lta bur gsal :	27	chu zla ja tshhon lta bur gsal 
BO_TZ_PEMA-SANGTHIG-P25:274	rang srog sngags kyi 'od zer ni //	27	rang srog sngags kyi d zer ni 
BO_TZ_PEMA-SANGTHIG-P25:275	gzung thag la 'khril bum nang song //	27	gzung thag la khril bum nang gro 
BO_TZ_PEMA-SANGTHIG-P25:276	bum lha'i sku las bdud rtshi'i rgyun //	27	bum lha sku las bdud rtshi rgyun 
BO_TZ_PEMA-SANGTHIG-P25:277	babs pas bum pa yongs gang gyur //	27	bab ba bum ba yongs gang gyur 
BO_TZ_PEMA-SANGTHIG-P25:278	rtsha sngags mthar om bo d+hi tshit+ta ma ha su kha dz+nya na d+ha tu a:	27	rtsha sngags mthar om bo d+hi tshit+ta ma ha su kha dz+nya na d+ha tu a: 
BO_TZ_PEMA-SANGTHIG-P25:279	om ru lu ru lu hu~m b+h+yo hu~m:	27	om ru lu ru lu hu~m b+h+yo hu~m: 
BO_TZ_PEMA-SANGTHIG-P25:280	om ahhu~m ma ha gu ru sarba sid+d+hi hu~m:	28	om ahhu~m ma ha gu ru sarba sid+d+hi hu~m: 
BO_TZ_PEMA-SANGTHIG-P25:281	ka la sha a b+hi shiny+tsha b+h+ru~m:	28	ka la sha a b+hi shiny+tsha b+h+ru~m: 
BO_TZ_PEMA-SANGTHIG-P25:282	zhes stong du tshhang bar bzlas mthar /	28	zhes stong du tshhang ba bzlas mthar 
BO_TZ_PEMA-SANGTHIG-P25:283	ye shes lha tshhogs spyan 'dren sogs brjod la stong tshhigs 'bul /	28	ye shes lha tshhogs spyan bgrang sogs rjod la stong tshhigs bul 
BO_TZ_PEMA-SANGTHIG-P25:284	om ahhu~m zhes pa'i mchod yon phul bas bum pa'i lha bde stong chen po'i ngo bor 'od du zhu nas bum chu dang ro gcig tu gyur /	28	om ahhu~m zhes ba mchod yon bul ba bum ba lha bde stong chen po ngo bor d du ju nas bum chu dang ro gcig tu gyur 
BO_TZ_PEMA-SANGTHIG-P25:285	las bum la gzungs thag bkod de /	28	las bum la gzungs thag bkod de 
BO_TZ_PEMA-SANGTHIG-P25:286	a mr-itas bsang /	28	a mr-itas bsang 
BO_TZ_PEMA-SANGTHIG-P25:287	swa b+ha was sbyang /	28	swa b+ha was sbyong 
BO_TZ_PEMA-SANGTHIG-P25:288	las bum nang du pad nyi'i steng /	28	las bum nang du pad nyi steng 
BO_TZ_PEMA-SANGTHIG-P25:289	khro chen rta mgrin sku mdog dmar //	28	khro chen rta mgrin sku mdog dmar 
BO_TZ_PEMA-SANGTHIG-P25:290	dbyug to zhags 'dzin de'i sku las //	29	dbyug to zhags dzin de sku las 
BO_TZ_PEMA-SANGTHIG-P25:291	babs pa'i bdud rtshis bum pa gang //	29	bab ba bdud rtshis bum ba gang 
BO_TZ_PEMA-SANGTHIG-P25:292	om h+ya gr-i wa hu~m phatah	29	om h+ya gr-i wa hu~m phatah 
BO_TZ_PEMA-SANGTHIG-P25:293	ces brgya rtsha bzlas mthar /	29	ces brgya rtsha bzlas mthar 
BO_TZ_PEMA-SANGTHIG-P25:294	om ahhu~m zhes pas mchod yon phul bas bum lha 'od du zhu bas bdud rtshi'i chur gyur pa dngos po gang la 'thor ba'i nyes skyon thams cad sbyong ba'i nus pa dang ldan par bsam mo //	29	om ahhu~m zhes ba mchod yon bul ba bum lha d du ju ba bdud rtshi chur(d) gyur ba dngos po gang la thor ba nyes skyon thams cad sbyong ba nus ba dang ldan ba bsam mo 
BO_TZ_PEMA-SANGTHIG-P25:295	skabs 'dir rigs drug gnas sbyong gi dmigs pa spro na /	29	skabs dir rigs drug gnas sbyong gi dmigs ba spro na 
BO_TZ_PEMA-SANGTHIG-P25:296	rang nyid dkyil 'khor lha tshhogs kyi //	29	rang nyid dkyil khor lha tshhogs kyi 
BO_TZ_PEMA-SANGTHIG-P25:297	sku gsung thugs kyi gsang ba las //	29	sku gsung thugs kyi gsang ba las 
BO_TZ_PEMA-SANGTHIG-P25:298	'od zer 'ja' tshhon lta bu'i tshhogs //	29	d zer ja tshhon lta bu tshhogs 
BO_TZ_PEMA-SANGTHIG-P25:299	sngags kyi rang sgra sgrog bzhin 'phros /	29	sngags kyi rang sgra sgrog bzhin phro 
BO_TZ_PEMA-SANGTHIG-P25:300	khams gsum snod bcud 'od kyis gang //	30	khams gsum snod bcud d kyis gang 
BO_TZ_PEMA-SANGTHIG-P25:301	rigs drug gnas rnams dong nas sprug	30	rigs drug gnas rnams dong nas sprug 
BO_TZ_PEMA-SANGTHIG-P25:302	/dmigs yul gtshor byas sems can rnams //	30	yul gtshor byed sems can rnams 
BO_TZ_PEMA-SANGTHIG-P25:303	sangs rgyas go 'phang 'thob par bsam /	30	sangs rgya go phen thob ba bsam 
BO_TZ_PEMA-SANGTHIG-P25:304	om bo d+hi tshit+ta ma ha su kha dz+nya na d+ha tu a:	30	om bo d+hi tshit+ta ma ha su kha dz+nya na d+ha tu a: 
BO_TZ_PEMA-SANGTHIG-P25:305	om ru lu ru lu hu~m b+h+yo hu~m:	30	om ru lu ru lu hu~m b+h+yo hu~m: 
BO_TZ_PEMA-SANGTHIG-P25:306	om ahhu~m ma ha gu ru sarba sid+d+hi hu~m:	30	om ahhu~m ma ha gu ru sarba sid+d+hi hu~m: 
BO_TZ_PEMA-SANGTHIG-P25:307	zhes zhi khro rtsha sngags gsum gyi mthar /	30	zhes zhi khro rtsha sngags gsum gyi mthar 
BO_TZ_PEMA-SANGTHIG-P25:308	ma ma ko lim sa man+ta :	30	ma ma ko lim sa man+ta 
BO_TZ_PEMA-SANGTHIG-P25:309	sarba pa pam bi shud+d+he swa ha:	30	sarba ba pam bi shud+d+he swa ha: 
BO_TZ_PEMA-SANGTHIG-P25:310	zhes dang yi ge brgya pa yang cung zad bzla /	31	zhes dang yi ge brgya ba yang cung zad bzla 
BO_TZ_PEMA-SANGTHIG-P25:311	bye ma dang yungs dkar la phu gdab bo //	31	bye ma dang yungs dkar la phu gdab bo 
BO_TZ_PEMA-SANGTHIG-P25:312	(tshhe 'gugs dgos na zur byang ltar 'dir gyer /mchan /)	31	(tshhe gugs dgos na zur byang ltar dir gyer 
BO_TZ_PEMA-SANGTHIG-P25:313	de nas spyi dang bye brag gi srung ma'i gtor 'bul song nas /	31	de nas spyi dang bye brag gi srung ma thor bul gro nas 
BO_TZ_PEMA-SANGTHIG-P25:314	de nas bsod nams gsag pa'i phyir /	31	de nas bsod nams gsag ba phyir 
BO_TZ_PEMA-SANGTHIG-P25:315	phyi yi mchod pa 'bul ba ni /	31	phyi yi mchod ba bul ba ni 
BO_TZ_PEMA-SANGTHIG-P25:316	hu~m hri: rtsha gsum tshhe yi lha tshhogs dang : rgyal ba zhi khro rab 'byams dang : mkha' 'gro chos skyong bcas pa la :	31	hu~m hri: rtsha gsum tshhe yi lha tshhogs dang rgyal ba zhi khro rab byam dang mkha gro chos skyong cha ba la 
BO_TZ_PEMA-SANGTHIG-P25:317	bdag sogs tshhogs gnyis gsag pa'i phyir :	31	bdag sogs tshhogs gnyis gsag ba phyir 
BO_TZ_PEMA-SANGTHIG-P25:318	stong gsum 'di 'am gzhan dag na :	31	stong gsum di mang gzhan dag na 
BO_TZ_PEMA-SANGTHIG-P25:319	yan lag brgyad ldan chu bo kun :	31	yan lag brgyad ldan chu bo kun 
BO_TZ_PEMA-SANGTHIG-P25:320	rgyal ba zhi khro'i tshhogs la 'bul :	32	rgyal ba zhi khro tshhogs la bul 
BO_TZ_PEMA-SANGTHIG-P25:321	lus ngag yid gsum sgrib dag nas :	32	lus ngag yid gsum sgrib dag nas 
BO_TZ_PEMA-SANGTHIG-P25:322	bsod nams ye shes tshhogs rdzogs shog :	32	bsod nams ye shes tshhogs rdzogs shog 
BO_TZ_PEMA-SANGTHIG-P25:323	hu~m hri: rtsha gsum tshhe yi lha tshhogs dang : rgyal ba zhi khro rab 'byams dang : mkha' 'gro chos skyong bcas pa la :	32	hu~m hri: rtsha gsum tshhe yi lha tshhogs dang rgyal ba zhi khro rab byam dang mkha gro chos skyong cha ba la 
BO_TZ_PEMA-SANGTHIG-P25:324	bdag sogs tshhogs gnyis gsag pa'i phyir :	32	bdag sogs tshhogs gnyis gsag ba phyir 
BO_TZ_PEMA-SANGTHIG-P25:325	stong gsum 'di 'am gzhan dag na :	32	stong gsum di mang gzhan dag na 
BO_TZ_PEMA-SANGTHIG-P25:326	dag byed sman dang spos chu'i rigs :	32	dag byed sman dang spros chu rigs 
BO_TZ_PEMA-SANGTHIG-P25:327	rgyal ba zhi khro'i tshhogs la 'bul :	32	rgyal ba zhi khro tshhogs la bul 
BO_TZ_PEMA-SANGTHIG-P25:328	lus ngag yid gsum sgrib dag nas :	32	lus ngag yid gsum sgrib dag nas 
BO_TZ_PEMA-SANGTHIG-P25:329	bsod nams ye shes tshhogs rdzogs shog :	32	bsod nams ye shes tshhogs rdzogs shog 
BO_TZ_PEMA-SANGTHIG-P25:330	hu~m hri: rtsha gsum tshhe yi lha tshhogs dang : rgyal ba zhi khro rab 'byams dang : mkha' 'gro chos skyong bcas pa la :	33	hu~m hri: rtsha gsum tshhe yi lha tshhogs dang rgyal ba zhi khro rab byam dang mkha gro chos skyong cha ba la 
BO_TZ_PEMA-SANGTHIG-P25:331	bdag sogs tshhogs gnyis gsag pa'i phyir :	33	bdag sogs tshhogs gnyis gsag ba phyir 
BO_TZ_PEMA-SANGTHIG-P25:332	stong gsum 'di 'am gzhan dag na :	33	stong gsum di mang gzhan dag na 
BO_TZ_PEMA-SANGTHIG-P25:333	ngo mtshhar me tog lta na sdug :	33	ngo mtshhar me tog lta na sdug 
BO_TZ_PEMA-SANGTHIG-P25:334	rgyal ba zhi khro'i tshhogs la 'bul :	33	rgyal ba zhi khro tshhogs la bul 
BO_TZ_PEMA-SANGTHIG-P25:335	lus ngag yid gsum sgrib dag nas :	33	lus ngag yid gsum sgrib dag nas 
BO_TZ_PEMA-SANGTHIG-P25:336	bsod nams ye shes tshhogs rdzogs shog :	33	bsod nams ye shes tshhogs rdzogs shog 
BO_TZ_PEMA-SANGTHIG-P25:337	hu~m hri: rtsha gsum tshhe yi lha tshhogs dang : rgyal ba zhi khro rab 'byams dang : mkha' 'gro chos skyong bcas pa la :	33	hu~m hri: rtsha gsum tshhe yi lha tshhogs dang rgyal ba zhi khro rab byam dang mkha gro chos skyong cha ba la 
BO_TZ_PEMA-SANGTHIG-P25:338	bdag sogs tshhogs gnyis gsag pa'i phyir :	33	bdag sogs tshhogs gnyis gsag ba phyir 
BO_TZ_PEMA-SANGTHIG-P25:339	stong gsum 'di 'am gzhan dag na :	33	stong gsum di mang gzhan dag na 
BO_TZ_PEMA-SANGTHIG-P25:340	lhan cig skyes dang sbyar pa'i dri :	34	lhan cig skye dang sbyor ba dri 
BO_TZ_PEMA-SANGTHIG-P25:341	rgyal ba zhi khro'i tshhogs la 'bul :	34	rgyal ba zhi khro tshhogs la bul 
BO_TZ_PEMA-SANGTHIG-P25:342	lus ngag yid gsum sgrib dag nas :	34	lus ngag yid gsum sgrib dag nas 
BO_TZ_PEMA-SANGTHIG-P25:343	bsod nams ye shes tshhogs rdzogs shog :	34	bsod nams ye shes tshhogs rdzogs shog 
BO_TZ_PEMA-SANGTHIG-P25:344	hu~m hri: rtsha gsum tshhe yi lha tshhogs dang : rgyal ba zhi khro rab 'byams dang : mkha' 'gro chos skyong bcas pa la :	34	hu~m hri: rtsha gsum tshhe yi lha tshhogs dang rgyal ba zhi khro rab byam dang mkha gro chos skyong cha ba la 
BO_TZ_PEMA-SANGTHIG-P25:345	bdag sogs tshhogs gnyis gsag pa'i phyir :	34	bdag sogs tshhogs gnyis gsag ba phyir 
BO_TZ_PEMA-SANGTHIG-P25:346	stong gsum 'di 'am gzhan dag na :	34	stong gsum di mang gzhan dag na 
BO_TZ_PEMA-SANGTHIG-P25:347	nyi zla la sogs snang gsal sgron :	34	nyi zla la sogs snang gsal sgron 
BO_TZ_PEMA-SANGTHIG-P25:348	rgyal ba zhi khro'i tshhogs la 'bul :	34	rgyal ba zhi khro tshhogs la bul 
BO_TZ_PEMA-SANGTHIG-P25:349	lus ngag yid gsum sgrib dag nas :	34	lus ngag yid gsum sgrib dag nas 
BO_TZ_PEMA-SANGTHIG-P25:350	bsod nams ye shes tshhogs rdzogs shog :	35	bsod nams ye shes tshhogs rdzogs shog 
BO_TZ_PEMA-SANGTHIG-P25:351	hu~m hri: rtsha gsum tshhe yi lha tshhogs dang : rgyal ba zhi khro rab 'byams dang : mkha' 'gro chos skyong bcas pa la :	35	hu~m hri: rtsha gsum tshhe yi lha tshhogs dang rgyal ba zhi khro rab byam dang mkha gro chos skyong cha ba la 
BO_TZ_PEMA-SANGTHIG-P25:352	bdag sogs tshhogs gnyis gsag pa'i phyir :	35	bdag sogs tshhogs gnyis gsag ba phyir 
BO_TZ_PEMA-SANGTHIG-P25:353	stong gsum 'di 'am gzhan dag na :	35	stong gsum di mang gzhan dag na 
BO_TZ_PEMA-SANGTHIG-P25:354	bde ba skyed pa'i dri yi chab :	35	bde ba skyed ba dri yi chab 
BO_TZ_PEMA-SANGTHIG-P25:355	rgyal ba zhi khro'i tshhogs la 'bul :	35	rgyal ba zhi khro tshhogs la bul 
BO_TZ_PEMA-SANGTHIG-P25:356	lus ngag yid gsum sgrib dag nas :	35	lus ngag yid gsum sgrib dag nas 
BO_TZ_PEMA-SANGTHIG-P25:357	bsod nams ye shes tshhogs rdzogs shog :	35	bsod nams ye shes tshhogs rdzogs shog 
BO_TZ_PEMA-SANGTHIG-P25:358	hu~m hri: rtsha gsum tshhe yi lha tshhogs dang : rgyal ba zhi khro rab 'byams dang : mkha' 'gro chos skyong bcas pa la :	35	hu~m hri: rtsha gsum tshhe yi lha tshhogs dang rgyal ba zhi khro rab byam dang mkha gro chos skyong cha ba la 
BO_TZ_PEMA-SANGTHIG-P25:359	bdag sogs tshhogs gnyis gsag pa'i phyir :	35	bdag sogs tshhogs gnyis gsag ba phyir 
BO_TZ_PEMA-SANGTHIG-P25:360	stong gsum 'di 'am gzhan dag na :	36	stong gsum di mang gzhan dag na 
BO_TZ_PEMA-SANGTHIG-P25:361	dkar gsum mngar gsum bza' bca'i rigs :	36	dkar gsum mngar gsum bza bca rigs 
BO_TZ_PEMA-SANGTHIG-P25:362	rgyal ba zhi khro'i tshhogs la 'bul :	36	rgyal ba zhi khro tshhogs la bul 
BO_TZ_PEMA-SANGTHIG-P25:363	lus ngag yid gsum sgrib dag nas :	36	lus ngag yid gsum sgrib dag nas 
BO_TZ_PEMA-SANGTHIG-P25:364	bsod nams ye shes tshhogs rdzogs shog :	36	bsod nams ye shes tshhogs rdzogs shog 
BO_TZ_PEMA-SANGTHIG-P25:365	hu~m hri: rtsha gsum tshhe yi lha tshhogs dang : rgyal ba zhi khro rab 'byams dang : mkha' 'gro chos skyong bcas pa la :	36	hu~m hri: rtsha gsum tshhe yi lha tshhogs dang rgyal ba zhi khro rab byam dang mkha gro chos skyong cha ba la 
BO_TZ_PEMA-SANGTHIG-P25:366	bdag sogs tshhogs gnyis gsag pa'i phyir :	36	bdag sogs tshhogs gnyis gsag ba phyir 
BO_TZ_PEMA-SANGTHIG-P25:367	stong gsum 'di 'am gzhan dag na :	36	stong gsum di mang gzhan dag na 
BO_TZ_PEMA-SANGTHIG-P25:368	snyan 'gyur rol mo'i sgra dbyangs sogs :	36	snyan gyur rol mo sgra dbyangs sogs 
BO_TZ_PEMA-SANGTHIG-P25:369	rgyal ba zhi khro'i tshhogs la 'bul :	36	rgyal ba zhi khro tshhogs la bul 
BO_TZ_PEMA-SANGTHIG-P25:370	lus ngag yid gsum sgrib dag nas :	37	lus ngag yid gsum sgrib dag nas 
BO_TZ_PEMA-SANGTHIG-P25:371	bsod nams ye shes tshhogs rdzogs shog :	37	bsod nams ye shes tshhogs rdzogs shog 
BO_TZ_PEMA-SANGTHIG-P25:372	de nas nang mchod 'bul ba ni /	37	de nas nang mchod bul ba ni 
BO_TZ_PEMA-SANGTHIG-P25:373	hu~m: spyi gtshug bde chen b+han+d+ha ru :	37	hu~m: spyi gtshug bde chen b+han+d+ha ru 
BO_TZ_PEMA-SANGTHIG-P25:374	go ro tsha na'i bdud rtshis bkang :	37	go ro tsha na bdud rtshis geng 
BO_TZ_PEMA-SANGTHIG-P25:375	'di ni bdud rtshi sman gyi mchog :	37	di ni bdud rtshi sman gyi mchog 
BO_TZ_PEMA-SANGTHIG-P25:376	rtsha gsum tshhe yi lha tshhogs dang : zhi khro rab 'byams thugs dam bskang :	37	rtsha gsum tshhe yi lha tshhogs dang zhi khro rab byam thugs dam skong 
BO_TZ_PEMA-SANGTHIG-P25:377	mgrin pa longs spyod b+han+d+ha ru :	37	mgrin ba longs spyod b+han+d+ha ru 
BO_TZ_PEMA-SANGTHIG-P25:378	dmar gsal byang sems bdud rtshis bkang :	37	dmar gsal byang sems bdud rtshis geng 
BO_TZ_PEMA-SANGTHIG-P25:379	'di ni bdud rtshi sman gyi mchog :	37	di ni bdud rtshi sman gyi mchog 
BO_TZ_PEMA-SANGTHIG-P25:380	rtsha gsum tshhe yi lha tshhogs dang : zhi khro rab 'byams thugs dam bskang :	38	rtsha gsum tshhe yi lha tshhogs dang zhi khro rab byam thugs dam skong 
BO_TZ_PEMA-SANGTHIG-P25:381	snying ga chos dbyings b+han+d+ha ru :	38	snying ga chos dbyings b+han+d+ha ru 
BO_TZ_PEMA-SANGTHIG-P25:382	byang chub sems kyi bdud rtshis bkang :	38	byang chub sems kyi bdud rtshis geng 
BO_TZ_PEMA-SANGTHIG-P25:383	'di ni bdud rtshi sman gyi mchog :	38	di ni bdud rtshi sman gyi mchog 
BO_TZ_PEMA-SANGTHIG-P25:384	rtsha gsum tshhe yi lha tshhogs dang : zhi khro rab 'byams thugs dam bskang :	38	rtsha gsum tshhe yi lha tshhogs dang zhi khro rab byam thugs dam skong 
BO_TZ_PEMA-SANGTHIG-P25:385	lte ba sprul pa'i b+han+d+ha ru :	38	lte ba sprul ba b+han+d+ha ru 
BO_TZ_PEMA-SANGTHIG-P25:386	ser gsal dri chen bdud rtshis bkang :	38	ser gsal dri chen bdud rtshis geng 
BO_TZ_PEMA-SANGTHIG-P25:387	'di ni bdud rtshi sman gyi mchog :	38	di ni bdud rtshi sman gyi mchog 
BO_TZ_PEMA-SANGTHIG-P25:388	rtsha gsum tshhe yi lha tshhogs dang : zhi khro rab 'byams thugs dam bskang :	38	rtsha gsum tshhe yi lha tshhogs dang zhi khro rab byam thugs dam skong 
BO_TZ_PEMA-SANGTHIG-P25:389	gsang ba bde skyong b+han+d+ha ru :	38	gsang ba bde skyong b+han+d+ha ru 
BO_TZ_PEMA-SANGTHIG-P25:390	dag byed dri chu'i bdud rtshis bkang :	39	dag byed dri chu bdud rtshis geng 
BO_TZ_PEMA-SANGTHIG-P25:391	'di ni bdud rtshi sman gyi mchog :	39	di ni bdud rtshi sman gyi mchog 
BO_TZ_PEMA-SANGTHIG-P25:392	rtsha gsum tshhe yi lha tshhogs dang : zhi khro rab 'byams thugs dam bskang :	39	rtsha gsum tshhe yi lha tshhogs dang zhi khro rab byam thugs dam skong 
BO_TZ_PEMA-SANGTHIG-P25:393	de nas gsang mchod 'bul ba ni /	39	de nas gsang mchod bul ba ni 
BO_TZ_PEMA-SANGTHIG-P25:394	hu~m: gti mug bsgral pa'i b+han+d+ha ru :	39	hu~m: gti mug bsgral ba b+han+d+ha ru 
BO_TZ_PEMA-SANGTHIG-P25:395	chos kyi dbyings kyi rak+tas bkang :	39	chos kyi dbyings kyi rak+tas geng 
BO_TZ_PEMA-SANGTHIG-P25:396	chags med rak+ta'i mchod pa 'dis :	39	chags med rak+ta mchod ba dis 
BO_TZ_PEMA-SANGTHIG-P25:397	rtsha gsum tshhe yi lha tshhogs dang : zhi khro rab 'byams thugs dam bskang :	39	rtsha gsum tshhe yi lha tshhogs dang zhi khro rab byam thugs dam skong 
BO_TZ_PEMA-SANGTHIG-P25:398	'dod chags bsgral pa'i b+han+d+ha ru :	39	dod chags bsgral ba b+han+d+ha ru 
BO_TZ_PEMA-SANGTHIG-P25:399	sor rtog ye shes rak+tas bkang :	39	sor rtogs ye shes rak+tas geng 
BO_TZ_PEMA-SANGTHIG-P25:400	chags med rak+ta'i mchod pa 'dis :	40	chags med rak+ta mchod ba dis 
BO_TZ_PEMA-SANGTHIG-P25:401	rtsha gsum tshhe yi lha tshhogs dang : zhi khro rab 'byams thugs dam bskang :	40	rtsha gsum tshhe yi lha tshhogs dang zhi khro rab byam thugs dam skong 
BO_TZ_PEMA-SANGTHIG-P25:402	zhe sdang bsgral pa'i b+han+d+ha ru :	40	zhe sdang bsgral ba b+han+d+ha ru 
BO_TZ_PEMA-SANGTHIG-P25:403	me long ye shes rak+tas bkang :	40	me long ye shes rak+tas geng 
BO_TZ_PEMA-SANGTHIG-P25:404	chags med rak+ta'i mchod pa 'dis :	40	chags med rak+ta mchod ba dis 
BO_TZ_PEMA-SANGTHIG-P25:405	rtsha gsum tshhe yi lha tshhogs dang : zhi khro rab 'byams thugs dam bskang :	40	rtsha gsum tshhe yi lha tshhogs dang zhi khro rab byam thugs dam skong 
BO_TZ_PEMA-SANGTHIG-P25:406	nga rgyal bsgral pa'i b+han+d+ha ru :	40	nga rgyal bsgral ba b+han+d+ha ru 
BO_TZ_PEMA-SANGTHIG-P25:407	mnyam nyid ye shes rak+tas bkang :	40	mnyam nyid ye shes rak+tas geng 
BO_TZ_PEMA-SANGTHIG-P25:408	chags med rak+ta'i mchod pa 'dis :	40	chags med rak+ta mchod ba dis 
BO_TZ_PEMA-SANGTHIG-P25:409	rtsha gsum tshhe yi lha tshhogs dang : zhi khro rab 'byams thugs dam bskang :	40	rtsha gsum tshhe yi lha tshhogs dang zhi khro rab byam thugs dam skong 
BO_TZ_PEMA-SANGTHIG-P25:410	phrag dog bsgral pa'i b+han+d+ha ru :	41	phrag dog bsgral ba b+han+d+ha ru 
BO_TZ_PEMA-SANGTHIG-P25:411	bya grub ye shes rak+tas bkang :	41	byed grub ye shes rak+tas geng 
BO_TZ_PEMA-SANGTHIG-P25:412	chags med rak+ta'i mchod pa 'dis :	41	chags med rak+ta mchod ba dis 
BO_TZ_PEMA-SANGTHIG-P25:413	rtsha gsum tshhe yi lha tshhogs dang : zhi khro rab 'byams thugs dam bskang :	41	rtsha gsum tshhe yi lha tshhogs dang zhi khro rab byam thugs dam skong 
BO_TZ_PEMA-SANGTHIG-P25:414	de kho na nyid kyi mchod pa ni /	41	de kho na nyid kyi mchod ba ni 
BO_TZ_PEMA-SANGTHIG-P25:415	hu~m: zhing chen lpags pa'i gtor gzhong du :	41	hu~m: zhing chen lpags ba thor gzhong du 
BO_TZ_PEMA-SANGTHIG-P25:416	sha dang rus pa'i gtor ma bshams :	41	sha dang rus ba thor ma bshams 
BO_TZ_PEMA-SANGTHIG-P25:417	dbang po rnam lngas brgyan pa 'dis :	41	dbang po rnam lngas rgyan ba dis 
BO_TZ_PEMA-SANGTHIG-P25:418	rtsha gsum tshhe yi lha tshhogs dang : zhi khro rab 'byams thugs dam bskang :	41	rtsha gsum tshhe yi lha tshhogs dang zhi khro rab byam thugs dam skong 
BO_TZ_PEMA-SANGTHIG-P25:419	'khor lo lnga yi gtor gzhong du :	41	khor lo lnga yi thor gzhong du 
BO_TZ_PEMA-SANGTHIG-P25:420	bdud rtshi lnga yi gtor ma bshams :	42	bdud rtshi lnga yi thor ma bshams 
BO_TZ_PEMA-SANGTHIG-P25:421	don snod lnga yis brgyan pa 'dis :	42	don snod lnga yis rgyan ba dis 
BO_TZ_PEMA-SANGTHIG-P25:422	rtsha gsum tshhe yi lha tshhogs dang : zhi khro rab 'byams thugs dam bskang :	42	rtsha gsum tshhe yi lha tshhogs dang zhi khro rab byam thugs dam skong 
BO_TZ_PEMA-SANGTHIG-P25:423	dwangs gsal rtsha yi gtor gzhong du :	42	dwangs gsal rtsha yi thor gzhong du 
BO_TZ_PEMA-SANGTHIG-P25:424	ye shes klong lnga'i gtor ma bshams :	42	ye shes klong lnga thor ma bshams 
BO_TZ_PEMA-SANGTHIG-P25:425	dkar dmar thig les brgyan pa 'dis :	42	dkar dmar thig les rgyan ba dis 
BO_TZ_PEMA-SANGTHIG-P25:426	rtsha gsum tshhe yi lha tshhogs dang : zhi khro rab 'byams thugs dam bskang :	42	rtsha gsum tshhe yi lha tshhogs dang zhi khro rab byam thugs dam skong 
BO_TZ_PEMA-SANGTHIG-P25:427	thabs dang shes rab gtor gzhong du :	42	thabs dang shes rab thor gzhong du 
BO_TZ_PEMA-SANGTHIG-P25:428	rtsha rlung thig le'i gtor ma bshams :	42	rtsha rlung thig le thor ma bshams 
BO_TZ_PEMA-SANGTHIG-P25:429	bde ba chen pos brgyan pa 'dis :	42	bde ba chen pos rgyan ba dis 
BO_TZ_PEMA-SANGTHIG-P25:430	rtsha gsum tshhe yi lha tshhogs dang : zhi khro rab 'byams thugs dam bskang :	43	rtsha gsum tshhe yi lha tshhogs dang zhi khro rab byam thugs dam skong 
BO_TZ_PEMA-SANGTHIG-P25:431	kun khyab dbyings kyi gtor gzhong du :	43	kun khyab dbyings kyi thor gzhong du 
BO_TZ_PEMA-SANGTHIG-P25:432	rang gsal ye shes gtor ma bshams :	43	rang gsal ye shes thor ma bshams 
BO_TZ_PEMA-SANGTHIG-P25:433	sna tshhogs snang bas brgyan pa 'dis :	43	sna tshhogs snang ba rgyan ba dis 
BO_TZ_PEMA-SANGTHIG-P25:434	rtsha gsum tshhe yi lha tshhogs dang : zhi khro rab 'byams thugs dam bskang :	43	rtsha gsum tshhe yi lha tshhogs dang zhi khro rab byam thugs dam skong 
BO_TZ_PEMA-SANGTHIG-P25:435	phyi nang gsang gsum kho na nyid //	43	phyi nang gsang gsum kho na nyid 
BO_TZ_PEMA-SANGTHIG-P25:436	thams cad 'dus pa'i mchod pa ni //	43	thams cad du ba mchod ba ni 
BO_TZ_PEMA-SANGTHIG-P25:437	hu~m: thabs dang shes rab b+han+d+ha ru :	43	hu~m: thabs dang shes rab b+han+d+ha ru 
BO_TZ_PEMA-SANGTHIG-P25:438	dga' ba'i rang bzhin tshhogs gtor bshams :	43	dga ba rang bzhin tshhogs thor bshams 
BO_TZ_PEMA-SANGTHIG-P25:439	rmad du byung ba'i mchod pa 'dis :	43	rmad du byung ba mchod ba dis 
BO_TZ_PEMA-SANGTHIG-P25:440	rtsha gsum tshhe yi lha tshhogs dang : zhi khro rab 'byams thugs dam bskang :	44	rtsha gsum tshhe yi lha tshhogs dang zhi khro rab byam thugs dam skong 
BO_TZ_PEMA-SANGTHIG-P25:441	gnyis med mnyam sbyor ban+d+ha ru :	44	gnyis med mnyam sbyor ban+d+ha ru 
BO_TZ_PEMA-SANGTHIG-P25:442	mchog gi dga' ba'i tshhogs gtor bshams :	44	mchog gi dga ba tshhogs thor bshams 
BO_TZ_PEMA-SANGTHIG-P25:443	rmad du byung ba'i mchod pa 'dis :	44	rmad du byung ba mchod ba dis 
BO_TZ_PEMA-SANGTHIG-P25:444	rtsha gsum tshhe yi lha tshhogs dang : zhi khro rab 'byams thugs dam bskang :	44	rtsha gsum tshhe yi lha tshhogs dang zhi khro rab byam thugs dam skong 
BO_TZ_PEMA-SANGTHIG-P25:445	dkar dmar 'bab pa'i b+han+d+ha ru :	44	dkar dmar bab ba b+han+d+ha ru 
BO_TZ_PEMA-SANGTHIG-P25:446	khyad par dga' ba'i tshhogs gtor bshams :	44	khyad ba dga ba tshhogs thor bshams 
BO_TZ_PEMA-SANGTHIG-P25:447	rmad du byung ba'i mchod pa 'dis :	44	rmad du byung ba mchod ba dis 
BO_TZ_PEMA-SANGTHIG-P25:448	rtsha gsum tshhe yi lha tshhogs dang : zhi khro rab 'byams thugs dam bskang :	44	rtsha gsum tshhe yi lha tshhogs dang zhi khro rab byam thugs dam skong 
BO_TZ_PEMA-SANGTHIG-P25:449	byang sems 'dres pa'i b+han+d+ha ru :	44	byang sems dre ba b+han+d+ha ru 
BO_TZ_PEMA-SANGTHIG-P25:450	dga' bral ye shes tshhogs gtor bshams :	45	dga bral ye shes tshhogs thor bshams 
BO_TZ_PEMA-SANGTHIG-P25:451	rmad du byung ba'i mchod pa 'dis :	45	rmad du byung ba mchod ba dis 
BO_TZ_PEMA-SANGTHIG-P25:452	rtsha gsum tshhe yi lha tshhogs dang : zhi khro rab 'byams thugs dam bskang :	45	rtsha gsum tshhe yi lha tshhogs dang zhi khro rab byam thugs dam skong 
BO_TZ_PEMA-SANGTHIG-P25:453	bde ba gyen 'khyil b+han+d+ha ru :	45	bde ba gyen khyil b+han+d+ha ru 
BO_TZ_PEMA-SANGTHIG-P25:454	lugs ldog dga' bzhi'i tshhogs gtor bshams :	45	lugs ldog dga bzhi tshhogs thor bshams 
BO_TZ_PEMA-SANGTHIG-P25:455	rmad du byung ba'i mchod pa 'dis :	45	rmad du byung ba mchod ba dis 
BO_TZ_PEMA-SANGTHIG-P25:456	rtsha gsum tshhe yi lha tshhogs dang : zhi khro rab 'byams thugs dam bskang :	45	rtsha gsum tshhe yi lha tshhogs dang zhi khro rab byam thugs dam skong 
BO_TZ_PEMA-SANGTHIG-P25:457	mnyam rdzogs ye shes mchod pa ni /	45	mnyam rdzogs ye shes mchod ba ni 
BO_TZ_PEMA-SANGTHIG-P25:458	hu~m: phung po lus kyi kong bu ru :	45	hu~m: phung po lus kyi kong bu ru 
BO_TZ_PEMA-SANGTHIG-P25:459	rtsha gsum 'khor lo'i sdong bu btshug :	45	rtsha gsum khor lo sdong bu btshug 
BO_TZ_PEMA-SANGTHIG-P25:460	bdud rtshi rnam lnga'i mar khus gtams :	46	bdud rtshi rnam lnga mar khus gtams 
BO_TZ_PEMA-SANGTHIG-P25:461	ye nas dag pa'i me sbar ba :	46	ye nas dag ba me sbor ba 
BO_TZ_PEMA-SANGTHIG-P25:462	rmad du byung ba'i snang gsal 'dis :	46	rmad du byung ba snang gsal dis 
BO_TZ_PEMA-SANGTHIG-P25:463	rtsha gsum tshhe yi lha tshhogs dang : zhi khro rab 'byams thugs dam bskang :	46	rtsha gsum tshhe yi lha tshhogs dang zhi khro rab byam thugs dam skong 
BO_TZ_PEMA-SANGTHIG-P25:464	yab yum thabs shes kong bu ru :	46	yab yum thabs shes kong bu ru 
BO_TZ_PEMA-SANGTHIG-P25:465	byang chub sems kyi mar khus gtams :	46	byang chub sems kyi mar khus gtams 
BO_TZ_PEMA-SANGTHIG-P25:466	rlung gi 'gro 'ong sdong bu btshug :	46	rlung gi gro ng sdong bu btshug 
BO_TZ_PEMA-SANGTHIG-P25:467	bde ba chen pos me sbar ba :	46	bde ba chen pos me sbor ba 
BO_TZ_PEMA-SANGTHIG-P25:468	rmad du byung ba'i snang gsal 'dis :	46	rmad du byung ba snang gsal dis 
BO_TZ_PEMA-SANGTHIG-P25:469	rtsha gsum tshhe yi lha tshhogs dang : zhi khro rab 'byams thugs dam bskang :	46	rtsha gsum tshhe yi lha tshhogs dang zhi khro rab byam thugs dam skong 
BO_TZ_PEMA-SANGTHIG-P25:470	snang ba bde ba'i kong bu ru :	47	snang ba bde ba kong bu ru 
BO_TZ_PEMA-SANGTHIG-P25:471	mched pa gsal ba'i mar khus gtams :	47	mched ba gsal ba mar khus gtams 
BO_TZ_PEMA-SANGTHIG-P25:472	thob pa mi rtog sdong bu btshug :	47	thob ba mi rtogs sdong bu btshug 
BO_TZ_PEMA-SANGTHIG-P25:473	'od gsal ye shes me sbar ba :	47	d gsal ye shes me sbor ba 
BO_TZ_PEMA-SANGTHIG-P25:474	rmad du byung ba'i snang gsal 'dis :	47	rmad du byung ba snang gsal dis 
BO_TZ_PEMA-SANGTHIG-P25:475	rtsha gsum tshhe yi lha tshhogs dang : zhi khro rab 'byams thugs dam bskang :	47	rtsha gsum tshhe yi lha tshhogs dang zhi khro rab byam thugs dam skong 
BO_TZ_PEMA-SANGTHIG-P25:476	yul snang stong pa'i kong bu ru :	47	yul snang stong ba kong bu ru 
BO_TZ_PEMA-SANGTHIG-P25:477	dbang po'i byed las mar khus gtams :	47	dbang po byed las mar khus gtams 
BO_TZ_PEMA-SANGTHIG-P25:478	rnam shes tshhogs brgyad sdong bu btshug :	47	rnam shes tshhogs brgyad sdong bu btshug 
BO_TZ_PEMA-SANGTHIG-P25:479	gnyis med spros bral me sbar ba :	47	gnyis med spros bral me sbor ba 
BO_TZ_PEMA-SANGTHIG-P25:480	rmad du byung ba'i snang gsal 'dis :	48	rmad du byung ba snang gsal dis 
BO_TZ_PEMA-SANGTHIG-P25:481	rtsha gsum tshhe yi lha tshhogs dang : zhi khro rab 'byams thugs dam bskang :	48	rtsha gsum tshhe yi lha tshhogs dang zhi khro rab byam thugs dam skong 
BO_TZ_PEMA-SANGTHIG-P25:482	skye ba med pa'i kong bu ru :	48	skye ba med ba kong bu ru 
BO_TZ_PEMA-SANGTHIG-P25:483	'gag pa med pa'i mar khus gtams :	48	gag ba med ba mar khus gtams 
BO_TZ_PEMA-SANGTHIG-P25:484	'gro 'ong gnas med sdong bu btshug :	48	gro ng gnas med sdong bu btshug 
BO_TZ_PEMA-SANGTHIG-P25:485	phyi nang zang thal me sbar ba :	48	phyi nang zang thal me sbor ba 
BO_TZ_PEMA-SANGTHIG-P25:486	rmad du byung ba'i snang gsal 'dis :	48	rmad du byung ba snang gsal dis 
BO_TZ_PEMA-SANGTHIG-P25:487	rtsha gsum tshhe yi lha tshhogs dang : zhi khro rab 'byams thugs dam bskang :	48	rtsha gsum tshhe yi lha tshhogs dang zhi khro rab byam thugs dam skong 
BO_TZ_PEMA-SANGTHIG-P25:488	bcas so // !	48	cha so 
BO_TZ_PEMA-SANGTHIG-P25:489	//skabs 'dir rigs drug gnas sbyong bya bar spro na tshhe 'das gnas 'dren skabs ltar tshhig kha cung zad bsgyur nas 'dir bya'o //	48	dir rigs drug gnas sbyong byed ba spro na tshhe da gnas bgrang skabs ltar tshhig kha cung zad sgyur nas dir byed 
BO_TZ_PEMA-SANGTHIG-P25:490	! //de nas dang po lus sgrib sbyong phyir mtshhan nas brjod cing phyag 'tshhal ba ni /	49	nas dang po lus sgrib sbyong phyir mtshhan nas rjod cing phyag tshhal ba ni 
BO_TZ_PEMA-SANGTHIG-P25:491	e ma ho :	49	e ma ho 
BO_TZ_PEMA-SANGTHIG-P25:492	chos dbyings rab 'byams rgyal ba'i dkyil 'khor 'dir :	49	chos dbyings rab byam rgyal ba dkyil khor dir 
BO_TZ_PEMA-SANGTHIG-P25:493	phyogs bcu dus bzhi rgyal ba sras dang bcas :	49	phyogs chu dus bzhi rgyal ba sras dang cha 
BO_TZ_PEMA-SANGTHIG-P25:494	thugs rjes 'gro ba'i don phyir gshegs su gsol :	49	thugs rjes gro ba don phyir gshegs su gsol 
BO_TZ_PEMA-SANGTHIG-P25:495	rin chen pad+ma nyi zla'i gdan la bzhugs :	49	rin chen pad+ma nyi zla gdan la bzhugs 
BO_TZ_PEMA-SANGTHIG-P25:496	kun bzang mchod pa'i sprin gyis mchod par bgyi :	49	kun bzang mchod ba sprin gyis mchod ba bgyid 
BO_TZ_PEMA-SANGTHIG-P25:497	a la la ho :	49	a la la ho 
BO_TZ_PEMA-SANGTHIG-P25:498	don dam chos dbyings yum gyi b+ha ga'i klong :	49	don dam chos dbyings yum gyi b+ha ga klong 
BO_TZ_PEMA-SANGTHIG-P25:499	mkha' dbyings yangs pa'i dkyil 'khor chen po na :	49	mkha dbyings yangs ba dkyil khor chen po na 
BO_TZ_PEMA-SANGTHIG-P25:500	bzhugs pa'i phyogs bcu dus gsum bde bar gshegs :	50	bzhugs ba phyogs chu dus gsum bde ba gshegs 
BO_TZ_PEMA-SANGTHIG-P25:501	rgyal ba rgya mtshho'i tshhogs la phyag 'tshhal lo :	50	rgyal ba rgya mtshho tshhogs la phyag tshhal lo 
BO_TZ_PEMA-SANGTHIG-P25:502	a la la ho :	50	a la la ho 
BO_TZ_PEMA-SANGTHIG-P25:503	zhi ba lhun gyis grub pa'i dkyil 'khor nas :	50	zhi ba lhun gyis grub ba dkyil khor nas 
BO_TZ_PEMA-SANGTHIG-P25:504	gsal 'tshher lhun sdug gzi brjid rab tu 'phro :	50	gsal tshher lhun sdug gzi brjid rab tu phro 
BO_TZ_PEMA-SANGTHIG-P25:505	mnyen lcug 'khril ldem zhi ba'i tshhul dgu ldan :	50	mnyen lcug khril ldem zhi ba tshhul dgu ldan 
BO_TZ_PEMA-SANGTHIG-P25:506	sangs rgyas bzhi bcu gnyis la phyag 'tshhal lo :	50	sangs rgya bzhi chu gnyis la phyag tshhal lo 
BO_TZ_PEMA-SANGTHIG-P25:507	a la la ho :	50	a la la ho 
BO_TZ_PEMA-SANGTHIG-P25:508	chos rnams rnam dag ye nas lhun grub cing :	50	chos rnams rnam dag ye nas lhun grub cing 
BO_TZ_PEMA-SANGTHIG-P25:509	bya ba byed dang yid chos rnam par dag :	50	byed ba byed dang yid chos rnam ba dag 
BO_TZ_PEMA-SANGTHIG-P25:510	chos dbyings ye shes mchog la mnga' brnyes pa'i :	51	chos dbyings ye shes mchog la mnga brnyes ba 
BO_TZ_PEMA-SANGTHIG-P25:511	kun bzang yab yum gnyis la phyag 'tshhal lo :	51	kun bzang yab yum gnyis la phyag tshhal lo 
BO_TZ_PEMA-SANGTHIG-P25:512	chos sku nam mkha' bzhin du dbyer med kyang :	51	chos sku nam mkha bzhin du dbyer med kyang 
BO_TZ_PEMA-SANGTHIG-P25:513	gzugs sku 'ja' tshhon bzhin du so sor gsal :	51	gzugs sku ja tshhon bzhin du so sor gsal 
BO_TZ_PEMA-SANGTHIG-P25:514	thabs dang shes rab mchog la mnga' brnyes pa'i :	51	thabs dang shes rab mchog la mnga brnyes ba 
BO_TZ_PEMA-SANGTHIG-P25:515	rigs lnga bde bar gshegs la phyag 'tshhal lo :	51	rigs lnga bde ba gshegs la phyag tshhal lo 
BO_TZ_PEMA-SANGTHIG-P25:516	ngo mtshhar pho brang bde bar gshegs pa'i yum :	51	ngo mtshhar pho brang bde ba gshegs ba yum 
BO_TZ_PEMA-SANGTHIG-P25:517	dus gsum sangs rgyas thams cad bskyed mdzad ma :	51	dus gsum sangs rgya thams cad skyed mdzad ma 
BO_TZ_PEMA-SANGTHIG-P25:518	bde stong zung 'jug yab kyi sku la 'khril :	51	bde stong zung jug yab kyi sku la khril 
BO_TZ_PEMA-SANGTHIG-P25:519	rigs kyi yum mchog rnams la phyag 'tshhal lo :	51	rigs kyi yum mchog rnams la phyag tshhal lo 
BO_TZ_PEMA-SANGTHIG-P25:520	rnam shes dbang po dag pas thugs dang gsung :	52	rnam shes dbang po dag ba thugs dang gsung 
BO_TZ_PEMA-SANGTHIG-P25:521	bde bar gshegs pa rnams kyi sras mchog ste :	52	bde ba gshegs ba rnams kyi sras mchog ste 
BO_TZ_PEMA-SANGTHIG-P25:522	nyon mongs spyod pa'i rkyen dang bral ba yi :	52	nyon mongs spyod ba rkyen dang bral ba yi 
BO_TZ_PEMA-SANGTHIG-P25:523	sems dpa' chen po brgyad la phyag 'tshhal lo :	52	sems dpa chen po brgyad la phyag tshhal lo 
BO_TZ_PEMA-SANGTHIG-P25:524	sgeg mo phreng thogs rin chen glu gar bcas :	52	sgeg mo phreng thogs rin chen glu gar cha 
BO_TZ_PEMA-SANGTHIG-P25:525	bdug spos me tog snang gsal dri chab ma :	52	bdug spros me tog snang gsal dri chab ma 
BO_TZ_PEMA-SANGTHIG-P25:526	rgyal ba'i dkyil 'khor mchod pas mnyes mdzad ma :	52	rgyal ba dkyil khor mchod ba mnyes mdzad ma 
BO_TZ_PEMA-SANGTHIG-P25:527	mchod pa'i lha mo brgyad la phyag 'tshhal lo :	52	mchod ba lha mo brgyad la phyag tshhal lo 
BO_TZ_PEMA-SANGTHIG-P25:528	drag shul thabs kyis 'gro ba 'dul mdzad cing :	52	drag shul thabs kyis gro ba dul mdzad cing 
BO_TZ_PEMA-SANGTHIG-P25:529	bdud kyi dpung dang bgegs tshhogs rnam par 'joms :	52	bdud kyi dpung dang bgegs tshhogs rnam ba joms 
BO_TZ_PEMA-SANGTHIG-P25:530	tshhad med bzhi ldan sgo bzhi thub par srung :	53	tshhad med bzhi ldan sgo bzhi thub ba srung 
BO_TZ_PEMA-SANGTHIG-P25:531	ta kr-ita sgo ba bzhi la phyag 'tshhal lo :	53	ta kr-ita sgo ba bzhi la phyag tshhal lo 
BO_TZ_PEMA-SANGTHIG-P25:532	rtag chad lta 'byin gsang ba yum gyi ngang :	53	rtag chad lta byin gsang ba yum gyi ngang 
BO_TZ_PEMA-SANGTHIG-P25:533	mi mthun phyogs 'joms rab 'jigs khro mo'i tshhul :	53	mi mthun phyogs joms rab jigs khro mo tshhul 
BO_TZ_PEMA-SANGTHIG-P25:534	lcags kyu zhags pa lcags sgrog dril bu ma :	53	lcags kyu zhags ba lcags sgrog dril bu ma 
BO_TZ_PEMA-SANGTHIG-P25:535	ye shes sgo ma bzhi la phyag 'tshhal lo :	53	ye shes sgo ma bzhi la phyag tshhal lo 
BO_TZ_PEMA-SANGTHIG-P25:536	steng 'og phyogs bzhi 'jig rten 'dul ba'i gtsho :	53	steng g phyogs bzhi jig rten dul ba gtsho 
BO_TZ_PEMA-SANGTHIG-P25:537	nyon mongs drug 'joms rgyud drug dag par sbyong :	53	nyon mongs drug joms brgyud drug dag ba sbyong 
BO_TZ_PEMA-SANGTHIG-P25:538	'gro drug 'dren phyin sprul pa'i skur ston pa :	53	gro drug bgrang phyin sprul ba skur ston ba 
BO_TZ_PEMA-SANGTHIG-P25:539	bcom ldan thub pa drug la phyag 'tshhal lo :	53	joms ldan thub ba drug la phyag tshhal lo 
BO_TZ_PEMA-SANGTHIG-P25:540	a la la ho :	54	a la la ho 
BO_TZ_PEMA-SANGTHIG-P25:541	sgyu 'phrul zhi ba'i lha tshhogs 'di dag gi :	54	sgyu phrul zhi ba lha tshhogs di dag gi 
BO_TZ_PEMA-SANGTHIG-P25:542	mtshhan ni lan gcig brjod byed cing :	54	mtshhan ni lan gcig rjod byed cing 
BO_TZ_PEMA-SANGTHIG-P25:543	gang gis gus pas phyag 'tshhal na :	54	gang gis gus ba phyag tshhal na 
BO_TZ_PEMA-SANGTHIG-P25:544	nyams chag bskangs nas dngos grub thob :	54	nyams chag skong nas dngos grub thob 
BO_TZ_PEMA-SANGTHIG-P25:545	de phyir gus pas phyag 'tshhal lo :	54	de phyir gus ba phyag tshhal lo 
BO_TZ_PEMA-SANGTHIG-P25:546	a la la ho :	54	a la la ho 
BO_TZ_PEMA-SANGTHIG-P25:547	khro bo rmad du byung ba'i dkyil 'khor nas :	54	khro bo rmad du byung ba dkyil khor nas 
BO_TZ_PEMA-SANGTHIG-P25:548	sgeg pa dpa' ba 'jigs su rung ba dang : rgod dang gshe la khro bar bstan pa dang : snying rje rngams dang zhi bar skur ston pa :	54	sgeg ba dpa ba jigs su rung ba dang rgod dang gshe la khro ba ston ba dang snying rje rngams dang zhi ba skur ston ba 
BO_TZ_PEMA-SANGTHIG-P25:549	'bar ba lnga bcu brgyad la phyag 'tshhal lo :	54	bar ba lnga chu brgyad la phyag tshhal lo 
BO_TZ_PEMA-SANGTHIG-P25:550	a la la ho :	55	a la la ho 
BO_TZ_PEMA-SANGTHIG-P25:551	chos sku skye med ngang las ma g.yos kyang :	55	chos sku skye med ngang las ma g.yos kyang 
BO_TZ_PEMA-SANGTHIG-P25:552	gzugs sku 'jigs pa'i cha lugs skur ston pa :	55	gzugs sku jigs ba cha lugs skur ston ba 
BO_TZ_PEMA-SANGTHIG-P25:553	gdug pa 'dul mdzad khro chen 'bar ba'i sku :	55	gdug ba dul mdzad khro chen bar ba sku 
BO_TZ_PEMA-SANGTHIG-P25:554	dpal chen he ru kahla phyag 'tshhal lo :	55	dpal chen he ru kahla phyag tshhal lo 
BO_TZ_PEMA-SANGTHIG-P25:555	khro rgyal dbang phyug sku la 'khril mdzad cing :	55	khro rgyal dbang phyug sku la khril mdzad cing 
BO_TZ_PEMA-SANGTHIG-P25:556	dgyes pa bskyed phyir dung khrag yab la stob :	55	dgyes ba skyed phyir dung khrag yab la stob 
BO_TZ_PEMA-SANGTHIG-P25:557	khro mo mi bzad 'bar ba'i sprin 'phro ma :	55	khro mo mi bzad bar ba sprin phro ma 
BO_TZ_PEMA-SANGTHIG-P25:558	kro d+hi shwa ri yum la phyag 'tshhal lo :	55	kro d+hi shwa ri yum la phyag tshhal lo 
BO_TZ_PEMA-SANGTHIG-P25:559	thugs rje thabs mkhas ma rungs 'dul mdzad cing :	55	thugs rje thabs mkhas ma rungs dul mdzad cing 
BO_TZ_PEMA-SANGTHIG-P25:560	ye shes mtshhon chas nyon mongs ma lus 'joms :	56	ye shes mtshhon cha nyon mongs ma lus joms 
BO_TZ_PEMA-SANGTHIG-P25:561	srid gsum bla med dbyings su sgrol mdzad pa :	56	srid gsum bla med dbyings su sgrol mdzad ba 
BO_TZ_PEMA-SANGTHIG-P25:562	rigs bzhi'i khrag 'thung tshhogs la phyag 'tshhal lo :	56	rigs bzhi khrag thung tshhogs la phyag tshhal lo 
BO_TZ_PEMA-SANGTHIG-P25:563	khrag 'thung so so'i yab kyi sku la 'khril :	56	khrag thung so so yab kyi sku la khril 
BO_TZ_PEMA-SANGTHIG-P25:564	khro mo'i gzugs kyis log lta zil gyis gnon :	56	khro mo gzugs kyis log lta zil gyis gnon 
BO_TZ_PEMA-SANGTHIG-P25:565	'gro rnams thugs rjes 'dren phyir mdzad pa'i yum :	56	gro rnams thugs rjes bgrang phyir mdzad ba yum 
BO_TZ_PEMA-SANGTHIG-P25:566	rigs bzhi'i khro mo yum la phyag 'tshhal lo :	56	rigs bzhi khro mo yum la phyag tshhal lo 
BO_TZ_PEMA-SANGTHIG-P25:567	bskal pa me ltar 'bar ba'i klong dkyil na :	56	bskal ba me ltar bar ba klong dkyil na 
BO_TZ_PEMA-SANGTHIG-P25:568	sgeg mo la sogs 'bar ba'i nyams ldan zhing :	56	sgeg mo la sogs bar ba nyams ldan zhing 
BO_TZ_PEMA-SANGTHIG-P25:569	ye shes sku mchog 'jigs byed rgyan gyis bzhugs :	56	ye shes sku mchog jigs byed rgyan gyis bzhugs 
BO_TZ_PEMA-SANGTHIG-P25:570	go'u ri khro mo brgyad la phyag 'tshhal lo :	57	gou ri khro mo brgyad la phyag tshhal lo 
BO_TZ_PEMA-SANGTHIG-P25:571	nam mkha'i lus can gar yang thogs pa med :	57	nam mkha lus can gar yang thogs ba med 
BO_TZ_PEMA-SANGTHIG-P25:572	'dod dgur sgyur ba'i gzugs can 'phrul mo che :	57	dod dgur sgyur ba gzugs can phrul mo che 
BO_TZ_PEMA-SANGTHIG-P25:573	ma sring byams pa'i tshhul du grogs mdzad ma :	57	ma sring byams ba tshhul du grogs mdzad ma 
BO_TZ_PEMA-SANGTHIG-P25:574	sing ha phra men brgyad la phyag 'tshhal lo :	57	sing ha phra men brgyad la phyag tshhal lo 
BO_TZ_PEMA-SANGTHIG-P25:575	rdo rje gdong mo pho nya mgyogs ma bzhi :	57	rdo rje gdong mo pho nya mgyog ma bzhi 
BO_TZ_PEMA-SANGTHIG-P25:576	'gugs dang 'ching sdom myos pa'i las kun mdzad :	57	gugs dang ching sdom myos ba las kun mdzad 
BO_TZ_PEMA-SANGTHIG-P25:577	shar lho nub byang sgo bzhi thub par srung :	57	char lho nub byang sgo bzhi thub ba srung 
BO_TZ_PEMA-SANGTHIG-P25:578	sgo srung khro mo bzhi la phyag 'tshhal lo :	57	sgo srung khro mo bzhi la phyag tshhal lo 
BO_TZ_PEMA-SANGTHIG-P25:579	dpal gyi 'khor tshhogs badzra a ral+li :	57	dpal gyi khor tshhogs badzra a ral+li 
BO_TZ_PEMA-SANGTHIG-P25:580	mkha' 'gro shugs 'gro ma tshhogs dbang phyug ma :	58	mkha gro shugs gro ma tshhogs dbang phyug ma 
BO_TZ_PEMA-SANGTHIG-P25:581	srin mo'i cha lugs 'jigs pa'i mgo brnyan can :	58	srin mo cha lugs jigs ba mgo rnyan can 
BO_TZ_PEMA-SANGTHIG-P25:582	rnal 'byor nyi shu brgyad la phyag 'tshhal lo :	58	rnal byor nyi shu brgyad la phyag tshhal lo 
BO_TZ_PEMA-SANGTHIG-P25:583	phyogs bcu dreg pa bsnol ba'i gdan steng du :	58	phyogs chu dreg ba snol ba gdan steng du 
BO_TZ_PEMA-SANGTHIG-P25:584	ye shes bskal pa me ltar 'bar ba'i klong :	58	ye shes bskal ba me ltar bar ba klong 
BO_TZ_PEMA-SANGTHIG-P25:585	mi dge tshhar gcod dge bcu don du bskul :	58	mi dge tshhar gcod dge chu don du skul 
BO_TZ_PEMA-SANGTHIG-P25:586	phyogs bcu'i khro rgyal rnams la phyag 'tshhal lo :	58	phyogs chu khro rgyal rnams la phyag tshhal lo 
BO_TZ_PEMA-SANGTHIG-P25:587	a la la ho :	58	a la la ho 
BO_TZ_PEMA-SANGTHIG-P25:588	sgyu 'phrul zhi khro'i lha tshhogs 'di dag gi :	58	sgyu phrul zhi khro lha tshhogs di dag gi 
BO_TZ_PEMA-SANGTHIG-P25:589	mtshhan ni lan gcig brjod byed cing :	58	mtshhan ni lan gcig rjod byed cing 
BO_TZ_PEMA-SANGTHIG-P25:590	gang gis gus pas phyag 'tshhal na :	59	gang gis gus ba phyag tshhal na 
BO_TZ_PEMA-SANGTHIG-P25:591	nyams chag bskangs nas dngos grub thob :	59	nyams chag skong nas dngos grub thob 
BO_TZ_PEMA-SANGTHIG-P25:592	de phyir gus pas phyag 'tshhal lo :	59	de phyir gus ba phyag tshhal lo 
BO_TZ_PEMA-SANGTHIG-P25:593	a la la ho :	59	a la la ho 
BO_TZ_PEMA-SANGTHIG-P25:594	dus gsum sangs rgyas yon tan kun rdzogs shing :	59	dus gsum sangs rgya yon tan kun rdzogs shing 
BO_TZ_PEMA-SANGTHIG-P25:595	gdul bya ma lus smin cing grol mdzad pa :	59	gdul byed ma lus smin cing grol mdzad ba 
BO_TZ_PEMA-SANGTHIG-P25:596	bla ma rig 'dzin tshhogs la phyag 'tshhal lo :	59	bla ma rig dzin tshhogs la phyag tshhal lo 
BO_TZ_PEMA-SANGTHIG-P25:597	skye med chos kyi sku la phyag 'tshhal lo :	59	skye med chos kyi sku la phyag tshhal lo 
BO_TZ_PEMA-SANGTHIG-P25:598	longs spyod rdzogs pa'i sku la phyag 'tshhal lo :	59	longs spyod rdzogs ba sku la phyag tshhal lo 
BO_TZ_PEMA-SANGTHIG-P25:599	cir yang sprul pa'i sku la phyag 'tshhal lo :	59	cir yang sprul ba sku la phyag tshhal lo 
BO_TZ_PEMA-SANGTHIG-P25:600	mi 'gyur rdo rje'i sku la phyag 'tshhal lo :	60	mi gyur rdo rje sku la phyag tshhal lo 
BO_TZ_PEMA-SANGTHIG-P25:601	mngon par byang chub sku la phyag 'tshhal lo :	60	mngon ba byang chub sku la phyag tshhal lo 
BO_TZ_PEMA-SANGTHIG-P25:602	dus gsum rgyal ba kun gyi bsgrub pa'i gnas :	60	dus gsum rgyal ba kun gyi sgrub ba gnas 
BO_TZ_PEMA-SANGTHIG-P25:603	tshhogs gnyis rdzogs nas yon tan mthar phyin pa :	60	tshhogs gnyis rdzogs nas yon tan mthar phyin ba 
BO_TZ_PEMA-SANGTHIG-P25:604	sku dang ye shes tshhogs la phyag 'tshhal lo :	60	sku dang ye shes tshhogs la phyag tshhal lo 
BO_TZ_PEMA-SANGTHIG-P25:605	'byung ba lnga las skur bzhengs pa :	60	byung ba lnga las skur bzhengs ba 
BO_TZ_PEMA-SANGTHIG-P25:606	rtag pa'i rgyal mo lnga la phyag 'tshhal lo :	60	rtag ba rgyal mo lnga la phyag tshhal lo 
BO_TZ_PEMA-SANGTHIG-P25:607	rang bzhin dbyings las grub pa mo :	60	rang bzhin dbyings las grub ba mo 
BO_TZ_PEMA-SANGTHIG-P25:608	dbyings phyug lha mo lnga la phyag 'tshhal lo :	60	dbyings phyug lha mo lnga la phyag tshhal lo 
BO_TZ_PEMA-SANGTHIG-P25:609	rgyu 'bras byang chub sems dpa'i sprul pa ste :	60	rgyu bras byang chub sems dpa sprul ba ste 
BO_TZ_PEMA-SANGTHIG-P25:610	mkha' 'gro sum cu gnyis la phyag 'tshhal lo :	61	mkha gro sum cu gnyis la phyag tshhal lo 
BO_TZ_PEMA-SANGTHIG-P25:611	ga na pa ti'i sprul pa ste :	61	ga na ba ti sprul ba ste 
BO_TZ_PEMA-SANGTHIG-P25:612	ging pho rnams la phyag 'tshhal lo :	61	ging pho rnams la phyag tshhal lo 
BO_TZ_PEMA-SANGTHIG-P25:613	lha mo dpa' mo'i sprul pa ste :	61	lha mo dpa mo sprul ba ste 
BO_TZ_PEMA-SANGTHIG-P25:614	ging mo rnams la phyag 'tshhal lo :	61	ging mo rnams la phyag tshhal lo 
BO_TZ_PEMA-SANGTHIG-P25:615	'jig rten khams la mnga' mdzad ma :	61	jig rten khams la mnga mdzad ma 
BO_TZ_PEMA-SANGTHIG-P25:616	'jigs byed dpal 'bar ral pa can :	61	jigs byed dpal bar ral ba can 
BO_TZ_PEMA-SANGTHIG-P25:617	'dod pa'i ro la chags pa mo :	61	dod ba ro la chags ba mo 
BO_TZ_PEMA-SANGTHIG-P25:618	ma mo mkha' 'gro'i tshhogs la phyag 'tshhal lo :	61	ma mo mkha gro tshhogs la phyag tshhal lo 
BO_TZ_PEMA-SANGTHIG-P25:619	legs nyes stangs 'dzin dam tshhig rjes gcod cing :	61	legs nyes stangs dzin dam tshhig rjes gcod cing 
BO_TZ_PEMA-SANGTHIG-P25:620	bka' bzhin rjes su sgrub pa'i grogs mdzad ma :	62	bka bzhin rjes su sgrub ba grogs mdzad ma 
BO_TZ_PEMA-SANGTHIG-P25:621	dam can rgya mtshho'i tshhogs la phyag 'tshhal lo :	62	dam can rgya mtshho tshhogs la phyag tshhal lo 
BO_TZ_PEMA-SANGTHIG-P25:622	gnyis pa ngag gi sdig sgrib sbyong ba rdo rje sems dpa'i bsgom bzlas ni /	62	gnyis ba ngag gi sdig sgrib sbyong ba rdo rje sems dpa bsgom bzlas ni 
BO_TZ_PEMA-SANGTHIG-P25:623	ah rang gi spyi bor pad zla'i steng //	62	ah rang gi spyi bor pad zla steng 
BO_TZ_PEMA-SANGTHIG-P25:624	sangs rgyas kun gyi ye shes sku //	62	sangs rgya kun gyi ye shes sku 
BO_TZ_PEMA-SANGTHIG-P25:625	dpal ldan rdo rje sems dpa' ni //	62	dpal ldan rdo rje sems dpa ni 
BO_TZ_PEMA-SANGTHIG-P25:626	dri med ston ka'i zla ba'i mdangs //	62	dri med ston ka zla ba mdangs 
BO_TZ_PEMA-SANGTHIG-P25:627	rdo rje dril bu 'dzin pa'i rgyas //	62	rdo rje dril bu dzin ba rgya 
BO_TZ_PEMA-SANGTHIG-P25:628	yum chen snyems ma dkar mo 'khril //	62	yum chen snyems ma dkar mo khril 
BO_TZ_PEMA-SANGTHIG-P25:629	thugs kar zla steng hu~m gi mthar //	62	thugs kar zla steng hu~m gi mthar 
BO_TZ_PEMA-SANGTHIG-P25:630	yig brgya'i sngags kyis bskor ba dang // snyoms 'jug bde rol sbyor mtshhams nas :	63	yig brgya sngags kyis skor ba dang snyom jug bde rol sbyor mtshhams nas 
BO_TZ_PEMA-SANGTHIG-P25:631	bdud rtshi byang chub sems rgyun babs //	63	bdud rtshi byang chub sems rgyun bab 
BO_TZ_PEMA-SANGTHIG-P25:632	rang gi spyi gtshug nas zhugs te //	63	rang gi spyi gtshug nas jug te 
BO_TZ_PEMA-SANGTHIG-P25:633	lus kyi nang gang sdig sgrib dag	63	lus kyi nang gang sdig sgrib dag 
BO_TZ_PEMA-SANGTHIG-P25:634	/stong gsal 'od kyi sku ru gyur //	63	gsal d kyi sku ru gyur 
BO_TZ_PEMA-SANGTHIG-P25:635	a la la ho :	63	a la la ho 
BO_TZ_PEMA-SANGTHIG-P25:636	bcom ldan 'das dpal rdo rje sems dpa' la phyag 'tshhal lo :	63	joms ldan da dpal rdo rje sems dpa la phyag tshhal lo 
BO_TZ_PEMA-SANGTHIG-P25:637	om badzra satwa sa ma ya ma nu pa la ya :	63	om badzra satwa sa ma ya ma nu ba la ya 
BO_TZ_PEMA-SANGTHIG-P25:638	badzra satwa twe no pa tish+tha :	63	badzra satwa twe no ba tish+tha 
BO_TZ_PEMA-SANGTHIG-P25:639	dr-i d+ho me b+ha wa :	63	dr-i d+ho me b+ha wa 
BO_TZ_PEMA-SANGTHIG-P25:640	su to sh+yo me b+ha wa :	64	su to sh+yo me b+ha wa 
BO_TZ_PEMA-SANGTHIG-P25:641	a nu rak+to me b+ha wa :	64	a nu rak+to me b+ha wa 
BO_TZ_PEMA-SANGTHIG-P25:642	su po sh+yo me b+ha wa :	64	su po sh+yo me b+ha wa 
BO_TZ_PEMA-SANGTHIG-P25:643	sarba sid+d+hi m+me pra yatsh+tshha :	64	sarba sid+d+hi m+me pra yatsh+tshha 
BO_TZ_PEMA-SANGTHIG-P25:644	sarba karma su tsha me tshit+tam:	64	sarba karma su tsha me tshit+tam: 
BO_TZ_PEMA-SANGTHIG-P25:645	shre yamhku ru hu~m:	64	shre yamhku ru hu~m: 
BO_TZ_PEMA-SANGTHIG-P25:646	ha ha ha ha ho :	64	ha ha ha ha ho 
BO_TZ_PEMA-SANGTHIG-P25:647	b+ha ga wana?: sarba ta tha ga ta :	64	b+ha ga wana?: sarba ta tha ga ta 
BO_TZ_PEMA-SANGTHIG-P25:648	badzra ma me muny+tsha :	64	badzra ma me muny+tsha 
BO_TZ_PEMA-SANGTHIG-P25:649	badzri b+ha wa :	64	badzri b+ha wa 
BO_TZ_PEMA-SANGTHIG-P25:650	ma ha sa ma ya satwa a:	65	ma ha sa ma ya satwa a: 
BO_TZ_PEMA-SANGTHIG-P25:651	dus gsum bde gshegs thams cad kyi :	65	dus gsum bde gshegs thams cad kyi 
BO_TZ_PEMA-SANGTHIG-P25:652	yang snying yig ge brgya pa 'di :	65	yang snying yig ge brgya ba di 
BO_TZ_PEMA-SANGTHIG-P25:653	bdun nam nyi shu rtsha gcig gam :	65	bdun nam nyi shu rtsha gcig gam 
BO_TZ_PEMA-SANGTHIG-P25:654	brgya dang rtsha brgyad brjod gyur na :	65	brgya dang rtsha brgyad rjod gyur na 
BO_TZ_PEMA-SANGTHIG-P25:655	mtshhams med lnga yi sdig pa byang :	65	mtshhams med lnga yi sdig ba byang 
BO_TZ_PEMA-SANGTHIG-P25:656	nyams chag kun kyang byang gyur nas :	65	nyams chag kun kyang byang gyur nas 
BO_TZ_PEMA-SANGTHIG-P25:657	dus gsum sangs rgyas thams cad kyis :	65	dus gsum sangs rgya thams cad kyis 
BO_TZ_PEMA-SANGTHIG-P25:658	sras kyi dam par dgongs par 'gyur :	65	sras kyi dam ba dgongs ba gyur 
BO_TZ_PEMA-SANGTHIG-P25:659	ho : rgyal ba rgya mtshho'i tshhogs rnams dgongs :	65	ho rgyal ba rgya mtshho tshhogs rnams dgongs 
BO_TZ_PEMA-SANGTHIG-P25:660	rgyal ba'i bka' dang bla ma'i lung :	66	rgyal ba bka dang bla ma lung 
BO_TZ_PEMA-SANGTHIG-P25:661	ji bzhin ma spyad lung dang 'gal :	66	ji bzhin ma spyod lung dang gal 
BO_TZ_PEMA-SANGTHIG-P25:662	gsang sngags dam tshhig nyams chag rnams :	66	gsang sngags dam tshhig nyams chag rnams 
BO_TZ_PEMA-SANGTHIG-P25:663	gnong zhing 'gyod pa'i sems kyis ni :	66	gnong zhing gyod ba sems kyis ni 
BO_TZ_PEMA-SANGTHIG-P25:664	mi 'chab mi sbed mthol lo bshags :	66	mi chab mi sbed mthol lo chags 
BO_TZ_PEMA-SANGTHIG-P25:665	bla ma rdo rje slob dpon dang : mched dang lcam dral la sogs pa :	66	bla ma rdo rje slob dpon dang mched dang lcam dral la sogs ba 
BO_TZ_PEMA-SANGTHIG-P25:666	khams gsum sems can thams cad la :	66	khams gsum sems can thams cad la 
BO_TZ_PEMA-SANGTHIG-P25:667	mtshhams med lnga dang nye ba lnga :	66	mtshhams med lnga dang nye ba lnga 
BO_TZ_PEMA-SANGTHIG-P25:668	lci ba bzhi dang log pa brgyad :	66	lci ba bzhi dang log ba brgyad 
BO_TZ_PEMA-SANGTHIG-P25:669	mi dge bcu yi las bgyis rnams :	66	mi dge chu yi las bgyid rnams 
BO_TZ_PEMA-SANGTHIG-P25:670	gnong zhing 'gyod pa'i sems kyis bshags par bgyi :	67	gnong zhing gyod ba sems kyis chags ba bgyid 
BO_TZ_PEMA-SANGTHIG-P25:671	gsang sngags phyi nang dkyil 'khor du :	67	gsang sngags phyi nang dkyil khor du 
BO_TZ_PEMA-SANGTHIG-P25:672	rdo rje slob dpon mched lcam la :	67	rdo rje slob dpon mched lcam la 
BO_TZ_PEMA-SANGTHIG-P25:673	ma gus nyes par byas la sogs :	67	ma gus nyes ba byed la sogs 
BO_TZ_PEMA-SANGTHIG-P25:674	sku yi dam tshhig nyams chag rnams :	67	sku yi dam tshhig nyams chag rnams 
BO_TZ_PEMA-SANGTHIG-P25:675	gnong zhing 'gyod pa'i sems kyis bshags par bgyi :	67	gnong zhing gyod ba sems kyis chags ba bgyid 
BO_TZ_PEMA-SANGTHIG-P25:676	bskyed rdzogs bzlas sgom bar chod cing :	67	skyed rdzogs bzlas sgom ba chod cing 
BO_TZ_PEMA-SANGTHIG-P25:677	tshhogs dang gtor ma chag la sogs :	67	tshhogs dang thor ma chag la sogs 
BO_TZ_PEMA-SANGTHIG-P25:678	gsung gi dam tshhig nyams chag rnams :	67	gsung gi dam tshhig nyams chag rnams 
BO_TZ_PEMA-SANGTHIG-P25:679	gnong zhing 'gyod pa'i sems kyis bshags par bgyi :	67	gnong zhing gyod ba sems kyis chags ba bgyid 
BO_TZ_PEMA-SANGTHIG-P25:680	nyams dang ma smin sems can la :	68	nyams dang ma smin sems can la 
BO_TZ_PEMA-SANGTHIG-P25:681	gsang ba bsgrags pa la sogs pa :	68	gsang ba sgrog ba la sogs ba 
BO_TZ_PEMA-SANGTHIG-P25:682	thugs kyi dam tshhig nyams chag rnams :	68	thugs kyi dam tshhig nyams chag rnams 
BO_TZ_PEMA-SANGTHIG-P25:683	gnong zhing 'gyod pa'i sems kyis bshags par bgyi :	68	gnong zhing gyod ba sems kyis chags ba bgyid 
BO_TZ_PEMA-SANGTHIG-P25:684	spyad bya lnga dang mi spang lnga :	68	spyod byed lnga dang mi spong lnga 
BO_TZ_PEMA-SANGTHIG-P25:685	blang bya lnga dang bsgrub bya lnga :	68	blang byed lnga dang sgrub byed lnga 
BO_TZ_PEMA-SANGTHIG-P25:686	shes par bya ba lnga la sogs :	68	shes ba byed ba lnga la sogs 
BO_TZ_PEMA-SANGTHIG-P25:687	yan lag dam tshhig nyams chag rnams :	68	yan lag dam tshhig nyams chag rnams 
BO_TZ_PEMA-SANGTHIG-P25:688	gnong zhing 'gyod pa'i sems kyis bshags par bgyi :	68	gnong zhing gyod ba sems kyis chags ba bgyid 
BO_TZ_PEMA-SANGTHIG-P25:689	nya stong tshhes brgyad la sogs dus kyi mchod pa chag :	68	nya stong tshhes brgyad la sogs dus kyi mchod ba chag 
BO_TZ_PEMA-SANGTHIG-P25:690	bsnyen sgrub ting 'dzin ma gsal lta ba log :	69	snyen sgrub ting dzin ma gsal lta ba log 
BO_TZ_PEMA-SANGTHIG-P25:691	phud dang gtshang sbra ma mchis 'bags btshog shor :	69	bud dang gtshang sbra ma mchis bags btshog chor 
BO_TZ_PEMA-SANGTHIG-P25:692	le lo ser sna'i dbang du gyur pa rnams :	69	le lo ser sna dbang du gyur ba rnams 
BO_TZ_PEMA-SANGTHIG-P25:693	gnong zhing 'gyod pa'i sems kyis bshags par bgyi :	69	gnong zhing gyod ba sems kyis chags ba bgyid 
BO_TZ_PEMA-SANGTHIG-P25:694	'di nas gzung ste byang chub mchis kyi bar :	69	di nas gzung ste byang chub mchis kyi ba 
BO_TZ_PEMA-SANGTHIG-P25:695	sdig pa mi dge'i las su gyur pa kun :	69	sdig ba mi dge las su gyur ba kun 
BO_TZ_PEMA-SANGTHIG-P25:696	lus dang srog la babs kyang mi bgyid par :	69	lus dang srog la bab kyang mi bgyid ba 
BO_TZ_PEMA-SANGTHIG-P25:697	rgyal ba khyed kyi spyan sngar dam bca' 'o :	69	rgyal ba khyed kyi spyan sngar dam chos mang 
BO_TZ_PEMA-SANGTHIG-P25:698	khyed kyi thugs rjes btang snyoms ma mdzad par :	69	khyed kyi thugs rjes gtong snyom ma mdzad ba 
BO_TZ_PEMA-SANGTHIG-P25:699	byams brtshe ldan pas bu bzhin bskyang du gsol :	69	byams brtshe ldan ba bu bzhin skyong du gsol 
BO_TZ_PEMA-SANGTHIG-P25:700	de ltar mthol zhing bshags pas rdo rje sems dpa' dgyes shing 'dzum pa dang bcas rigs kyi bu khyod kyi sdig sgrib dag go zhes gnang ba bstshal te rang la thim par bsam mo //	70	de ltar mthol zhing chags ba rdo rje sems dpa dgyes shing dzum ba dang cha rigs kyi bu khyod kyi sdig sgrib dag go zhes gnang ba bstshal te rang la thim ba bsam mo 
BO_TZ_PEMA-SANGTHIG-P25:701	gsum pa yid kyi rtog sgrib sbyong ba chos nyid don gyi bshags pa ni /	70	gsum ba yid kyi rtogs sgrib sbyong ba chos nyid don gyi chags ba ni 
BO_TZ_PEMA-SANGTHIG-P25:702	gdod nas ma skyes chos kyi sku :	70	gdod nas ma skye chos kyi sku 
BO_TZ_PEMA-SANGTHIG-P25:703	gnyis med ro mnyam longs spyod rdzogs :	70	gnyis med ro mnyam longs spyod rdzogs 
BO_TZ_PEMA-SANGTHIG-P25:704	ma 'gags rol pa sprul pa'i sku :	70	ma gag rol ba sprul ba sku 
BO_TZ_PEMA-SANGTHIG-P25:705	phyag 'tshhal bla ma mkha' 'gro la :	70	phyag tshhal bla ma mkha gro la 
BO_TZ_PEMA-SANGTHIG-P25:706	dngos 'byor yid las byung ba yi :	70	dngos byor yid las byung ba yi 
BO_TZ_PEMA-SANGTHIG-P25:707	phyi nang gsang ba'i mchod sprin rnams :	70	phyi nang gsang ba mchod sprin rnams 
BO_TZ_PEMA-SANGTHIG-P25:708	chos dbyings nam mkha'i klong yangs nas :	70	chos dbyings nam mkha klong yangs nas 
BO_TZ_PEMA-SANGTHIG-P25:709	rnam 'phrul gus pa'i yid kyis mchod :	70	rnam phrul gus ba yid kyis mchod 
BO_TZ_PEMA-SANGTHIG-P25:710	thog med dus nas da lta'i bar :	71	thogs med dus nas da lta ba 
BO_TZ_PEMA-SANGTHIG-P25:711	rang bzhin dang ni bcas pa yi :	71	rang bzhin dang ni cha ba yi 
BO_TZ_PEMA-SANGTHIG-P25:712	sgo gsum mi dge'i las rnams kun :	71	sgo gsum mi dge las rnams kun 
BO_TZ_PEMA-SANGTHIG-P25:713	rang grol rig pa'i klong du bshags :	71	rang grol rig ba klong du chags 
BO_TZ_PEMA-SANGTHIG-P25:714	bla ma yi dam mkha' 'gro'i tshhogs :	71	bla ma yi dam mkha gro tshhogs 
BO_TZ_PEMA-SANGTHIG-P25:715	bdag dang dbyer med ro mnyam la :	71	bdag dang dbyer med ro mnyam la 
BO_TZ_PEMA-SANGTHIG-P25:716	bdag tu bzung ba mthol lo bshags :	71	bdag tu bzung ba mthol lo chags 
BO_TZ_PEMA-SANGTHIG-P25:717	dran rtog chos nyid rang rtshal la :	71	dran rtogs chos nyid rang rtshal la 
BO_TZ_PEMA-SANGTHIG-P25:718	ye grol bskyar gzhi med pa yi :	71	ye grol skyor gzhi med ba yi 
BO_TZ_PEMA-SANGTHIG-P25:719	blta bya lta byed med pa la :	71	lta byed lta byed med ba la 
BO_TZ_PEMA-SANGTHIG-P25:720	ngo blta byas pa mthol lo bshags :	72	ngo lta byed ba mthol lo chags 
BO_TZ_PEMA-SANGTHIG-P25:721	sems nyid ye grol 'khor yug 'di :	72	sems nyid ye grol khor yug di 
BO_TZ_PEMA-SANGTHIG-P25:722	yid byed bsgom pa'i yul las 'das :	72	yid byed bsgom ba yul las da 
BO_TZ_PEMA-SANGTHIG-P25:723	bsgom bya sgom byed med pa la :	72	bsgom byed sgom byed med ba la 
BO_TZ_PEMA-SANGTHIG-P25:724	stong nyid bsgoms pa mthol lo bshags :	72	stong nyid sgom ba mthol lo chags 
BO_TZ_PEMA-SANGTHIG-P25:725	chos dbyings brdal ba'i yo langs la :	72	chos dbyings rdal ba yo ldang la 
BO_TZ_PEMA-SANGTHIG-P25:726	spang blang spyod pa a thang chad :	72	spong blang spyod ba a thang chad 
BO_TZ_PEMA-SANGTHIG-P25:727	spyad bya spyod byed med pa la :	72	spyod byed spyod byed med ba la 
BO_TZ_PEMA-SANGTHIG-P25:728	blang dor spyod pa mthol lo bshags :	72	blang dor spyod ba mthol lo chags 
BO_TZ_PEMA-SANGTHIG-P25:729	rig pa bcing grol med pa la :	72	rig ba ching grol med ba la 
BO_TZ_PEMA-SANGTHIG-P25:730	sa lam 'bad pas grol ba mtshhar :	73	sa lam bad ba grol ba mtshhar 
BO_TZ_PEMA-SANGTHIG-P25:731	'thob bya thob byed med pa la :	73	thob byed thob byed med ba la 
BO_TZ_PEMA-SANGTHIG-P25:732	spang thob 'bras bu mthol lo bshags :	73	spong thob bras bu mthol lo chags 
BO_TZ_PEMA-SANGTHIG-P25:733	dran pa rang grol thig le'i ngang :	73	dran ba rang grol thig le ngang 
BO_TZ_PEMA-SANGTHIG-P25:734	khyab brdal nam mkha'i 'khor yug la :	73	khyab rdal nam mkha khor yug la 
BO_TZ_PEMA-SANGTHIG-P25:735	dran pas bzung dang ma gzung med :	73	dran ba bzung dang ma gzung med 
BO_TZ_PEMA-SANGTHIG-P25:736	dran pas sgrog bcings mthol lo bshags :	73	dran ba sgrog ching mthol lo chags 
BO_TZ_PEMA-SANGTHIG-P25:737	thams cad chos dbyings rol pa la :	73	thams cad chos dbyings rol ba la 
BO_TZ_PEMA-SANGTHIG-P25:738	yengs dang ma yengs ga la yod :	73	yengs dang ma yengs ga la yod 
BO_TZ_PEMA-SANGTHIG-P25:739	ye nas skye med rgya yan la :	73	ye nas skye med rgya yan la 
BO_TZ_PEMA-SANGTHIG-P25:740	ma yengs sems 'dzin mthol lo bshags :	74	ma yengs sems dzin mthol lo chags 
BO_TZ_PEMA-SANGTHIG-P25:741	sems nyid nam mkha' lta bu la :	74	sems nyid nam mkha lta bu la 
BO_TZ_PEMA-SANGTHIG-P25:742	gang gis glod cing sgrim par nus :	74	gang gis glod cing sgrim ba nus 
BO_TZ_PEMA-SANGTHIG-P25:743	bya rtshol spros pa'i yul las 'das :	74	byed rtshol spros ba yul las da 
BO_TZ_PEMA-SANGTHIG-P25:744	'bad rtshol sgrim glod mthol lo bshags :	74	bad rtshol sgrim glod mthol lo chags 
BO_TZ_PEMA-SANGTHIG-P25:745	ris med stong pa nam mkha'i ngang :	74	ris med stong ba nam mkha ngang 
BO_TZ_PEMA-SANGTHIG-P25:746	btshal bas rnyed par mi 'gyur te :	74	btshal ba rnyed ba mi gyur te 
BO_TZ_PEMA-SANGTHIG-P25:747	'bad rtshol 'du byed 'khrul pa'i lam :	74	bad rtshol du byed khrul ba lam 
BO_TZ_PEMA-SANGTHIG-P25:748	rig 'tshhol sdug btshir mthol lo bshags :	74	rig tshhol sdug btshir mthol lo chags 
BO_TZ_PEMA-SANGTHIG-P25:749	ma yengs rnam rtog ngos bzung nas :	74	ma yengs rnam rtogs ngos bzung nas 
BO_TZ_PEMA-SANGTHIG-P25:750	de nyid glod cing de nyid blta :	75	de nyid glod cing de nyid lta 
BO_TZ_PEMA-SANGTHIG-P25:751	'di yang 'du byed 'khrul pa'i lam :	75	di yang du byed khrul ba lam 
BO_TZ_PEMA-SANGTHIG-P25:752	ye dag rol par mthol lo bshags :	75	ye dag rol ba mthol lo chags 
BO_TZ_PEMA-SANGTHIG-P25:753	byas pa'i chos kyis sangs mi rgya :	75	byed ba chos kyis sangs mi rgya 
BO_TZ_PEMA-SANGTHIG-P25:754	blo yi chos kyis rang nyid 'ching :	75	blo yi chos kyis rang nyid ching 
BO_TZ_PEMA-SANGTHIG-P25:755	gang la dmigs kyang yin lugs sgrib :	75	gang la dmigs kyang yin lugs sgrib 
BO_TZ_PEMA-SANGTHIG-P25:756	dmigs med chos dbyings klong du bshags :	75	dmigs med chos dbyings klong du chags 
BO_TZ_PEMA-SANGTHIG-P25:757	sa lam drod rtags re bas bcing :	75	sa lam drod rtags re ba ching 
BO_TZ_PEMA-SANGTHIG-P25:758	nyams rtogs ro la chags pas phung :	75	nyams rtogs ro la chags ba phung 
BO_TZ_PEMA-SANGTHIG-P25:759	smig sgyu'i chu yis rang nyid bslus :	75	smig sgyu chu yis rang nyid bslus 
BO_TZ_PEMA-SANGTHIG-P25:760	byar med ye grol klong du bshags :	76	byar med ye grol klong du chags 
BO_TZ_PEMA-SANGTHIG-P25:761	mi rtog gnas pa'i 'khor yug ngang :	76	mi rtogs gnas ba khor yug ngang 
BO_TZ_PEMA-SANGTHIG-P25:762	bde gsal mi rtog ting 'dzin dang : stong nyid blo bral ris med sogs :	76	bde gsal mi rtogs ting dzin dang stong nyid blo bral ris med sogs 
BO_TZ_PEMA-SANGTHIG-P25:763	myong zhen skye med klong du bshags :	76	myong zhen skye med klong du chags 
BO_TZ_PEMA-SANGTHIG-P25:764	don dam chos dbyings spros bral ngang :	76	don dam chos dbyings spros bral ngang 
BO_TZ_PEMA-SANGTHIG-P25:765	bsam med dmigs med brjod med sogs :	76	bsam med dmigs med rjod med sogs 
BO_TZ_PEMA-SANGTHIG-P25:766	go myong yid kyis gtad so rnams :	76	go myong yid kyis gtod so rnams 
BO_TZ_PEMA-SANGTHIG-P25:767	ris med bsam 'das klong du bshags :	76	ris med bsam da klong du chags 
BO_TZ_PEMA-SANGTHIG-P25:768	thos bsam 'bad rtshol sgom pa dang : mi bsgom mi rtog byar med sogs :	76	thos bsam bad rtshol sgom ba dang mi bsgom mi rtogs byar med sogs 
BO_TZ_PEMA-SANGTHIG-P25:769	gang ltar byas kyang bcos ma'i lam :	76	gang ltar byed kyang chos ma lam 
BO_TZ_PEMA-SANGTHIG-P25:770	ma bcos chos sku'i klong du bshags :	77	ma chos chos sku klong du chags 
BO_TZ_PEMA-SANGTHIG-P25:771	gtang bzhag 'gugs dang ched 'dzin sgom :	77	gtong jog gugs dang ched dzin sgom 
BO_TZ_PEMA-SANGTHIG-P25:772	sgrim klod ngo blta la sogs dang : rtag chad bsam gzhig yid byed lam :	77	sgrim klod ngo lta la sogs dang rtag chad bsam jig yid byed lam 
BO_TZ_PEMA-SANGTHIG-P25:773	byar med ka dag klong du bshags :	77	byar med ka dag klong du chags 
BO_TZ_PEMA-SANGTHIG-P25:774	ma byas dge la rjes yi rang :	77	ma byed dge la rjes yi rang 
BO_TZ_PEMA-SANGTHIG-P25:775	skye med chos 'khor bskor ba dang : skye 'chi med par rtag bzhugs nas :	77	skye med chos khor skor ba dang skye chi med ba rtag bzhugs nas 
BO_TZ_PEMA-SANGTHIG-P25:776	ji srid nam mkha'i mthar thug bar :	77	ji srid nam mkha mthar thug ba 
BO_TZ_PEMA-SANGTHIG-P25:777	mi ngal 'gro ba 'dren par shog :	77	mi ngal gro ba bgrang ba shog 
BO_TZ_PEMA-SANGTHIG-P25:778	de nas sgo gsum thun mong gi dam tshhig nyams pa bskang ba tshhogs kyi mchod pa ni /	77	de nas sgo gsum thun mong gi dam tshhig nyams ba skong ba tshhogs kyi mchod ba ni 
BO_TZ_PEMA-SANGTHIG-P25:779	ram yam kham: bdag nyid lha yi thugs ka nas :	77	ram yam kham: bdag nyid lha yi thugs ka nas 
BO_TZ_PEMA-SANGTHIG-P25:780	sogs nas / sarba ga na tshakra pu dza ho :	78	sogs nas sarba ga na tshakra pu dza ho 
BO_TZ_PEMA-SANGTHIG-P25:781	tshhogs bar pa bskang ba'i mgo la /	78	tshhogs ba ba skong ba mgo la 
BO_TZ_PEMA-SANGTHIG-P25:782	skong rdzas rnams kun tu bzang po'i mchod sprin lta bur bsam la nam mkha' mdzod kyi sngags rgya lan gsum gyis byin brlabs te /	78	skong rdzas rnams kun tu bzang po mchod sprin lta bur bsam la nam mkha mdzod kyi sngags rgya lan gsum gyis byin brlabs te 
BO_TZ_PEMA-SANGTHIG-P25:783	hu~m: ma bcos spros bral gnas lugs mngon gyur pa'i :	78	hu~m: ma chos spros bral gnas lugs mngon gyur ba 
BO_TZ_PEMA-SANGTHIG-P25:784	rgyal ba dgongs pa brgyud pa'i thugs dam bskang :	78	rgyal ba dgongs ba brgyud ba thugs dam skong 
BO_TZ_PEMA-SANGTHIG-P25:785	ting 'dzin mchog brnyes brda yi brgyud pa ste :	78	ting dzin mchog brnyes brda yi brgyud ba ste 
BO_TZ_PEMA-SANGTHIG-P25:786	rig 'dzin rig pa brgyud pa'i thugs dam bskang :	78	rig dzin rig ba brgyud ba thugs dam skong 
BO_TZ_PEMA-SANGTHIG-P25:787	bka' lung lhag chad med pa'i gang zag mchog :	78	bka lung lhag chad med ba gang zag mchog 
BO_TZ_PEMA-SANGTHIG-P25:788	snyan khungs brgyud pa'i bla ma'i thugs dam bskang :	78	snyan khungs brgyud ba bla ma thugs dam skong 
BO_TZ_PEMA-SANGTHIG-P25:789	bka' brgyud gter du sbas pa'i bya ra ba :	78	bka brgyud gter du sbed ba byed ra ba 
BO_TZ_PEMA-SANGTHIG-P25:790	mkha' 'gro gtad rgya brgyud pa'i thugs\u0f8e	79	mkha gro gtod rgya brgyud ba thugs\u0f8e 
BO_TZ_PEMA-SANGTHIG-P25:791	ma 'ongs las 'phro can la lung ston pa'i :	79	ma ngs las phro can la lung ston ba 
BO_TZ_PEMA-SANGTHIG-P25:792	smon lam dbang bskur brgyud pa'i thugs\u0f8e	79	smon lam dbang skur brgyud ba thugs\u0f8e 
BO_TZ_PEMA-SANGTHIG-P25:793	shes bya thams cad rnam pa kun mkhyen pa'i :	79	shes byed thams cad rnam ba kun mkhyen ba 
BO_TZ_PEMA-SANGTHIG-P25:794	dus gsum sangs rgyas rnams kyi thugs\u0f8e	79	dus gsum sangs rgya rnams kyi thugs\u0f8e 
BO_TZ_PEMA-SANGTHIG-P25:795	'gro kun zhi bde'i gnas su 'dren mdzad pa'i :	79	gro kun zhi bde gnas su bgrang mdzad ba 
BO_TZ_PEMA-SANGTHIG-P25:796	gsung mchog dam chos rnams kyi thugs\u0f8e	79	gsung mchog dam chos rnams kyi thugs\u0f8e 
BO_TZ_PEMA-SANGTHIG-P25:797	sa dang lam la gnas nas zhing mchog skyong :	79	sa dang lam la gnas nas zhing mchog skyong 
BO_TZ_PEMA-SANGTHIG-P25:798	'phags pa'i dge 'dun rnams kyi thugs\u0f8e	79	phag ba dge dun rnams kyi thugs\u0f8e 
BO_TZ_PEMA-SANGTHIG-P25:799	lta sgom mkhyen pa mchog la mnga' brnyes pa'i :	79	lta sgom mkhyen ba mchog la mnga brnyes ba 
BO_TZ_PEMA-SANGTHIG-P25:800	skye mchog bla ma rnams kyi thugs\u0f8e	80	skye mchog bla ma rnams kyi thugs\u0f8e 
BO_TZ_PEMA-SANGTHIG-P25:801	dngos grub thogs pa med par ster mdzad pa'i :	80	dngos grub thogs ba med ba ster mdzad ba 
BO_TZ_PEMA-SANGTHIG-P25:802	yi dam rgyal ba zhi khro'i thugs\u0f8e	80	yi dam rgyal ba zhi khro thugs\u0f8e 
BO_TZ_PEMA-SANGTHIG-P25:803	phyi nang gsang ba'i bar chad kun sel ba'i :	80	phyi nang gsang ba ba chad kun sel ba 
BO_TZ_PEMA-SANGTHIG-P25:804	mkha' 'gro dam can rnams kyi thugs\u0f8e	80	mkha gro dam can rnams kyi thugs\u0f8e 
BO_TZ_PEMA-SANGTHIG-P25:805	ma skyes rang bzhin gdod nas dag pa ste :	80	ma skye rang bzhin gdod nas dag ba ste 
BO_TZ_PEMA-SANGTHIG-P25:806	rang bzhin spros bral chos sku'i thugs\u0f8e	80	rang bzhin spros bral chos sku thugs\u0f8e 
BO_TZ_PEMA-SANGTHIG-P25:807	dug lnga ye shes lnga yi ngo bor smin :	80	dug lnga ye shes lnga yi ngo bor smin 
BO_TZ_PEMA-SANGTHIG-P25:808	zhi ba longs spyod rdzogs sku'i thugs\u0f8e	80	zhi ba longs spyod rdzogs sku thugs\u0f8e 
BO_TZ_PEMA-SANGTHIG-P25:809	rang snang ma 'gags gzhan snang der ston pa'i :	80	rang snang ma gag gzhan snang der ston ba 
BO_TZ_PEMA-SANGTHIG-P25:810	sprul sku 'gro don mdzad pa'i thugs\u0f8e	81	sprul sku gro don mdzad ba thugs\u0f8e 
BO_TZ_PEMA-SANGTHIG-P25:811	zhi ba lhun gyis grub pa'i dkyil 'khor nas :	81	zhi ba lhun gyis grub ba dkyil khor nas 
BO_TZ_PEMA-SANGTHIG-P25:812	bzhi bcu rtsha gnyis rgyal ba'i thugs\u0f8e	81	bzhi chu rtsha gnyis rgyal ba thugs\u0f8e 
BO_TZ_PEMA-SANGTHIG-P25:813	khrag 'thung rol pa'i dur khrod chen po nas :	81	khrag thung rol ba dur khrod chen po nas 
BO_TZ_PEMA-SANGTHIG-P25:814	lnga bcu rtsha brgyad khro bo'i thugs\u0f8e	81	lnga chu rtsha brgyad khro bo thugs\u0f8e 
BO_TZ_PEMA-SANGTHIG-P25:815	sku mchog 'gyur ba med pa'i dkyil 'khor nas :	81	sku mchog gyur ba med ba dkyil khor nas 
BO_TZ_PEMA-SANGTHIG-P25:816	'jam dpal sku yi lha tshhogs thugs\u0f8e	81	jam dpal sku yi lha tshhogs thugs\u0f8e 
BO_TZ_PEMA-SANGTHIG-P25:817	gsung mchog 'gag pa med pa'i dkyil 'khor nas :	81	gsung mchog gag ba med ba dkyil khor nas 
BO_TZ_PEMA-SANGTHIG-P25:818	pad+ma gsung gi lha tshhogs thugs\u0f8e	81	pad+ma gsung gi lha tshhogs thugs\u0f8e 
BO_TZ_PEMA-SANGTHIG-P25:819	thugs mchog g.yo ba med pa'i dkyil 'khor nas :	81	thugs mchog g.yo ba med ba dkyil khor nas 
BO_TZ_PEMA-SANGTHIG-P25:820	yang dag thugs kyi lha tshhogs thugs\u0f8e	82	yang dag thugs kyi lha tshhogs thugs\u0f8e 
BO_TZ_PEMA-SANGTHIG-P25:821	yon tan lhun gyis grub pa'i dkyil 'khor nas :	82	yon tan lhun gyis grub ba dkyil khor nas 
BO_TZ_PEMA-SANGTHIG-P25:822	bdud rtshi yon tan lha tshhogs thugs\u0f8e	82	bdud rtshi yon tan lha tshhogs thugs\u0f8e 
BO_TZ_PEMA-SANGTHIG-P25:823	phrin las drag po sgrol byed dkyil 'khor nas :	82	phrin las drag po sgrol byed dkyil khor nas 
BO_TZ_PEMA-SANGTHIG-P25:824	phur pa phrin las lha tshhogs thugs\u0f8e	82	phur ba phrin las lha tshhogs thugs\u0f8e 
BO_TZ_PEMA-SANGTHIG-P25:825	sha khrag rgya mtshhor 'khyil ba'i dkyil 'khor nas :	82	sha khrag rgya mtshhor khyil ba dkyil khor nas 
BO_TZ_PEMA-SANGTHIG-P25:826	rbod gtong ma mo'i lha tshhogs thugs\u0f8e	82	rbod gtong ma mo lha tshhogs thugs\u0f8e 
BO_TZ_PEMA-SANGTHIG-P25:827	thugs rje gdung 'tshhob sku yi dkyil 'khor nas :	82	thugs rje gdung tshhob sku yi dkyil khor nas 
BO_TZ_PEMA-SANGTHIG-P25:828	rig 'dzin bla ma'i lha tshhogs thugs\u0f8e	82	rig dzin bla ma lha tshhogs thugs\u0f8e 
BO_TZ_PEMA-SANGTHIG-P25:829	dam rdzas rdza ltar lhag pa'i dkyil 'khor nas :	82	dam rdzas rdza ltar lhag ba dkyil khor nas 
BO_TZ_PEMA-SANGTHIG-P25:830	'jig rten mchod bstod lha tshhogs thugs\u0f8e	83	jig rten mchod bstod lha tshhogs thugs\u0f8e 
BO_TZ_PEMA-SANGTHIG-P25:831	dgra bgegs gdug pa 'dul ba'i dkyil 'khor nas :	83	dgra bgegs gdug ba dul ba dkyil khor nas 
BO_TZ_PEMA-SANGTHIG-P25:832	dmod pa drag sngags lha tshhogs thugs\u0f8e	83	dmod ba drag sngags lha tshhogs thugs\u0f8e 
BO_TZ_PEMA-SANGTHIG-P25:833	dpal gyi spyan sngar rang rtags srog snying phul :	83	dpal gyi spyan sngar rang rtags srog snying bul 
BO_TZ_PEMA-SANGTHIG-P25:834	dam can rgya mtshho rnams kyi thugs\u0f8e	83	dam can rgya mtshho rnams kyi thugs\u0f8e 
BO_TZ_PEMA-SANGTHIG-P25:835	sangs rgyas bstan pa srung bar zhal bzhes pa'i :	83	sangs rgya ston ba srung ba zhal bzhes ba 
BO_TZ_PEMA-SANGTHIG-P25:836	mthu chen dpal mgon lcam dral thugs\u0f8e	83	mthu chen dpal mgon lcam dral thugs\u0f8e 
BO_TZ_PEMA-SANGTHIG-P25:837	sngags kyi rgyud sde bstan pa'i bya ra mdzad :	83	sngags kyi brgyud sde ston ba byed ra mdzad 
BO_TZ_PEMA-SANGTHIG-P25:838	sngags bdag sngags srung rnams kyi thugs\u0f8e	83	sngags bdag sngags srung rnams kyi thugs\u0f8e 
BO_TZ_PEMA-SANGTHIG-P25:839	slob dpon chen po'i bka' yis gnyer du gtad :	83	slob dpon chen po bka yis gnyer du gtod 
BO_TZ_PEMA-SANGTHIG-P25:840	gter bdag gter srung rnams kyi thugs\u0f8e	84	gter bdag gter srung rnams kyi thugs\u0f8e 
BO_TZ_PEMA-SANGTHIG-P25:841	tshhul bzhin sgrub pa byed pa'i grogs mdzad pa'i :	84	tshhul bzhin sgrub ba byed ba grogs mdzad ba 
BO_TZ_PEMA-SANGTHIG-P25:842	gzhi bdag gzhi srung rnams kyi thugs\u0f8e	84	gzhi bdag gzhi srung rnams kyi thugs\u0f8e 
BO_TZ_PEMA-SANGTHIG-P25:843	'jig rten khams 'dir mthu dang ldan pa'i bdag :	84	jig rten khams dir mthu dang ldan ba bdag 
BO_TZ_PEMA-SANGTHIG-P25:844	dregs pa'i sde dpon sum cu'i thugs\u0f8e	84	dregs ba sde dpon sum cu thugs\u0f8e 
BO_TZ_PEMA-SANGTHIG-P25:845	zlog pas mi bzlog sngags zlog mkhan gyi gshed :	84	zlog ba mi bzlog sngags zlog mkhan gyi gshed 
BO_TZ_PEMA-SANGTHIG-P25:846	dpal mgon ma ning nag po'i thugs\u0f8e	84	dpal mgon ma ning nag po thugs\u0f8e 
BO_TZ_PEMA-SANGTHIG-P25:847	stong khams 'di na drag rtshal gzer gyi bdag :	84	stong khams di na drag rtshal gzer gyi bdag 
BO_TZ_PEMA-SANGTHIG-P25:848	gza' bdud chen po dpal 'bar thugs\u0f8e	84	gza bdud chen po dpal bar thugs\u0f8e 
BO_TZ_PEMA-SANGTHIG-P25:849	mthu nus thogs med dgra bgegs kun gyi gshed :	84	mthu nus thogs med dgra bgegs kun gyi gshed 
BO_TZ_PEMA-SANGTHIG-P25:850	srung ma e ka dza ti'i thugs\u0f8e	85	srung ma e ka dza ti thugs\u0f8e 
BO_TZ_PEMA-SANGTHIG-P25:851	a ti bla med bka' yi bya ra mdzad :	85	a ti bla med bka yi byed ra mdzad 
BO_TZ_PEMA-SANGTHIG-P25:852	shan pa srog sgrub nag mo'i thugs\u0f8e	85	shan ba srog sgrub nag mo thugs\u0f8e 
BO_TZ_PEMA-SANGTHIG-P25:853	dam la gnas shing gnod byed sgrol mdzad pa'i :	85	dam la gnas shing gnod byed sgrol mdzad ba 
BO_TZ_PEMA-SANGTHIG-P25:854	gnod sbyin shan pa dmar nag thugs\u0f8e	85	gnod sbyin shan ba dmar nag thugs\u0f8e 
BO_TZ_PEMA-SANGTHIG-P25:855	sangs rgyas bstan pa srung bar zhal bzhes pa'i :	85	sangs rgya ston ba srung ba zhal bzhes ba 
BO_TZ_PEMA-SANGTHIG-P25:856	dam can rdo rje legs pa'i thugs\u0f8e	85	dam can rdo rje legs ba thugs\u0f8e 
BO_TZ_PEMA-SANGTHIG-P25:857	longs spyod rin chen gter la mnga' brnyes pa'i :	85	longs spyod rin chen gter la mnga brnyes ba 
BO_TZ_PEMA-SANGTHIG-P25:858	nor bdag gnod sbyin rnams kyi thugs\u0f8e	85	nor bdag gnod sbyin rnams kyi thugs\u0f8e 
BO_TZ_PEMA-SANGTHIG-P25:859	las kyi mtha' sdud 'jam dpal thugs kyi sras :	85	las kyi mtha sdud jam dpal thugs kyi sras 
BO_TZ_PEMA-SANGTHIG-P25:860	srung ma na ga rak+sha'i thugs\u0f8e	86	srung ma na ga rak+sha thugs\u0f8e 
BO_TZ_PEMA-SANGTHIG-P25:861	lha khang gtshug lag skyong bar zhal bzhes pa'i :	86	lha khang gtshug lag skyong ba zhal bzhes ba 
BO_TZ_PEMA-SANGTHIG-P25:862	rgyal po li byin ha ra'i thugs\u0f8e	86	rgyal po li byin ha ra thugs\u0f8e 
BO_TZ_PEMA-SANGTHIG-P25:863	srid pa bod kyi srog bdag chen po ni :	86	srid ba bod kyi srog bdag chen po ni 
BO_TZ_PEMA-SANGTHIG-P25:864	bdud po yab rje nag po'i thugs\u0f8e	86	bdud po yab rje nag po thugs\u0f8e 
BO_TZ_PEMA-SANGTHIG-P25:865	gtor len rnal 'byor skyong bar zhal bzhes pa'i :	86	thor len rnal byor skyong ba zhal bzhes ba 
BO_TZ_PEMA-SANGTHIG-P25:866	bod skyong brtan ma bcu gnyis thugs\u0f8e	86	bod skyong brtan ma chu gnyis thugs\u0f8e 
BO_TZ_PEMA-SANGTHIG-P25:867	bskang ngo bskal pa'i bar du thugs dam bskang :	86	skong ngo bskal ba ba du thugs dam skong 
BO_TZ_PEMA-SANGTHIG-P25:868	bskang ba med de khams gsum yongs kyis bskang :	86	skong ba med de khams gsum yongs kyis skong 
BO_TZ_PEMA-SANGTHIG-P25:869	sbyor ba med de khams gsum yongs kyis sbyor :	86	sbyor ba med de khams gsum yongs kyis sbyor 
BO_TZ_PEMA-SANGTHIG-P25:870	sgrol ba med de khams gsum yongs kyis sgrol :	87	sgrol ba med de khams gsum yongs kyis sgrol 
BO_TZ_PEMA-SANGTHIG-P25:871	ye sbyor ye sgrol chen pos thugs dam bskang :	87	ye sbyor ye sgrol chen pos thugs dam skong 
BO_TZ_PEMA-SANGTHIG-P25:872	rtsha brgyad stong la sbyar ba'i bdud rtshi dang : khyad par rmad du byung ba'i gtor ma dang : 'bru bcud stong la sbyar ba'i dza gad dang : pad+ma mam sar bcas pa'i rak+ta dang : dzapa? dang gar 'cham ging dang stangs stabs dang : snang gsal 'od kyi zhun mar gsal ba dang :	87	rtsha brgyad stong la sbyor ba bdud rtshi dang khyad ba rmad du byung ba thor ma dang bru bcud stong la sbyor ba dza gad dang pad+ma mam sar cha ba rak+ta dang dzapa? dang gar cham ging dang stangs stabs dang snang gsal d kyi zhun mar gsal ba dang 
BO_TZ_PEMA-SANGTHIG-P25:873	stong gsal dbyer med lta sgom mthar thug dang : tshhogs kyi longs spyod rgya chen 'di dag gis :	87	stong gsal dbyer med lta sgom mthar thug dang tshhogs kyi longs spyod rgya chen di dag gis 
BO_TZ_PEMA-SANGTHIG-P25:874	skyes mchog bla ma rnams kyi thugs dam bskang :	87	skye mchog bla ma rnams kyi thugs dam skong 
BO_TZ_PEMA-SANGTHIG-P25:875	yi dam lha tshhogs rnams kyi thugs\u0f8e	87	yi dam lha tshhogs rnams kyi thugs\u0f8e 
BO_TZ_PEMA-SANGTHIG-P25:876	las byed mkha' 'gro rnams kyi thugs\u0f8e	87	las byed mkha gro rnams kyi thugs\u0f8e 
BO_TZ_PEMA-SANGTHIG-P25:877	gter bdag gter srung rnams kyi thugs\u0f8e	87	gter bdag gter srung rnams kyi thugs\u0f8e 
BO_TZ_PEMA-SANGTHIG-P25:878	gzhi bdag gzhi srung rnams kyi thugs\u0f8e	87	gzhi bdag gzhi srung rnams kyi thugs\u0f8e 
BO_TZ_PEMA-SANGTHIG-P25:879	mchod yul gong ma rnams kyi thugs\u0f8e	87	mchod yul gong ma rnams kyi thugs\u0f8e 
BO_TZ_PEMA-SANGTHIG-P25:880	sbyin yul 'og ma rnams kyi thugs\u0f8e	88	sbyin yul g ma rnams kyi thugs\u0f8e 
BO_TZ_PEMA-SANGTHIG-P25:881	rigs drug pha ma rnams kyi thugs\u0f8e	88	rigs drug pha ma rnams kyi thugs\u0f8e 
BO_TZ_PEMA-SANGTHIG-P25:882	lan chags mgron gyur rnams kyi thugs\u0f8e	88	lan chags mgron gyur rnams kyi thugs\u0f8e 
BO_TZ_PEMA-SANGTHIG-P25:883	thams cad thugs dam gnyan po des bskangs la :	88	thams cad thugs dam gnyan po des skong la 
BO_TZ_PEMA-SANGTHIG-P25:884	g.yar dam sor chud dngos grub bstshal du gsol :	88	g.yar dam sor chud dngos grub bstshal du gsol 
BO_TZ_PEMA-SANGTHIG-P25:885	de nas zhi ba gnas dag gi bskang ba ni /	88	de nas zhi ba gnas dag gi skong ba ni 
BO_TZ_PEMA-SANGTHIG-P25:886	om: yid kyi rnam shes gnas dag pa :	88	om: yid kyi rnam shes gnas dag ba 
BO_TZ_PEMA-SANGTHIG-P25:887	kun tu bzang po'i thugs dam bskang :	88	kun tu bzang po thugs dam skong 
BO_TZ_PEMA-SANGTHIG-P25:888	chos kyi ngo bo gnas dag pa :	88	chos kyi ngo bo gnas dag ba 
BO_TZ_PEMA-SANGTHIG-P25:889	kun tu bzang mo'i thugs\u0f8e	88	kun tu bzang mo thugs\u0f8e 
BO_TZ_PEMA-SANGTHIG-P25:890	phung po lnga po gnas dag pa :	89	phung po lnga po gnas dag ba 
BO_TZ_PEMA-SANGTHIG-P25:891	rgyal ba yab lnga'i thugs\u0f8e	89	rgyal ba yab lnga thugs\u0f8e 
BO_TZ_PEMA-SANGTHIG-P25:892	'byung ba lnga po gnas dag pa :	89	byung ba lnga po gnas dag ba 
BO_TZ_PEMA-SANGTHIG-P25:893	rgyal ba yum lnga'i thugs\u0f8e	89	rgyal ba yum lnga thugs\u0f8e 
BO_TZ_PEMA-SANGTHIG-P25:894	rnam shes tshhogs brgyad gnas dag pa :	89	rnam shes tshhogs brgyad gnas dag ba 
BO_TZ_PEMA-SANGTHIG-P25:895	sems dpa' brgyad kyi thugs\u0f8e	89	sems dpa brgyad kyi thugs\u0f8e 
BO_TZ_PEMA-SANGTHIG-P25:896	rnam shes yul brgyad gnas dag pa :	89	rnam shes yul brgyad gnas dag ba 
BO_TZ_PEMA-SANGTHIG-P25:897	sems ma brgyad kyi thugs\u0f8e	89	sems ma brgyad kyi thugs\u0f8e 
BO_TZ_PEMA-SANGTHIG-P25:898	lus kyi chos bzhi gnas dag pa :	89	lus kyi chos bzhi gnas dag ba 
BO_TZ_PEMA-SANGTHIG-P25:899	khro bo bzhi yi thugs\u0f8e	89	khro bo bzhi yi thugs\u0f8e 
BO_TZ_PEMA-SANGTHIG-P25:900	rtag chad mu bzhi gnas dag pa :	90	rtag chad mu bzhi gnas dag ba 
BO_TZ_PEMA-SANGTHIG-P25:901	khro mo bzhi yi thugs\u0f8e	90	khro mo bzhi yi thugs\u0f8e 
BO_TZ_PEMA-SANGTHIG-P25:902	nyon mongs drug po gnas dag pa :	90	nyon mongs drug po gnas dag ba 
BO_TZ_PEMA-SANGTHIG-P25:903	thub pa drug gi thugs dam bskang :	90	thub ba drug gi thugs dam skong 
BO_TZ_PEMA-SANGTHIG-P25:904	khro bo gnas gyur gyi bskang ba ni /	90	khro bo gnas gyur gyi skong ba ni 
BO_TZ_PEMA-SANGTHIG-P25:905	hu~m: kun gzhi yid chos gnas gyur pa :	90	hu~m: kun gzhi yid chos gnas gyur ba 
BO_TZ_PEMA-SANGTHIG-P25:906	dpal chen yab yum thugs dam bskang :	90	dpal chen yab yum thugs dam skong 
BO_TZ_PEMA-SANGTHIG-P25:907	nyon mongs dug lnga gnas gyur pa :	90	nyon mongs dug lnga gnas gyur ba 
BO_TZ_PEMA-SANGTHIG-P25:908	khrag 'thung yab lnga'i thugs\u0f8e	90	khrag thung yab lnga thugs\u0f8e 
BO_TZ_PEMA-SANGTHIG-P25:909	'byung ba lus lnga gnas gyur pa :	90	byung ba lus lnga gnas gyur ba 
BO_TZ_PEMA-SANGTHIG-P25:910	khrag 'thung yum lnga'i thugs\u0f8e	91	khrag thung yum lnga thugs\u0f8e 
BO_TZ_PEMA-SANGTHIG-P25:911	rnam bzhi'i rtog pa gnas gyur pa :	91	rnam bzhi rtogs ba gnas gyur ba 
BO_TZ_PEMA-SANGTHIG-P25:912	he ru kahbzhi'i thugs\u0f8e	91	he ru kahbzhi thugs\u0f8e 
BO_TZ_PEMA-SANGTHIG-P25:913	skye gnas bzhi po gnas gyur pa :	91	skye gnas bzhi po gnas gyur ba 
BO_TZ_PEMA-SANGTHIG-P25:914	kro d+hi rigs bzhi'i thugs\u0f8e	91	kro d+hi rigs bzhi thugs\u0f8e 
BO_TZ_PEMA-SANGTHIG-P25:915	rnam 'gyur tshhogs brgyad gnas gyur pa :	91	rnam gyur tshhogs brgyad gnas gyur ba 
BO_TZ_PEMA-SANGTHIG-P25:916	khro mo brgyad kyi thugs\u0f8e	91	khro mo brgyad kyi thugs\u0f8e 
BO_TZ_PEMA-SANGTHIG-P25:917	rnam 'gyur yul brgyad gnas gyur pa :	91	rnam gyur yul brgyad gnas gyur ba 
BO_TZ_PEMA-SANGTHIG-P25:918	phra men brgyad kyi thugs\u0f8e	91	phra men brgyad kyi thugs\u0f8e 
BO_TZ_PEMA-SANGTHIG-P25:919	rtag chad mtha' bzhi gnas gyur pa :	91	rtag chad mtha bzhi gnas gyur ba 
BO_TZ_PEMA-SANGTHIG-P25:920	sgo ma bzhi yi thugs\u0f8e	92	sgo ma bzhi yi thugs\u0f8e 
BO_TZ_PEMA-SANGTHIG-P25:921	sna tshhogs rtog pa gnas gyur pa :	92	sna tshhogs rtogs ba gnas gyur ba 
BO_TZ_PEMA-SANGTHIG-P25:922	dbang mo nyer brgyad thugs\u0f8e	92	dbang mo nyer brgyad thugs\u0f8e 
BO_TZ_PEMA-SANGTHIG-P25:923	mi shigs sku yi thugs dam bskang :	92	mi shigs sku yi thugs dam skong 
BO_TZ_PEMA-SANGTHIG-P25:924	'gag med gsung gi thugs\u0f8e	92	gag med gsung gi thugs\u0f8e 
BO_TZ_PEMA-SANGTHIG-P25:925	'gyur med thugs kyi thugs\u0f8e	92	gyur med thugs kyi thugs\u0f8e 
BO_TZ_PEMA-SANGTHIG-P25:926	yon tan mi zad thugs\u0f8e	92	yon tan mi zad thugs\u0f8e 
BO_TZ_PEMA-SANGTHIG-P25:927	phrin las rgyan gyi thugs\u0f8e	92	phrin las rgyan gyi thugs\u0f8e 
BO_TZ_PEMA-SANGTHIG-P25:928	ye shes 'khor lo'i thugs dam bskang :	92	ye shes khor lo thugs dam skong 
BO_TZ_PEMA-SANGTHIG-P25:929	nyams chag thams cad bskang gyur cig :	92	nyams chag thams cad skong gyur cig 
BO_TZ_PEMA-SANGTHIG-P25:930	rtog sgrib thams cad dag gyur cig :	93	rtogs sgrib thams cad dag gyur cig 
BO_TZ_PEMA-SANGTHIG-P25:931	bskangs gyur dbang dang dngos grub stshol :	93	skong gyur dbang dang dngos grub stshol 
BO_TZ_PEMA-SANGTHIG-P25:932	de nas las gzhung gi ho :	93	de nas las gzhung gi ho 
BO_TZ_PEMA-SANGTHIG-P25:933	dkyil 'khor lha tshhogs dgongs su gsol :	93	dkyil khor lha tshhogs dgongs su gsol 
BO_TZ_PEMA-SANGTHIG-P25:934	zhes sogs nas zhal bstab kyi bar song nas /	93	zhes sogs nas zhal stob kyi ba gro nas 
BO_TZ_PEMA-SANGTHIG-P25:935	de nas bdag nyid 'jug cing byin rlabs dbang len bya ba la /	93	de nas bdag nyid jug cing byin rlabs dbang len byed ba la 
BO_TZ_PEMA-SANGTHIG-P25:936	ji ltar bltams pa tsham gyis sogs khrus bgegs man+dal nas rjes kyi gtang rag gi man+dal phul ba'i bar song nas /	93	ji ltar ltems ba tsham gyis sogs khru bgegs man+dal nas rjes kyi gtong rag gi man+dal bul ba ba gro nas 
BO_TZ_PEMA-SANGTHIG-P25:937	bdag nyid 'jug cing dbang blang ba dang bcas pas dbang bzhi'i dam tshhig nyams pa sor chud par bsam /	93	bdag nyid jug cing dbang blang ba dang cha ba dbang bzhi dam tshhig nyams ba sor chud ba bsam 
BO_TZ_PEMA-SANGTHIG-P25:938	de nas tshhogs la rol zhing smon lam gdab pa ni /	93	de nas tshhogs la rol zhing smon lam gdab ba ni 
BO_TZ_PEMA-SANGTHIG-P25:939	ho : rab 'byams dkyil 'khor lha tshhogs dgongs su gsol :	93	ho rab byam dkyil khor lha tshhogs dgongs su gsol 
BO_TZ_PEMA-SANGTHIG-P25:940	bdag cag rnal 'byor mched dang lcam dral gyis :	94	bdag cag rnal byor mched dang lcam dral gyis 
BO_TZ_PEMA-SANGTHIG-P25:941	dam tshhig chen po'i mchod pa phul pa'i mthus :	94	dam tshhig chen po mchod ba bul ba mthus 
BO_TZ_PEMA-SANGTHIG-P25:942	nyams chag rtog sgrib mun pa dbyings su sangs :	94	nyams chag rtogs sgrib mun ba dbyings su sangs 
BO_TZ_PEMA-SANGTHIG-P25:943	mchog thun dngos grub ye shes snang ba rgyas :	94	mchog thun dngos grub ye shes snang ba rgya 
BO_TZ_PEMA-SANGTHIG-P25:944	bla ma yi dam mkha' 'gros rjes bzung nas :	94	bla ma yi dam mkha gros rjes bzung nas 
BO_TZ_PEMA-SANGTHIG-P25:945	rdo rje'i lam las rnam grol 'bras bu'i mchog :	94	rdo rje lam las rnam grol bras bu mchog 
BO_TZ_PEMA-SANGTHIG-P25:946	dka' ba med par tshhe 'dir 'grub par shog :	94	dka ba med ba tshhe dir grub ba shog 
BO_TZ_PEMA-SANGTHIG-P25:947	nam zhig mi rtag skye 'chi byung srid tshhe :	94	nam jig mi rtag skye chi byung srid tshhe 
BO_TZ_PEMA-SANGTHIG-P25:948	ye shes sgron me'i snang bas shul mtshhon te :	94	ye shes sgron me snang ba shul mtshhon te 
BO_TZ_PEMA-SANGTHIG-P25:949	'og min bde chen zhing du dbugs phyung nas :	94	g min bde chen zhing du dbugs byin nas 
BO_TZ_PEMA-SANGTHIG-P25:950	phyam gcig lhan skyes ye shes sku 'grub shog :	95	phyam gcig lhan skye ye shes sku grub shog 
BO_TZ_PEMA-SANGTHIG-P25:951	de ltar mthol zhing bshags pa yis :	95	de ltar mthol zhing chags ba yis 
BO_TZ_PEMA-SANGTHIG-P25:952	bdag cag gsang sngags sgor zhugs rnams :	95	bdag cag gsang sngags sgor jug rnams 
BO_TZ_PEMA-SANGTHIG-P25:953	rtsha ba yan lag dam tshhig gi :	95	rtsha ba yan lag dam tshhig gi 
BO_TZ_PEMA-SANGTHIG-P25:954	nyams chag thams cad bskangs gyur cig :	95	nyams chag thams cad skong gyur cig 
BO_TZ_PEMA-SANGTHIG-P25:955	mchog dang thun mong la sogs te :	95	mchog dang thun mong la sogs te 
BO_TZ_PEMA-SANGTHIG-P25:956	dngos grub thams cad thob gyur cig :	95	dngos grub thams cad thob gyur cig 
BO_TZ_PEMA-SANGTHIG-P25:957	ta na ga na'i lta spyod dbang :	95	ta na ga na lta spyod dbang 
BO_TZ_PEMA-SANGTHIG-P25:958	sems kyi rtogs pa thob gyur cig :	95	sems kyi rtogs ba thob gyur cig 
BO_TZ_PEMA-SANGTHIG-P25:959	de lta bu yi 'gyod tshhangs kyis :	95	de lta bu yi gyod tshhangs kyis 
BO_TZ_PEMA-SANGTHIG-P25:960	bdag dang 'gro drug sems can rnams :	96	bdag dang gro drug sems can rnams 
BO_TZ_PEMA-SANGTHIG-P25:961	lus ngag yid gsum sgrib byang zhing :	96	lus ngag yid gsum sgrib byang zhing 
BO_TZ_PEMA-SANGTHIG-P25:962	na raka gnas kyang dong sprugs nas :	96	na raka gnas kyang dong sprug nas 
BO_TZ_PEMA-SANGTHIG-P25:963	'gro drug gnas nas thar gyur cig :	96	gro drug gnas nas thar gyur cig 
BO_TZ_PEMA-SANGTHIG-P25:964	lam lnga sa bcu'i rim pa rnams :	96	lam lnga sa chu rim ba rnams 
BO_TZ_PEMA-SANGTHIG-P25:965	skad cig nyid la bgrod gyur cig :	96	skad cig nyid la bgrod gyur cig 
BO_TZ_PEMA-SANGTHIG-P25:966	rig 'dzin rgyal ba'i zhing du grags :	96	rig dzin rgyal ba zhing du grags 
BO_TZ_PEMA-SANGTHIG-P25:967	sangs rgyas sku gsum thob par shog :	96	sangs rgya sku gsum thob ba shog 
BO_TZ_PEMA-SANGTHIG-P25:968	de las byung ba'i dge ba yis :	96	de las byung ba dge ba yis 
BO_TZ_PEMA-SANGTHIG-P25:969	gsang sngags rdo rje theg pa rnams :	96	gsang sngags rdo rje theg ba rnams 
BO_TZ_PEMA-SANGTHIG-P25:970	bka' btshan byin che dar gyur cig :	97	bka btshan byin che dar gyur cig 
BO_TZ_PEMA-SANGTHIG-P25:971	kun kyang sangs rgyas thob par shog :	97	kun kyang sangs rgya thob ba shog 
BO_TZ_PEMA-SANGTHIG-P25:972	gsang sngags 'di bsgrags rgyal khams su :	97	gsang sngags di sgrog rgyal khams su 
BO_TZ_PEMA-SANGTHIG-P25:973	mi nad phyugs nad zhi gyur cig :	97	mi nad phyugs nad zhi gyur cig 
BO_TZ_PEMA-SANGTHIG-P25:974	mi dang lo phyugs legs gyur cig :	97	mi dang lo phyugs legs gyur cig 
BO_TZ_PEMA-SANGTHIG-P25:975	dge 'dun dge bcu spyod gyur cig :	97	dge dun dge chu spyod gyur cig 
BO_TZ_PEMA-SANGTHIG-P25:976	de nas lhag ma nas brtsham las byang mthar dbyung la /	97	de nas lhag ma nas brtsham las byang mthar byin la 
BO_TZ_PEMA-SANGTHIG-P25:977	rjes kyi gtang rag gi bstod pa'i skabs /	97	rjes kyi gtong rag gi bstod ba skabs 
BO_TZ_PEMA-SANGTHIG-P25:978	brjod med shes rab mi g.yo chos kyi sku :	97	rjod med shes rab mi g.yo chos kyi sku 
BO_TZ_PEMA-SANGTHIG-P25:979	bde chen longs spyod rdzogs sku rigs lnga'i gtsho :	97	bde chen longs spyod rdzogs sku rigs lnga gtsho 
BO_TZ_PEMA-SANGTHIG-P25:980	thugs rje thabs mkhas rgya che sprul pa'i sku :	98	thugs rje thabs mkhas rgya che sprul ba sku 
BO_TZ_PEMA-SANGTHIG-P25:981	zhi khro sku gsum lha la phyag 'tshhal bstod :	98	zhi khro sku gsum lha la phyag tshhal bstod 
BO_TZ_PEMA-SANGTHIG-P25:982	ces shwa lo ka gcig pus bstod /	98	ces shwa lo ka gcig pus bstod 
BO_TZ_PEMA-SANGTHIG-P25:983	rten yod med dang 'brel brtan bzhugs gshegs gsol gang 'os bya /	98	rten yod med dang brel brtan bzhugs gshegs gsol gang s byed 
BO_TZ_PEMA-SANGTHIG-P25:984	bdag bskyed bsdu ldang dge bsngo shis brjod sogs gzhung ltar byas pas grub bo //	98	bdag skyed sdud ldang dge sngo shis rjod sogs gzhung ltar byed ba grub bo 
BO_TZ_PEMA-SANGTHIG-P25:985	zhi khro rab 'byams rgyal ba'i lha //	98	zhi khro rab byam rgyal ba lha 
BO_TZ_PEMA-SANGTHIG-P25:986	dkyil 'khor gcig tu bsgrubs byas te //	98	dkyil khor gcig tu sgrub byed te 
BO_TZ_PEMA-SANGTHIG-P25:987	dam tshhig nyams chag gso ba'i thabs //	98	dam tshhig nyams chag gso ba thabs 
BO_TZ_PEMA-SANGTHIG-P25:988	gter gzhung ji bzhin bsdebs pa'i dges //	98	gter gzhung ji bzhin sdeb ba dges 
BO_TZ_PEMA-SANGTHIG-P25:989	bdag cag sngags kyi sgor zhugs rnams //	98	bdag cag sngags kyi sgor jug rnams 
BO_TZ_PEMA-SANGTHIG-P25:990	rtsha ba yan lag gis bsdus pa'i //	99	rtsha ba yan lag gis sdud ba 
BO_TZ_PEMA-SANGTHIG-P25:991	nyams chag ma lus sor chud de //	99	nyams chag ma lus sor chud de 
BO_TZ_PEMA-SANGTHIG-P25:992	sku lnga'i 'bras bzang myur smin shog	99	sku lnga bras bzang myur smin shog 
BO_TZ_PEMA-SANGTHIG-P25:993	/ces pa'ang rtsha gsum pad+ma gsang thig dang / thugs sgrub bde gshegs 'dus pa gang la'ang sbyar du rung ba'i zhi khro'i skong bshags kyi cho ga 'di yang gter gzhung rdo rje'i gsung la 'thad ldan man ngag gis zur brgyan te bdud 'joms nam mkha'i rdo rjes ngag nas smras rim bzhin blo gsal dpal ldan mkhas	99	ba rtsha gsum pad+ma gsang thig dang thugs sgrub bde gshegs du ba gang la sbyor du rung ba zhi khro skong chags kyi cho ga di yang gter gzhung rdo rje gsung la thad ldan man ngag gis zur rgyan te bdud joms nam mkha rdo rjes ngag nas smras rim bzhin blo gsal dpal ldan mkhas 
BO_TZ_PEMA-SANGTHIG-P25:994	mchog nas dag cing mgyogs par bris pa khams gsum sems can thams cad kun bzang pad+maka ra'i go 'phang la 'god pa'i rgyur gyur cig	99	mchog nas dag cing mgyog ba bri ba khams gsum sems can thams cad kun bzang pad+maka ra go phen la god ba rgyur gyur cig 
BO_TZ_PEMA-SANGTHIG-P25:995	/sid+d+hi rastu /// /	99	rastu 
