segmentnr	original	folio	stemmed
BO_TZ_TSASUM-OSEL-NYINGTHIG-P12:0	@#// rtsha gsum 'od gsal snying tig las /	0	rtsha gsum d gsal snying tig las 
BO_TZ_TSASUM-OSEL-NYINGTHIG-P12:1	rgyud lung man ngag gi dgongs don 'dus gsal du bshad pa 'od gsal ye shes nyin byed ces bya ba bzhugs so //	0	brgyud lung man ngag gi dgongs don du gsal du chad ba d gsal ye shes nyin byed ces byed ba bzhugs so 
BO_TZ_TSASUM-OSEL-NYINGTHIG-P12:2	'od gsal thig le chen po'i dbyings sims kyang //	0	d gsal thig le chen po dbyings sims kyang 
BO_TZ_TSASUM-OSEL-NYINGTHIG-P12:3	'od gsal sgyu 'phrul drwa ba'i rol sgeg las //	0	d gsal sgyu phrul drwa ba rol sgeg las 
BO_TZ_TSASUM-OSEL-NYINGTHIG-P12:4	'od gsal rtsha gsum rgya mtshho'i sprin 'phro ba'i //	0	d gsal rtsha gsum rgya mtshho sprin phro ba 
BO_TZ_TSASUM-OSEL-NYINGTHIG-P12:5	'od gsal sku brnyes pad+ma thod phreng rgyal //	0	d gsal sku brnyes pad+ma thod phreng rgyal 
BO_TZ_TSASUM-OSEL-NYINGTHIG-P12:6	'od gsal ye shes dag pa'i rang rtshal las //	0	d gsal ye shes dag ba rang rtshal las 
BO_TZ_TSASUM-OSEL-NYINGTHIG-P12:7	'od gsal snying gi ti ga'i yi ge'i sprin //	0	d gsal snying gi ti ga yi ge sprin 
BO_TZ_TSASUM-OSEL-NYINGTHIG-P12:8	'od gsal rdo rje snying po'i bstan pa'i rgyan //	0	d gsal rdo rje snying po ston ba rgyan 
BO_TZ_TSASUM-OSEL-NYINGTHIG-P12:9	'od gsal dgongs don 'byed la gnang ba stshol //	0	d gsal dgongs don byed la gnang ba stshol 
BO_TZ_TSASUM-OSEL-NYINGTHIG-P12:10	'od gsal rdo rje rtshe mo'i gseng lam nas ye shes rdo rje'i sku brnyes pa'i slob dpon chen po 'jam dpal bshes gnyen dang pan chen bi ma la dbyer med pa'i bdag nyid chen po /	1	d gsal rdo rje rtshe mo gseng lam nas ye shes rdo rje sku brnyes ba slob dpon chen po jam dpal bshes gnyen dang pan chen bi ma la dbyer med ba bdag nyid chen po 
BO_TZ_TSASUM-OSEL-NYINGTHIG-P12:11	gangs can bstan pa yongs rdzogs kyi sgron mer bsam bzhin byon pa'i 7kun mkhyen bla ma 'jam pa'i dbyangs mkhyen brtshe'i dbang po gsang mtshhan 'od gsal sprul pa'i rdo rje la /	1	gangs can ston ba yongs rdzogs kyi sgron mer bsam bzhin byon ba 7kun mkhyen bla ma jam ba dbyangs mkhyen brtshe dbang po gsang mtshhan d gsal sprul ba rdo rje la 
BO_TZ_TSASUM-OSEL-NYINGTHIG-P12:12	sangs rgyas gnyis pa o rgyan rdo rje 'chang chen pos bka' bab chen po bdun gyi mnga' bdag tu rdo rje'i lung gis che thang du bsngags pa'i ngo mtshhar gyi rnam thar chen po'i gsang mdzod kyi cha shas /	1	sangs rgya gnyis ba o rgyan rdo rje chang chen pos bka bab chen po bdun gyi mnga bdag tu rdo rje lung gis che thang du bsngags ba ngo mtshhar gyi rnam thar chen po gsang mdzod kyi cha shas 
BO_TZ_TSASUM-OSEL-NYINGTHIG-P12:13	thun mong gi gdul bya'i spyod yul du mngon sum du gyur pa'i bzhi pa zab mo dgongs pa'i gter gyi bye brag	1	thun mong gi gdul byed spyod yul du mngon sum du gyur ba bzhi ba zab mo dgongs ba gter gyi bye brag 
BO_TZ_TSASUM-OSEL-NYINGTHIG-P12:14	/rtsha gsum 'od gsal snying tig gi chos skor zab la rgyas par byon pa'i 'phro gzhi rgyud lung man ngag rdo rje'i tshhig gis ji ltar bstan pa'i rnam bshad 'dus gsal du dgod pa la /	1	gsum d gsal snying tig gi chos skor zab la rgya ba byon ba phro gzhi brgyud lung man ngag rdo rje tshhig gis ji ltar ston ba rnam chad du gsal du god ba la 
BO_TZ_TSASUM-OSEL-NYINGTHIG-P12:15	klong chen snying gi thig le'i rig 'dzin rtsha rgyud thod pa'i dum bu las /	1	klong chen snying gi thig le rig dzin rtsha brgyud thod ba dum bu las 
BO_TZ_TSASUM-OSEL-NYINGTHIG-P12:16	de yang rgyud lung man ngag gih	1	de yang brgyud lung man ngag gih 
BO_TZ_TSASUM-OSEL-NYINGTHIG-P12:17	khyad par 'di ni shes bya steh	1	khyad ba di ni shes byed steh 
BO_TZ_TSASUM-OSEL-NYINGTHIG-P12:18	ston pas bka' bstshal rgyud yin lah	1	ston ba bka bstshal brgyud yin lah 
BO_TZ_TSASUM-OSEL-NYINGTHIG-P12:19	zhu ba po yis bsdus pa lungah	1	ju ba po yis sdud ba lungah 
BO_TZ_TSASUM-OSEL-NYINGTHIG-P12:20	de la gcus dang dkrugs dang gabah	2	de la gcus dang dkrug dang gabah 
BO_TZ_TSASUM-OSEL-NYINGTHIG-P12:21	ji bzhin gsal ba man ngag steh	2	ji bzhin gsal ba man ngag steh 
BO_TZ_TSASUM-OSEL-NYINGTHIG-P12:22	zhes gsungs pa ltar /	2	zhes gsungs ba ltar 
BO_TZ_TSASUM-OSEL-NYINGTHIG-P12:23	dkyil 'khor rgya mtshho'i spro bsdu'i spyi mes ston pa rigs kun khyab bdag gi thugs rgyud du chos nyid rdo rje'i rang sgrar shar ba'i rtsha bshad man ngag gi rgyud mtha' drug tshhul bzhi'i sgrom du bzhugs pa rin po che'i mdzod lta bu dang / de'i dgongs pa sa bcu'i dbang phyug rnams kyis bkral ba'i lung gsang don rnam par 'byed pa mdzod kyi lde'u mig lta bur gyur pa grub pa sde bdun lta bu /	2	dkyil khor rgya mtshho spro sdud spyi mes ston ba rigs kun khyab bdag gi thugs brgyud du chos nyid rdo rje rang sgrar char ba rtsha chad man ngag gi brgyud mtha drug tshhul bzhi sgrom du bzhugs ba rin po che mdzod lta bu dang de dgongs ba sa chu dbang phyug rnams kyis bkral ba lung gsang don rnam ba byed ba mdzod kyi ldeu mig lta bur gyur ba grub ba sde bdun lta bu 
BO_TZ_TSASUM-OSEL-NYINGTHIG-P12:24	de dag gi gnad kyi man ngag grub brnyes rig 'dzin rnams kyis skal ldan nyams len du dril ba rang skal lag bcangs su spyod pa'i rnam gzhag gsum du mdzad pa ltar 'dir yang /	2	de dag gi gnad kyi man ngag grub brnyes rig dzin rnams kyis skal ldan nyams len du dril ba rang skal lag chang su spyod ba rnam jog gsum du mdzad ba ltar dir yang 
BO_TZ_TSASUM-OSEL-NYINGTHIG-P12:25	rig 'dzin rtsha rgyud ye shes drwa bas sgrub gzhi rtsha ba gsum gyi 'phro gzhi gzhi lam 'bras bu'i don gyi ngo bo mdor bstan /	2	rig dzin rtsha brgyud ye shes drwa ba sgrub gzhi rtsha ba gsum gyi phro gzhi gzhi lam bras bu don gyi ngo bo mdor ston 
BO_TZ_TSASUM-OSEL-NYINGTHIG-P12:26	rtsha gsum sgrub thabs lung gi dum bus bsgrub bya'i rnam pa rtsha gsum de dag spyir kun 'dus nor bu lugs su sgrub pa'i tshhul bye brag tu bshad /	2	rtsha gsum sgrub thabs lung gi dum bud sgrub byed rnam ba rtsha gsum de dag spyir kun du nor bu lugs su sgrub ba tshhul bye brag tu chad 
BO_TZ_TSASUM-OSEL-NYINGTHIG-P12:27	man ngag 'ja' lus rdo rje'i tshhig rkang gis sgrub byed sngon 'gro dngos gzhi rjes kyi rim pas nyams su blang bya'i lam rgyas par bshad pa'o //	2	man ngag ja lus rdo rje tshhig rkang gis sgrub byed sngon gro dngos gzhi rjes kyi rim ba nyams su blang byed lam rgya ba chad ba 
BO_TZ_TSASUM-OSEL-NYINGTHIG-P12:28	dang po la'ang /	2	dang po la 
BO_TZ_TSASUM-OSEL-NYINGTHIG-P12:29	mtshhan don / rgyu gleng gzhi /	2	mtshhan don rgyu gleng gzhi 
BO_TZ_TSASUM-OSEL-NYINGTHIG-P12:30	rkyen gleng bslang /	3	rkyen gleng bslang 
BO_TZ_TSASUM-OSEL-NYINGTHIG-P12:31	'bras bu rgyud don dngos /	3	bras bu brgyud don dngos 
BO_TZ_TSASUM-OSEL-NYINGTHIG-P12:32	mthar gtad rgya dang bcas lnga las /	3	mthar gtod rgya dang cha lnga las 
BO_TZ_TSASUM-OSEL-NYINGTHIG-P12:33	dang po rgya bod kyi mtshhan gyi don ni /	3	dang po rgya bod kyi mtshhan gyi don ni 
BO_TZ_TSASUM-OSEL-NYINGTHIG-P12:34	rgya gar skad du :	3	rgya gar skad du 
BO_TZ_TSASUM-OSEL-NYINGTHIG-P12:35	shri dz+nya na sogs nas /	3	shri dz+nya na sogs nas 
BO_TZ_TSASUM-OSEL-NYINGTHIG-P12:36	ces bya ba :	3	ces byed ba 
BO_TZ_TSASUM-OSEL-NYINGTHIG-P12:37	zhes pa ste /	3	zhes ba ste 
BO_TZ_TSASUM-OSEL-NYINGTHIG-P12:38	rang rgyud du nyes pa'i skyon thams cad zad /	3	rang brgyud du nyes ba skyon thams cad zad 
BO_TZ_TSASUM-OSEL-NYINGTHIG-P12:39	yon tan gyi 'byor pa mthar phyin pa'i phrin las kyis sems can gyi don rtag khyab lhun grub tu mdzad pas don gnyis mthar phyin pa'i phun sum tshhogs pa'i dpal dang ldan pa ni sangs rgyas te /	3	yon tan gyi byor ba mthar phyin ba phrin las kyis sems can gyi don rtag khyab lhun grub tu mdzad ba don gnyis mthar phyin ba phun sum tshhogs ba dpal dang ldan ba ni sangs rgya te 
BO_TZ_TSASUM-OSEL-NYINGTHIG-P12:40	de la mnga' ba'i bsam gyis mi khyab pa'i yon tan thams cad kyi snying po ni ye shes te /	4	de la mnga ba bsam gyis mi khyab ba yon tan thams cad kyi snying po ni ye shes te 
BO_TZ_TSASUM-OSEL-NYINGTHIG-P12:41	rdzogs pa chen po'i rgyud rang shar las /	4	rdzogs ba chen po brgyud rang char las 
BO_TZ_TSASUM-OSEL-NYINGTHIG-P12:42	tha dad rang bzhin 'gyur ba med //	4	tha dad rang bzhin gyur ba med 
BO_TZ_TSASUM-OSEL-NYINGTHIG-P12:43	de phyir sku lnga'i ye shes te //	4	de phyir sku lnga ye shes te 
BO_TZ_TSASUM-OSEL-NYINGTHIG-P12:44	sku dang ye shes 'du 'bral med //	4	sku dang ye shes du bral med 
BO_TZ_TSASUM-OSEL-NYINGTHIG-P12:45	don la de bzhin gnas pa 'o //	4	don la de bzhin gnas ba mang 
BO_TZ_TSASUM-OSEL-NYINGTHIG-P12:46	zhes dang / mu tig phreng ba las /	4	zhes dang mu tig phreng ba las 
BO_TZ_TSASUM-OSEL-NYINGTHIG-P12:47	sangs rgyas rnams kyi sku nyid ni //	4	sangs rgya rnams kyi sku nyid ni 
BO_TZ_TSASUM-OSEL-NYINGTHIG-P12:48	thugs kyi dkyil na ma bskyed rdzogs //	4	thugs kyi dkyil na ma skyed rdzogs 
BO_TZ_TSASUM-OSEL-NYINGTHIG-P12:49	'gyur ba med pa'i sku gcig ni //	4	gyur ba med ba sku gcig ni 
BO_TZ_TSASUM-OSEL-NYINGTHIG-P12:50	kun tu khyab pa'i tshhul du gnas //	5	kun tu khyab ba tshhul du gnas 
BO_TZ_TSASUM-OSEL-NYINGTHIG-P12:51	zhes sku yi snying po ye shes yin pas sku dang ye shes 'du 'bral med pa'i bdag nyid can te /	5	zhes sku yi snying po ye shes yin ba sku dang ye shes du bral med ba bdag nyid can te 
BO_TZ_TSASUM-OSEL-NYINGTHIG-P12:52	de la dbye na chos sku gzhir gnas kyi ye shes ngo bo rang bzhin thugs rje gsum ldan /	5	de la byed na chos sku gzhir gnas kyi ye shes ngo bo rang bzhin thugs rje gsum ldan 
BO_TZ_TSASUM-OSEL-NYINGTHIG-P12:53	longs sku mtshhan nyid 'dzin pa'i ye shes me long lta bu sogs lnga /	5	longs sku mtshhan nyid dzin ba ye shes me long lta bu sogs lnga 
BO_TZ_TSASUM-OSEL-NYINGTHIG-P12:54	sprul sku thugs rje kun khyab kyi ye shes mkhyen pa gnyis su 'byed /	5	sprul sku thugs rje kun khyab kyi ye shes mkhyen ba gnyis su byed 
BO_TZ_TSASUM-OSEL-NYINGTHIG-P12:55	drwa ba ni 'brel ba'i don te lam pa'i snang tshhul gyis /	5	drwa ba ni brel ba don te lam ba snang tshhul gyis 
BO_TZ_TSASUM-OSEL-NYINGTHIG-P12:56	ma dag pa /	5	ma dag ba 
BO_TZ_TSASUM-OSEL-NYINGTHIG-P12:57	dag ma dag 'dres ma /	5	dag ma dag dre ma 
BO_TZ_TSASUM-OSEL-NYINGTHIG-P12:58	shin tu dag pa'i tshhul gyis gzhi lam 'bras bu gsum du dbye yang ngo bo chos nyid bdag gcig gis 'brel zhing /	5	shin tu dag ba tshhul gyis gzhi lam bras bu gsum du byed yang ngo bo chos nyid bdag gcig gis brel zhing 
BO_TZ_TSASUM-OSEL-NYINGTHIG-P12:59	ye shes de dag kyang dbyings dang rig pa gnyis su med pa'i bdag nyid gcig tu gyur pa las /	5	ye shes de dag kyang dbyings dang rig ba gnyis su med ba bdag nyid gcig tu gyur ba las 
BO_TZ_TSASUM-OSEL-NYINGTHIG-P12:60	ngo bo nam yang mtshhan nyid tha dad ma dmigs pas mtshhon bya don gyi rgyud ces bya ba ste /	6	ngo bo nam yang mtshhan nyid tha dad ma dmigs ba mtshhon byed don gyi brgyud ces byed ba ste 
BO_TZ_TSASUM-OSEL-NYINGTHIG-P12:61	sangs rgyas kyi ye shes bsam mi khyab pa'i rol pa rtsha gsum zhi khro gang ltar bkod kyang 'di kho na'i cho 'phrul las byung zhing snang ba'i bdag nyid can ni don gyi gnas tshhul te /	6	sangs rgya kyi ye shes bsam mi khyab ba rol ba rtsha gsum zhi khro gang ltar bkod kyang di kho na cho phrul las byung zhing snang ba bdag nyid can ni don gyi gnas tshhul te 
BO_TZ_TSASUM-OSEL-NYINGTHIG-P12:62	de nyid gdul bya rnams la ston pa'i phyir tshhig dang yi ge'i rnam pa cir yang 'byung ba ni sgrar snang ba dang / sgrar grags pa dang / brdar gyur pa ni mtshhon byed tshhig gi rgyud de /	6	de nyid gdul byed rnams la ston ba phyir tshhig dang yi ge rnam ba cir yang byung ba ni sgrar snang ba dang sgrar grags ba dang rdar gyur ba ni mtshhon byed tshhig gi brgyud de 
BO_TZ_TSASUM-OSEL-NYINGTHIG-P12:63	brjod bya dang rjod byed thams cad ye shes rnam pa thams cad pa'i bdag nyid du shes par bya'o //	6	rjod byed dang rjod byed thams cad ye shes rnam ba thams cad ba bdag nyid du shes ba byed 
BO_TZ_TSASUM-OSEL-NYINGTHIG-P12:64	gnyis pa rgyud 'byung ba'i rgyu gleng gzhi la /	6	gnyis ba brgyud byung ba rgyu gleng gzhi la 
BO_TZ_TSASUM-OSEL-NYINGTHIG-P12:65	phyag gis mdor bstan pa /	6	phyag gis mdor ston ba 
BO_TZ_TSASUM-OSEL-NYINGTHIG-P12:66	gleng gzhi dngos so //	6	gleng gzhi dngos so 
BO_TZ_TSASUM-OSEL-NYINGTHIG-P12:67	dang po ni /	6	dang po ni 
BO_TZ_TSASUM-OSEL-NYINGTHIG-P12:68	bcom ldan 'das snang ba mtha' yas la phyag 'tshhal lo :	6	joms ldan da snang ba mtha yas la phyag tshhal lo 
BO_TZ_TSASUM-OSEL-NYINGTHIG-P12:69	zhes pa ste /	6	zhes ba ste 
BO_TZ_TSASUM-OSEL-NYINGTHIG-P12:70	de yang ting 'dzin rgyal po las /	7	de yang ting dzin rgyal po las 
BO_TZ_TSASUM-OSEL-NYINGTHIG-P12:71	dag pa dwangs ba 'od gsal ba //	7	dag ba dwangs ba d gsal ba 
BO_TZ_TSASUM-OSEL-NYINGTHIG-P12:72	mi 'khrugs 'dus ma byas pa nyid //	7	mi khrugs du ma byed ba nyid 
BO_TZ_TSASUM-OSEL-NYINGTHIG-P12:73	ces gsungs pa ltar /	7	ces gsungs ba ltar 
BO_TZ_TSASUM-OSEL-NYINGTHIG-P12:74	chos nyid lta ba'i gnas lugs don dam bden pa chos dbyings zab gsal gnyis su med pa ni 'khor 'das kun la khyab kyang /	7	chos nyid lta ba gnas lugs don dam bden ba chos dbyings zab gsal gnyis su med ba ni khor da kun la khyab kyang 
BO_TZ_TSASUM-OSEL-NYINGTHIG-P12:75	'khor 'das gang gi'ang phyogs su ma lhung zhing nyes pas ma gos pas shin tu rnam par dag pa'i bdag nyid can te /	7	khor da gang gi phyogs su ma lhung zhing nyes ba ma gos ba shin tu rnam ba dag ba bdag nyid can te 
BO_TZ_TSASUM-OSEL-NYINGTHIG-P12:76	ye shes de'i snang bas chos kyi dbyings kun la khyab cing zag pa med pa'i yon tan thams cad de yi rtshal las 'phro ba gang la /	7	ye shes de snang ba chos kyi dbyings kun la khyab cing zag ba med ba yon tan thams cad de yi rtshal las phro ba gang la 
BO_TZ_TSASUM-OSEL-NYINGTHIG-P12:77	chos can kun rdzob kyi bden pa shes bya'i chos thams cad ma 'dres yang dag par gzigs pa'i mkhyen pa la so sor rtogs pa'i ye shes gsung pad+ma'i rigs kyi khyab bdag gi tshhul du ston pa snang ba mtha' yas te /	7	chos can kun rdzob kyi bden ba shes byed chos thams cad ma dre yang dag ba gzigs ba mkhyen ba la so sor rtogs ba ye shes gsung pad+ma rigs kyi khyab bdag gi tshhul du ston ba snang ba mtha yas te 
BO_TZ_TSASUM-OSEL-NYINGTHIG-P12:78	de ni bdud bzhi bcom zhing legs pa'i yon tan drug dang ldan pa mtha' gnyis las 'das pa'i mya ngan las 'das pa chen po'i go 'phang mngon sum du brnyes pa'i ston pa /	7	de ni bdud bzhi joms zhing legs ba yon tan drug dang ldan ba mtha gnyis las da ba mya ngan las da ba chen po go phen mngon sum du brnyes ba ston ba 
BO_TZ_TSASUM-OSEL-NYINGTHIG-P12:79	sku dang ye shes kyi snang ba bsam mi khyab pa'i rdo rje'i gsung gi phrin las kyis chos kyi dbyings mtha' yas par spros te srid zhi'i phan bde'i dpal kun stshol ba'i byed po gang la /	7	sku dang ye shes kyi snang ba bsam mi khyab ba rdo rje gsung gi phrin las kyis chos kyi dbyings mtha yas ba spros te srid zhi phan bde dpal kun stshol ba byed po gang la 
BO_TZ_TSASUM-OSEL-NYINGTHIG-P12:80	ye shes rang snang gi 'khor dus chos gnas bcas nyid las mi gzhan pa'i bdag nyid du lhun gyis grub cing /	8	ye shes rang snang gi khor dus chos gnas cha nyid las mi gzhan ba bdag nyid du lhun gyis grub cing 
BO_TZ_TSASUM-OSEL-NYINGTHIG-P12:81	zab gsal gnyis su med pa'i chos kyi snang ba la 'du 'bral dang 'phel sgrib med par longs spyod pa'i phyir tshhul de'i gnas lugs la yid ches shing ngoms pas phyag 'tshhal bas rgyud kyi don mngon du byed nus pa'i phyir gleng gzhi'i mdor bstan yang zhar byung	8	zab gsal gnyis su med ba chos kyi snang ba la du bral dang phel sgrib med ba longs spyod ba phyir tshhul de gnas lugs la yid ches shing ngoms ba phyag tshhal ba brgyud kyi don mngon du byed nus ba phyir gleng gzhi mdor ston yang zhar byung 
BO_TZ_TSASUM-OSEL-NYINGTHIG-P12:82	du 'byung ba'o //	8	du byung ba 
BO_TZ_TSASUM-OSEL-NYINGTHIG-P12:83	gnyis pa gleng gzhi dngos ni /	8	gnyis ba gleng gzhi dngos ni 
BO_TZ_TSASUM-OSEL-NYINGTHIG-P12:84	'og min pad+ma drwa ba ru :	8	g min pad+ma drwa ba ru 
BO_TZ_TSASUM-OSEL-NYINGTHIG-P12:85	zhes pas phun sum tshhogs pa lnga las dang po gnas bstan pa ste /	8	zhes ba phun sum tshhogs ba lnga las dang po gnas ston ba ste 
BO_TZ_TSASUM-OSEL-NYINGTHIG-P12:86	'khor 'das kyi snang cha kun las 'das te bla ru 'phags pas 'og min /	8	khor da kyi snang cha kun las da te bla ru phag ba g min 
BO_TZ_TSASUM-OSEL-NYINGTHIG-P12:87	snod bcud tha mal gyi 'khrul rtog gi nyes pas gzhar yang ma gos shing rab 'byams dag pa'i zhing gi dpal dang ldan pas pad+ma /	8	snod bcud tha mal gyi khrul rtogs gi nyes ba gzhar yang ma gos shing rab byam dag ba zhing gi dpal dang ldan ba pad+ma 
BO_TZ_TSASUM-OSEL-NYINGTHIG-P12:88	chos dbyings de las ston 'khor thams cad snang zhing 'char bas drwa ba ste /	8	chos dbyings de las ston khor thams cad snang zhing char ba drwa ba ste 
BO_TZ_TSASUM-OSEL-NYINGTHIG-P12:89	gnas de nyid kyi ngang las nam yang 'pho 'gyur med par bzhugs pa ru /	8	gnas de nyid kyi ngang las nam yang pho gyur med ba bzhugs ba ru 
BO_TZ_TSASUM-OSEL-NYINGTHIG-P12:90	'od snang mtha' yas ston pa yis :	9	d snang mtha yas ston ba yis 
BO_TZ_TSASUM-OSEL-NYINGTHIG-P12:91	zhes pas ston pa ste 'od gsal bsam mi khyab pa'i snang ba mtha' yas pa 'phro ba'i ye shes de las sku gsung thugs yon tan phrin las zag pa med pa'i snang bas kun tu mdzes shing 'phel 'grib med par bzhugs pa gsung rdo rje rigs kun gyi	9	zhes ba ston ba ste d gsal bsam mi khyab ba snang ba mtha yas ba phro ba ye shes de las sku gsung thugs yon tan phrin las zag ba med ba snang ba kun tu mdzes shing phel grib med ba bzhugs ba gsung rdo rje rigs kun gyi 
BO_TZ_TSASUM-OSEL-NYINGTHIG-P12:92	khyab bdag tu gyur pa'i ston pa mchog de yis /	9	khyab bdag tu gyur ba ston ba mchog de yis 
BO_TZ_TSASUM-OSEL-NYINGTHIG-P12:93	lag na chu skyes la sogs pa'i :	9	lag na chu skye la sogs ba 
BO_TZ_TSASUM-OSEL-NYINGTHIG-P12:94	'khor la zhes 'khor te nyid las mi gzhan pa'i 'khor /	9	khor la zhes khor te nyid las mi gzhan ba khor 
BO_TZ_TSASUM-OSEL-NYINGTHIG-P12:95	thugs rje kun tu khyab pa'i ye shes kyi rang rtshal rig pa'i skyes bu gsung pad+ma'i rigs kyi rang rtags lag na chu skyes dkar po bsnams pa 'phags mchog 'jig rten dbang phyug gtsho bor gyur pa'i rigs lnga sems dpa' lcam dral /	9	thugs rje kun tu khyab ba ye shes kyi rang rtshal rig ba skye bu gsung pad+ma rigs kyi rang rtags lag na chu skye dkar po snom ba phag mchog jig rten dbang phyug gtsho bor gyur ba rigs lnga sems dpa lcam dral 
BO_TZ_TSASUM-OSEL-NYINGTHIG-P12:96	mthar byed bzhi la sogs pa mtha' yas pa'i dkyil 'khor snang ba chen po khyab par brdal bas bzhugs pa la /	9	mthar byed bzhi la sogs ba mtha yas ba dkyil khor snang ba chen po khyab ba rdal ba bzhugs ba la 
BO_TZ_TSASUM-OSEL-NYINGTHIG-P12:97	dus gsum dus med dus :	9	dus gsum dus med dus 
BO_TZ_TSASUM-OSEL-NYINGTHIG-P12:98	zhes dus te ston 'khor gyis khyab brdal ye shes kyi 'khor lo'i chos kyi snang ba la spyod pa yang dus res 'ga' tsham min pa dus gsum dus med kyi dus gnyis med mnyam pa chen po'i bdag nyid du nam yang 'du 'bral med par chos nyid zab	9	zhes dus te ston khor gyis khyab rdal ye shes kyi khor lo chos kyi snang ba la spyod ba yang dus res ga tsham min ba dus gsum dus med kyi dus gnyis med mnyam ba chen po bdag nyid du nam yang du bral med ba chos nyid zab 
BO_TZ_TSASUM-OSEL-NYINGTHIG-P12:99	gsal gyi dgongs pa la ldang 'jug med par bzhugs pa la /	9	gsal gyi dgongs ba la ldang jug med ba bzhugs ba la 
BO_TZ_TSASUM-OSEL-NYINGTHIG-P12:100	rdo rje gsang ba'i tshhig bstan tshhe :	10	rdo rje gsang ba tshhig ston tshhe 
BO_TZ_TSASUM-OSEL-NYINGTHIG-P12:101	zhes chos te ston 'khor gnyis su med pa'i chos kun gyi gnas lugs don gyi dgongs pa ni rtog ge dang phal pa'i blos mi phyed pas rdo rje /	10	zhes chos te ston khor gnyis su med ba chos kun gyi gnas lugs don gyi dgongs ba ni rtogs ge dang phal ba blos mi phyed ba rdo rje 
BO_TZ_TSASUM-OSEL-NYINGTHIG-P12:102	de dag gis sgra ji bzhin du rtogs shing ston mi nus pas gsang ba /	10	de dag gis sgra ji bzhin du rtogs shing ston mi nus ba gsang ba 
BO_TZ_TSASUM-OSEL-NYINGTHIG-P12:103	rgyal ba'i thugs rje thabs mkhas kyi rol pas dngos brgyud nas de rtogs par bya ba'i phyir brjod med brjod pa'i mchog tu snang ba'i tshhig gis bstan pa'i tshhe don la longs spyod de ston 'khor dgongs pa dbyer med kyis bzhugs pa ste /	10	rgyal ba thugs rje thabs mkhas kyi rol ba dngos brgyud nas de rtogs ba byed ba phyir rjod med rjod ba mchog tu snang ba tshhig gis ston ba tshhe don la longs spyod de ston khor dgongs ba dbyer med kyis bzhugs ba ste 
BO_TZ_TSASUM-OSEL-NYINGTHIG-P12:104	sangs rgyas nyag gcig gi spyod yul du gyur pa ste rgyud nyid 'byung ba'i gleng gzhi mthar thug pa'o //	10	sangs rgya nyag gcig gi spyod yul du gyur ba ste brgyud nyid byung ba gleng gzhi mthar thug ba 
BO_TZ_TSASUM-OSEL-NYINGTHIG-P12:105	gsum pa rkyen gleng bslang ba ni /	10	gsum ba rkyen gleng bslang ba ni 
BO_TZ_TSASUM-OSEL-NYINGTHIG-P12:106	pad+ma'i spyan gyis sogs nas /	10	pad+ma spyan gyis sogs nas 
BO_TZ_TSASUM-OSEL-NYINGTHIG-P12:107	'di skad gsung :	10	di skad gsung 
BO_TZ_TSASUM-OSEL-NYINGTHIG-P12:108	zhes pa ste skabs 'dir bstan bya'i gtsho bo gsung pad+ma'i rigs kyi sgyu 'phrul rtsha ba gsum gyi lha sngags ting 'dzin dbang dang sgrub thabs las tshhogs dam tshhig rnams bstan par bzhed nas /	10	zhes ba ste skabs dir ston byed gtsho bo gsung pad+ma rigs kyi sgyu phrul rtsha ba gsum gyi lha sngags ting dzin dbang dang sgrub thabs las tshhogs dam tshhig rnams ston ba bzhed nas 
BO_TZ_TSASUM-OSEL-NYINGTHIG-P12:109	nye ba'i 'khor mkha' khyab kyi sems can la brtshe chen ye shes kyi spyan ras nam yang zum pa med cing /	10	nye ba khor mkha khyab kyi sems can la brtshe chen ye shes kyi spyan ras nam yang zum ba med cing 
BO_TZ_TSASUM-OSEL-NYINGTHIG-P12:110	gdul dka' sdug bsngal can la thugs rjes lhag par dgongs pa'i rlan dang ma bral ba'i pad+ma 'dab ma rnam par rgyas pa'i spyan can 'phags pa thugs rje'i dbang phyug gis /	11	gdul dka sdug sngal can la thugs rjes lhag ba dgongs ba rlan dang ma bral ba pad+ma dab ma rnam ba rgya ba spyan can phag ba thugs rje dbang phyug gis 
BO_TZ_TSASUM-OSEL-NYINGTHIG-P12:111	slar yang gsol pa /	11	slar yang gsol ba 
BO_TZ_TSASUM-OSEL-NYINGTHIG-P12:112	e ma zhes ngo mtshhar chen po nges pa don gyi rgyud snying po'i don zab mo'i gnad du bsdu na ji ltar lags zhes bskul ba'i tshhul gleng bslang te gsol bas /	11	e ma zhes ngo mtshhar chen po nges ba don gyi brgyud snying po don zab mo gnad du sdud na ji ltar lags zhes skul ba tshhul gleng bslang te gsol ba 
BO_TZ_TSASUM-OSEL-NYINGTHIG-P12:113	dkyil 'khor gyi gtsho bo ston pa 'od dpag tu med pa'i mgon po yis ye shes kyi dgongs pa'i don gdul bya gzhan rgyud kyis rtogs shing grol bas rang nyid kyi go 'phang la 'god pa'i thabs su /	11	dkyil khor gyi gtsho bo ston ba d dpog tu med ba mgon po yis ye shes kyi dgongs ba don gdul byed gzhan brgyud kyis rtogs shing grol ba rang nyid kyi go phen la god ba thabs su 
BO_TZ_TSASUM-OSEL-NYINGTHIG-P12:114	chos nyid bsam gyis mi khyab pa'i don gsung sgra tshhig tshhangs pa'i dbyangs rnam pa thams cad pa'i bdag nyid can gyi rang sgras 'di skad gsungs so //	11	chos nyid bsam gyis mi khyab ba don gsung sgra tshhig tshhangs ba dbyangs rnam ba thams cad ba bdag nyid can gyi rang sgras di skad gsungs so 
BO_TZ_TSASUM-OSEL-NYINGTHIG-P12:115	bzhi pa 'bras bu rgyud don dngos la /	11	bzhi ba bras bu brgyud don dngos la 
BO_TZ_TSASUM-OSEL-NYINGTHIG-P12:116	rtogs bya gzhi yi rgyud /	11	rtogs byed gzhi yi brgyud 
BO_TZ_TSASUM-OSEL-NYINGTHIG-P12:117	rtogs byed lam gyi rgyud /	11	rtogs byed lam gyi brgyud 
BO_TZ_TSASUM-OSEL-NYINGTHIG-P12:118	rtogs tshhad mthar phyin pa 'bras bu'i rgyud gsum mo //	11	rtogs tshhad mthar phyin ba bras bu brgyud gsum mo 
BO_TZ_TSASUM-OSEL-NYINGTHIG-P12:119	dang po rtogs bya gzhi yi rgyud bshad pa ni /	11	dang po rtogs byed gzhi yi brgyud chad ba ni 
BO_TZ_TSASUM-OSEL-NYINGTHIG-P12:120	gzhi dbyings ka nas dag sogs nas /	12	gzhi dbyings ka nas dag sogs nas 
BO_TZ_TSASUM-OSEL-NYINGTHIG-P12:121	'khor bar 'khyams :	12	khor ba khyam 
BO_TZ_TSASUM-OSEL-NYINGTHIG-P12:122	zhes pa ste spyir sangs rgyas dang sems can gnyis gzhi dbyings ka nas dag pa'i chos nyid kyi klong na bzang ngan gnyis su med par gzung 'dzin 'khrul pa las 'das ye sangs rgyas pa ste /	12	zhes ba ste spyir sangs rgya dang sems can gnyis gzhi dbyings ka nas dag ba chos nyid kyi klong na bzang ngan gnyis su med ba gzung dzin khrul ba las da ye sangs rgya ba ste 
BO_TZ_TSASUM-OSEL-NYINGTHIG-P12:123	de'i rgyu mtshhan snang srid 'khor 'das kyi chos sogs rnam dbye ye nas ma dmigs pa'i gzhi ka dag chen po'i ngo bo la bzang ngan dang spros pa'i mtshhan ma gzhar yang ma dmigs pa'i chos kyi dbyings rnam kun mchog ldan gyi bdag nyid las /	12	de rgyu mtshhan snang srid khor da kyi chos sogs rnam byed ye nas ma dmigs ba gzhi ka dag chen po ngo bo la bzang ngan dang spros ba mtshhan ma gzhar yang ma dmigs ba chos kyi dbyings rnam kun mchog ldan gyi bdag nyid las 
BO_TZ_TSASUM-OSEL-NYINGTHIG-P12:124	gzhi snang thugs rje'i ye shes rig pa'i rang rtshal 'od gsal lhun grub kyi snang cha phyir gsal du 'char ba'i tshhul la /	12	gzhi snang thugs rje ye shes rig ba rang rtshal d gsal lhun grub kyi snang cha phyir gsal du char ba tshhul la 
BO_TZ_TSASUM-OSEL-NYINGTHIG-P12:125	thog ma'i mgon po kun tu bzang pos rig pa'i rang snang du rtogs te gzhi snang ye shes su shar bas sangs rgyas /	12	thogs ma mgon po kun tu bzang pos rig ba rang snang du rtogs te gzhi snang ye shes su char ba sangs rgya 
BO_TZ_TSASUM-OSEL-NYINGTHIG-P12:126	khams gsum gyi sems can rnams rang snang du ma shes par gzung 'dzin gnyis 'dzin du zhen pa'i dbang gis 'khrul te 'khor bar 'khyams nas gnas don lus su bag chags la spyod pas /	12	khams gsum gyi sems can rnams rang snang du ma shes ba gzung dzin gnyis dzin du zhen ba dbang gis khrul te khor ba khyam nas gnas don lus su bag chags la spyod ba 
BO_TZ_TSASUM-OSEL-NYINGTHIG-P12:127	gzhi chos nyid gcig las gzhi snang grol 'khrul gyi lam gnyis su byung ba'o //	12	gzhi chos nyid gcig las gzhi snang grol khrul gyi lam gnyis su byung ba 
BO_TZ_TSASUM-OSEL-NYINGTHIG-P12:128	gnyis pa rtogs byed lam gyi rgyud ni /	12	gnyis ba rtogs byed lam gyi brgyud ni 
BO_TZ_TSASUM-OSEL-NYINGTHIG-P12:129	de slad smin zhing sbyang ba'i sogs nas /	12	de slad smin zhing sbyong ba sogs nas 
BO_TZ_TSASUM-OSEL-NYINGTHIG-P12:130	don gnyis spyod :	13	don gnyis spyod 
BO_TZ_TSASUM-OSEL-NYINGTHIG-P12:131	ces pa ste sems can gyi ma dag 'khrul pa'i snang ba shar yang gzhi ngo bo'i gshis la sgrib pas ma gos pa'i gnad kyis /	13	ces ba ste sems can gyi ma dag khrul ba snang ba char yang gzhi ngo bo gshis la sgrib ba ma gos ba gnad kyis 
BO_TZ_TSASUM-OSEL-NYINGTHIG-P12:132	gnas lugs gzhi yi bzhugs tshhul dang dag pa ye shes kyi snang ba mthun pa lam du byas pas gzung 'dzin 'khrul pa'i snang ba glo bur pa yin pa'i gnad kyis sgrib pa'i dri ma dag nus pa'i phyir de'i gnyen po'i slad du rgyud dag par smin zhing	13	gnas lugs gzhi yi bzhugs tshhul dang dag ba ye shes kyi snang ba mthun ba lam du byed ba gzung dzin khrul ba snang ba glo bur ba yin ba gnad kyis sgrib ba dri ma dag nus ba phyir de gnyen po slad du brgyud dag ba smin zhing 
BO_TZ_TSASUM-OSEL-NYINGTHIG-P12:133	ma dag pa sbyong ba'i phyir lam byung ba ste /	13	ma dag ba sbyong ba phyir lam byung ba ste 
BO_TZ_TSASUM-OSEL-NYINGTHIG-P12:134	lam thams cad kyi rtshe mo gsang sngags rdo rje theg pa rnal 'byor bla med kyi 'jug sgo dbang bskur nges pa'i lam la 'jug pa dbang bzhi yan lag dang bcas pa la /	13	lam thams cad kyi rtshe mo gsang sngags rdo rje theg ba rnal byor bla med kyi jug sgo dbang skur nges ba lam la jug ba dbang bzhi yan lag dang cha ba la 
BO_TZ_TSASUM-OSEL-NYINGTHIG-P12:135	rtsha ba'i smin byed ye shes thig le /	13	rtsha ba smin byed ye shes thig le 
BO_TZ_TSASUM-OSEL-NYINGTHIG-P12:136	phyi sgrub kyi lha dbang ye shes char 'beb /	13	phyi sgrub kyi lha dbang ye shes char beb 
BO_TZ_TSASUM-OSEL-NYINGTHIG-P12:137	dbang bzhi ye shes dpal ster /	13	dbang bzhi ye shes dpal ster 
BO_TZ_TSASUM-OSEL-NYINGTHIG-P12:138	byin rlabs brda yi dbang bzhi /	13	byin rlabs brda yi dbang bzhi 
BO_TZ_TSASUM-OSEL-NYINGTHIG-P12:139	gtor dbang byin rlabs dpal ster /	13	thor dbang byin rlabs dpal ster 
BO_TZ_TSASUM-OSEL-NYINGTHIG-P12:140	tshhe sgrub 'chi med drwa ba /	14	tshhe sgrub chi med drwa ba 
BO_TZ_TSASUM-OSEL-NYINGTHIG-P12:141	thod phreng rigs lnga /	14	thod phreng rigs lnga 
BO_TZ_TSASUM-OSEL-NYINGTHIG-P12:142	gshin rje / rta mgrin /	14	gshin rje rta mgrin 
BO_TZ_TSASUM-OSEL-NYINGTHIG-P12:143	rnam 'joms / yang dag	14	rnam joms yang dag 
BO_TZ_TSASUM-OSEL-NYINGTHIG-P12:144	/phur pa / phag mo dkar mo /	14	ba phag mo dkar mo 
BO_TZ_TSASUM-OSEL-NYINGTHIG-P12:145	de'i tshhe dbang bcas so so'i smin byed bzhugs pa dang / dbang srog rgyud la 'dzin pa 'da' bar dka' ba'i sa ma ya'i dam tshhig rtsha ba yan lag srog bzhin bsrung ba /	14	de tshhe dbang cha so so smin byed bzhugs ba dang dbang srog brgyud la dzin ba da ba dka ba sa ma ya dam tshhig rtsha ba yan lag srog bzhin bsrung ba 
BO_TZ_TSASUM-OSEL-NYINGTHIG-P12:146	dbang gis smin zin grol ba'i thabs phyi sgrub sgyu 'phrul drwa ba bla ma sprul sku pad+ma thod phreng rtshal tshhe sgrub bcas dang / tshhe sgrub 'chi med drwa ba /	14	dbang gis smin zin grol ba thabs phyi sgrub sgyu phrul drwa ba bla ma sprul sku pad+ma thod phreng rtshal tshhe sgrub cha dang tshhe sgrub chi med drwa ba 
BO_TZ_TSASUM-OSEL-NYINGTHIG-P12:147	nang sgrub pad+ma drwa ba longs sku 'phags mchog snying rje'i lha thugs rje chen po /	14	nang sgrub pad+ma drwa ba longs sku phag mchog snying rje lha thugs rje chen po 
BO_TZ_TSASUM-OSEL-NYINGTHIG-P12:148	gsang sgrub 'od gsal drwa ba chos sku skye med snang ba mtha' yas 'od dpag med /	14	gsang sgrub d gsal drwa ba chos sku skye med snang ba mtha yas d dpog med 
BO_TZ_TSASUM-OSEL-NYINGTHIG-P12:149	yang gsang bla ma drag po dmar chen yi dam dgongs 'dus /	14	yang gsang bla ma drag po dmar chen yi dam dgongs du 
BO_TZ_TSASUM-OSEL-NYINGTHIG-P12:150	phyi sgrub las 'phros pa gu ru thod phreng sde lnga'i las bzhi mchog gi sgrub thabs las tshhogs /	15	phyi sgrub las phro ba gu ru thod phreng sde lnga las bzhi mchog gi sgrub thabs las tshhogs 
BO_TZ_TSASUM-OSEL-NYINGTHIG-P12:151	'jam dpal gshin rje /	15	jam dpal gshin rje 
BO_TZ_TSASUM-OSEL-NYINGTHIG-P12:152	dbang chen rta tshhe /	15	dbang chen rta tshhe 
BO_TZ_TSASUM-OSEL-NYINGTHIG-P12:153	rdo rje rnam 'joms /	15	rdo rje rnam joms 
BO_TZ_TSASUM-OSEL-NYINGTHIG-P12:154	yang dag /phur pa /	15	yang dag ba 
BO_TZ_TSASUM-OSEL-NYINGTHIG-P12:155	phag mo dkar mo dang tshhe sgrub /	15	phag mo dkar mo dang tshhe sgrub 
BO_TZ_TSASUM-OSEL-NYINGTHIG-P12:156	bka' srung gi sgrub thabs bcas /	15	bka srung gi sgrub thabs cha 
BO_TZ_TSASUM-OSEL-NYINGTHIG-P12:157	rang rang gi bskyed rdzogs zung 'jug gi tshhul du sgrub pa'i lam la brtshon pas bde stong 'od gsal dbyings rig zung 'jug gi don thig le nyag gcig gi sbubs su 'jug nas mchog dang thun mong gi dngos grub la spyod pa'i rig 'dzin bzhi'i sa lam bgrod	15	rang rang gi skyed rdzogs zung jug gi tshhul du sgrub ba lam la brtshon ba bde stong d gsal dbyings rig zung jug gi don thig le nyag gcig gi sbub su jug nas mchog dang thun mong gi dngos grub la spyod ba rig dzin bzhi sa lam bgrod 
BO_TZ_TSASUM-OSEL-NYINGTHIG-P12:158	pas gnas skabs dang mthar thug gi don gnyis mthar phyin pa la spyod par 'gyur ro //	15	ba gnas skabs dang mthar thug gi don gnyis mthar phyin ba la spyod ba gyur ro 
BO_TZ_TSASUM-OSEL-NYINGTHIG-P12:159	gsum pa rtogs tshhad mthar phyin 'bras bu'i rgyud ni /	15	gsum ba rtogs tshhad mthar phyin bras bu brgyud ni 
BO_TZ_TSASUM-OSEL-NYINGTHIG-P12:160	gzhi la lam gyis sogs nas /	16	gzhi la lam gyis sogs nas 
BO_TZ_TSASUM-OSEL-NYINGTHIG-P12:161	thugs rjer smin :	16	thugs rjer smin 
BO_TZ_TSASUM-OSEL-NYINGTHIG-P12:162	zhes pa ste gzhi'i gnas snang dang mthun pa'i lam gyi tshhul la sgra ji bzhin du slob pas mtshhams sbyar bas /	16	zhes ba ste gzhi gnas snang dang mthun ba lam gyi tshhul la sgra ji bzhin du slob ba mtshhams sbyor ba 
BO_TZ_TSASUM-OSEL-NYINGTHIG-P12:163	'khrul snang gi sgrib pa dag ste 'bras bu sku bzhi dbyer med kyi yon tan gzhi'i chos nyid la gdod nas bzhugs pa mngon gyur du sad nas /	16	khrul snang gi sgrib ba dag ste bras bu sku bzhi dbyer med kyi yon tan gzhi chos nyid la gdod nas bzhugs ba mngon gyur du sad nas 
BO_TZ_TSASUM-OSEL-NYINGTHIG-P12:164	zag med 'bras chos nyer lnga'i ye shes dang phrin las kyi snang ba bsam gyis mi khyab pa /	16	zag med bras chos nyer lnga ye shes dang phrin las kyi snang ba bsam gyis mi khyab ba 
BO_TZ_TSASUM-OSEL-NYINGTHIG-P12:165	rtag khyab lhun gyis grub pa ngo bo rang bzhin thugs rjer smin nas mtha' gnyis la mi gnas pa'i lhun grub chen po'i don la spyod nus pa'o //	16	rtag khyab lhun gyis grub ba ngo bo rang bzhin thugs rjer smin nas mtha gnyis la mi gnas ba lhun grub chen po don la spyod nus ba 
BO_TZ_TSASUM-OSEL-NYINGTHIG-P12:166	lnga pa mtha' rten gtad rgya dang bcas pa ni /	16	lnga ba mtha rten gtod rgya dang cha ba ni 
BO_TZ_TSASUM-OSEL-NYINGTHIG-P12:167	de skad ston pa kun bzang sogs nas /	16	de skad ston ba kun bzang sogs nas 
BO_TZ_TSASUM-OSEL-NYINGTHIG-P12:168	bdag la gdams :	16	bdag la doms 
BO_TZ_TSASUM-OSEL-NYINGTHIG-P12:169	rgya rgya rgya :	16	rgya rgya rgya 
BO_TZ_TSASUM-OSEL-NYINGTHIG-P12:170	brda thim : zhes pa ste tshhul 'di gal gnad che bar gdams pa ste rdo rje'i rgyud kyi dngos don gzhi lam 'bras bu'i rnam gzhag de skad khyab bdag ston pa kun bzang gis sngon byung dang ma 'ongs 'byung 'gyur gyi lam zab mo'i skal pa'i snod dang ldan pa la	17	brda thim zhes ba ste tshhul di gal gnad che ba doms ba ste rdo rje brgyud kyi dngos don gzhi lam bras bu rnam jog de skad khyab bdag ston ba kun bzang gis sngon byung dang ma ngs byung gyur gyi lam zab mo skal ba snod dang ldan ba la 
BO_TZ_TSASUM-OSEL-NYINGTHIG-P12:171	/ rgyal ba kun gyi gsung gi gsang ba'i snying po'i bcud 'di gdams pas /	17	rgyal ba kun gyi gsung gi gsang ba snying po bcud di doms ba 
BO_TZ_TSASUM-OSEL-NYINGTHIG-P12:172	tshhul bzhin nyams su len pa thams cad go 'phang mthar thug chos sku'i ye shes thig le nyag gcig tu mngon par byang chub cing smin par 'gyur ro //	17	tshhul bzhin nyams su len ba thams cad go phen mthar thug chos sku ye shes thig le nyag gcig tu mngon ba byang chub cing smin ba gyur ro 
BO_TZ_TSASUM-OSEL-NYINGTHIG-P12:173	sa ma ya :	17	sa ma ya 
BO_TZ_TSASUM-OSEL-NYINGTHIG-P12:174	de nas gtad rgya ni /	17	de nas gtod rgya ni 
BO_TZ_TSASUM-OSEL-NYINGTHIG-P12:175	gzhi lam 'bras gsum gyis bsdus pa'i chos nyid kyi don rjes su mtshhon pa'i rdo rje'i gnas 'di ni dus gsum rgyal ba kun gyi dgongs pa /	17	gzhi lam bras gsum gyis sdud ba chos nyid kyi don rjes su mtshhon ba rdo rje gnas di ni dus gsum rgyal ba kun gyi dgongs ba 
BO_TZ_TSASUM-OSEL-NYINGTHIG-P12:176	chos phung brgyad khris gtan la dbab bya'i nges don snying po /	17	chos phung brgyad khris gtan la bebs byed nges don snying po 
BO_TZ_TSASUM-OSEL-NYINGTHIG-P12:177	gab sbas kyi gsang ba zab mo'i rgyas btab pa'i ston pa rdo rje rgyal po'i dgongs pa mthar thug 'di'i don tshhul bzhin rtogs na ston 'khor tshhom bu gcig tu smin par gdon mi za bas /	17	gab sbed kyi gsang ba zab mo rgya debs ba ston ba rdo rje rgyal po dgongs ba mthar thug di don tshhul bzhin rtogs na ston khor tshhom bu gcig tu smin ba don mi za ba 
BO_TZ_TSASUM-OSEL-NYINGTHIG-P12:178	bskyed pa ma ha/	17	skyed ba ma 
BO_TZ_TSASUM-OSEL-NYINGTHIG-P12:179	rdzogs pa a nu /	17	rdzogs ba a nu 
BO_TZ_TSASUM-OSEL-NYINGTHIG-P12:180	zung 'jug a ti yo ga gsum gyi rdo rje'i tan+t+ra ni 'bum phrag kun gyi yang bcud snying po'i mthar thug 'di'i snyigs ma'i gdul bya rnams la 'dul byed thabs kyi gsang ba mchog tu 'gyur bar gzigs nas /	18	zung jug a ti yo ga gsum gyi rdo rje tan+t+ra ni bum phrag kun gyi yang bcud snying po mthar thug di snyigs ma gdul byed rnams la dul byed thabs kyi gsang ba mchog tu gyur ba gzigs nas 
BO_TZ_TSASUM-OSEL-NYINGTHIG-P12:181	gsung rdo rje snang ba mtha' yas pa'i rig rtshal 'phags mchog spyan ras gzigs kyis bde stong gnyis med ye shes rdo rje'i thol byung gi snying rje'i glu yi tshhul gyi nyid las mi gzhan pa'i pad+ma thod phreng rtshal bdag la gdams pa ste /	18	gsung rdo rje snang ba mtha yas ba rig rtshal phag mchog spyan ras gzigs kyis bde stong gnyis med ye shes rdo rje thol byung gi snying rje glu yi tshhul gyi nyid las mi gzhan ba pad+ma thod phreng rtshal bdag la doms ba ste 
BO_TZ_TSASUM-OSEL-NYINGTHIG-P12:182	snang ngor na rnam pa sku gsum sgyu 'phrul drwa ba'i tshhul du bstan kyang ngo bo dgongs klong ye shes kyi dbyings gcig pa'i bdag nyid du shes par bya'o //	18	snang ngor na rnam ba sku gsum sgyu phrul drwa ba tshhul du ston kyang ngo bo dgongs klong ye shes kyi dbyings gcig ba bdag nyid du shes ba byed 
BO_TZ_TSASUM-OSEL-NYINGTHIG-P12:183	spyir rdo rje'i rgyud kyi gnas 'di zhib tu dbye na zab rgyas ngo mtshhar che ba bzhugs kyang dgongs don gsal byed mdor bsdus tsham las deng sang dpyod ldan chos la don gnyer can shin tu dkon pas yi ge'i phung po brtshegs pa'i ngal ba ma byas so	18	spyir rdo rje brgyud kyi gnas di zhib tu byed na zab rgya ngo mtshhar che ba bzhugs kyang dgongs don gsal byed mdor sdud tsham las deng sang dpyod ldan chos la don gnyer can shin tu dkon(d) ba yi ge phung po brtshegs ba ngal ba ma byed so 
BO_TZ_TSASUM-OSEL-NYINGTHIG-P12:184	// ! //gnyis pa rtsha gsum sgrub thabs lung gi dum bus bsgrub bya'i rnam pa rtsha gsum de dag spyir kun 'dus nor bu lugs su sgrub tshhul bye brag tu bshad pa la gsum /	18	ba rtsha gsum sgrub thabs lung gi dum bud sgrub byed rnam ba rtsha gsum de dag spyir kun du nor bu lugs su sgrub tshhul bye brag tu chad ba la gsum 
BO_TZ_TSASUM-OSEL-NYINGTHIG-P12:185	lo rgyus brjod pa /	18	lo rgyus rjod ba 
BO_TZ_TSASUM-OSEL-NYINGTHIG-P12:186	lung gi don dngos /	18	lung gi don dngos 
BO_TZ_TSASUM-OSEL-NYINGTHIG-P12:187	phan yon bstan pa'o //	18	phan yon ston ba 
BO_TZ_TSASUM-OSEL-NYINGTHIG-P12:188	dang po la'ang /	18	dang po la 
BO_TZ_TSASUM-OSEL-NYINGTHIG-P12:189	mtshhan dang / mchod brjod /	18	mtshhan dang mchod rjod 
BO_TZ_TSASUM-OSEL-NYINGTHIG-P12:190	lo rgyus dngos dang gsum las /	19	lo rgyus dngos dang gsum las 
BO_TZ_TSASUM-OSEL-NYINGTHIG-P12:191	dang po ni /	19	dang po ni 
BO_TZ_TSASUM-OSEL-NYINGTHIG-P12:192	rtsha gsum 'od gsal snying tig las :	19	rtsha gsum d gsal snying tig las 
BO_TZ_TSASUM-OSEL-NYINGTHIG-P12:193	rtsha gsum sgrub thabs lung gi dum bu bzhugs :	19	rtsha gsum sgrub thabs lung gi dum bu bzhugs 
BO_TZ_TSASUM-OSEL-NYINGTHIG-P12:194	zhes pa ste /	19	zhes ba ste 
BO_TZ_TSASUM-OSEL-NYINGTHIG-P12:195	gong du bsgrub gzhi gzhi lam 'bras bu bstan pa'i rgyud kyi dgongs don mngon du bya ba'i thabs /	19	gong du sgrub gzhi gzhi lam bras bu ston ba brgyud kyi dgongs don mngon du byed ba thabs 
BO_TZ_TSASUM-OSEL-NYINGTHIG-P12:196	bsgrub bya rtsha ba gsum gyi lha tshhogs /	19	sgrub byed rtsha ba gsum gyi lha tshhogs 
BO_TZ_TSASUM-OSEL-NYINGTHIG-P12:197	sgrub byed kyi thabs sam gnad rgyud las btus pa lung gi dum bu bzhugs /	19	sgrub byed kyi thabs sam gnad brgyud las thu ba lung gi dum bu bzhugs 
BO_TZ_TSASUM-OSEL-NYINGTHIG-P12:198	gnyis pa mchod brjod ni /	19	gnyis ba mchod rjod ni 
BO_TZ_TSASUM-OSEL-NYINGTHIG-P12:199	'phags mchog snying rje'i lha la 'dud :	19	phag mchog snying rje lha la dud 
BO_TZ_TSASUM-OSEL-NYINGTHIG-P12:200	ces pa ste sangs rgyas rnams kyi chos nyid skye med kyi dgongs pa'i rang gshis mkha' khyab gdul bya'i yul la 'bad med du 'jug pa'i dmigs med thugs rje chen po'i ye shes ni nges pa don gyi 'phags mchog snying rje chen po ste /	20	ces ba ste sangs rgya rnams kyi chos nyid skye med kyi dgongs ba rang gshis mkha khyab gdul byed yul la bad med du jug ba dmigs med thugs rje chen po ye shes ni nges ba don gyi phag mchog snying rje chen po ste 
BO_TZ_TSASUM-OSEL-NYINGTHIG-P12:201	de ni gsang sngags kyi rgyud sde bzhi ka nas gsung pad+ma'i rigs kyi khyab bdag bde ba chen po gar gyi dbang phyug ces grags pa gang /	20	de ni gsang sngags kyi brgyud sde bzhi ka nas gsung pad+ma rigs kyi khyab bdag bde ba chen po gar gyi dbang phyug ces grags ba gang 
BO_TZ_TSASUM-OSEL-NYINGTHIG-P12:202	don la chos sku gdod ma'i mgon po 'od snang mtha' yas nyid phyir gsal sku dang zhing gi sgron me bkod pa'i tshhe /	20	don la chos sku gdod ma mgon po d snang mtha yas nyid phyir gsal sku dang zhing gi sgron me bkod ba tshhe 
BO_TZ_TSASUM-OSEL-NYINGTHIG-P12:203	rang snang longs sku'i ston pa rnam snang gangs chen mtshho'i sku dang zhing gi bkod pa bsam gyis mi khyab pas tshhangs pa rnga sgra rdo rje snying po'i bkod pa ston pa po dang tha mi dad pa'i lha la phyag gis btud de sprul gzhi ngos gzung ba'o	20	rang snang longs sku ston ba rnam snang gangs chen mtshho sku dang zhing gi bkod ba bsam gyis mi khyab ba tshhangs ba rnga sgra rdo rje snying po bkod ba ston ba po dang tha mi dad ba lha la phyag gis dud de sprul gzhi ngos gzung ba 
BO_TZ_TSASUM-OSEL-NYINGTHIG-P12:204	// gsum pa lo rgyus dngos ni /	20	gsum ba lo rgyus dngos ni 
BO_TZ_TSASUM-OSEL-NYINGTHIG-P12:205	bkra shis rang byung brag gi phug :sogs nas /	20	bkra shis rang byung brag gi bugs :sogs nas 
BO_TZ_TSASUM-OSEL-NYINGTHIG-P12:206	tshhig 'di bstan :	20	tshhig di ston 
BO_TZ_TSASUM-OSEL-NYINGTHIG-P12:207	sa ma ya :	20	sa ma ya 
BO_TZ_TSASUM-OSEL-NYINGTHIG-P12:208	zhes pa ste spyir rgyud kyi gleng gzhir gsal ba bzhin sangs rgyas rnams kyi ye shes rang snang gi ston pas chos kyi snang ba rgyun mi chad par dus bzhi mnyam pa nyid du spyod pa la tshhad gzung ma mchis kyang /	20	zhes ba ste spyir brgyud kyi gleng gzhir gsal ba bzhin sangs rgya rnams kyi ye shes rang snang gi ston ba chos kyi snang ba rgyun mi chad ba dus bzhi mnyam ba nyid du spyod ba la tshhad gzung ma mchis kyang 
BO_TZ_TSASUM-OSEL-NYINGTHIG-P12:209	phyogs re'i gdul bya re re'i don yang rgya che rgyun mi chad pa 'byung ba'i tshhul dmigs med ye shes kyi dgongs pas gzigs te 'gro ba 'dul ba'i skabs su babs pa na /	20	phyogs re gdul byed re re don yang rgya che rgyun mi chad ba byung ba tshhul dmigs med ye shes kyi dgongs ba gzigs te gro ba dul ba skabs su bab ba na 
BO_TZ_TSASUM-OSEL-NYINGTHIG-P12:210	chos sku 'od mtshhan stong 'bar dang longs sku 'gro 'dul 'phags mchog gnyis su med pa'i ye shes kyi rang gzugs sprul sku pad+ma thod phreng rtshal dang lha lcam man+da rahba gnyis kyis /	21	chos sku d mtshhan stong bar dang longs sku gro dul phag mchog gnyis su med ba ye shes kyi rang gzugs sprul sku pad+ma thod phreng rtshal dang lha lcam man+da rahba gnyis kyis 
BO_TZ_TSASUM-OSEL-NYINGTHIG-P12:211	rgya gar shar phyogs bkra shis rang byung brag gi phug ma ra ti ka'i gzhal yas su 'chi med tshhe yi rig 'dzin sgrub pa'i tshhe pad+ma drwa ba mgon po tshhe dpag med yab yum gyis dngos su byon nas o rgyan bdag la dbang bskur cing /	21	rgya gar char phyogs bkra shis rang byung brag gi bugs ma ra ti ka jal yas su chi med tshhe yi rig dzin sgrub ba tshhe pad+ma drwa ba mgon po tshhe dpog med yab yum gyis dngos su byon nas o rgyan bdag la dbang skur cing 
BO_TZ_TSASUM-OSEL-NYINGTHIG-P12:212	tshhe rgyud bye ba phrag brgya bstan te ston 'khor dgongs pa dbyer med du byin gyis brlabs par gyur nas nam mkha' ji srid bar rdo rje'i sku des 'gro ba'i don mdzad pa'i ngo mtshhar mngon du gyur pa'i tshhe rdo rje gsang ba'i tshhig 'di yang gdul bya	21	tshhe brgyud bye ba phrag brgya ston te ston khor dgongs ba dbyer med du byin gyis brlabs ba gyur nas nam mkha ji srid ba rdo rje sku des gro ba don mdzad ba ngo mtshhar mngon du gyur ba tshhe rdo rje gsang ba tshhig di yang gdul byed 
BO_TZ_TSASUM-OSEL-NYINGTHIG-P12:213	thun mong rnams 'dul ba'i phyir /	21	thun mong rnams dul ba phyir 
BO_TZ_TSASUM-OSEL-NYINGTHIG-P12:214	rtsha gsum 'od gsal snying tig gi zab rgyas rmad du byung ba'i rgyud kyi dgongs don lung gi tshhul 'di bstan par gyur to //	21	rtsha gsum d gsal snying tig gi zab rgya rmad du byung ba brgyud kyi dgongs don lung gi tshhul di ston ba gyur to 
BO_TZ_TSASUM-OSEL-NYINGTHIG-P12:215	gnyis pa lung gi don dngos la gnyis /	21	gnyis ba lung gi don dngos la gnyis 
BO_TZ_TSASUM-OSEL-NYINGTHIG-P12:216	gang bsgrub par bya ba'i gzhi /	21	gang sgrub ba byed ba gzhi 
BO_TZ_TSASUM-OSEL-NYINGTHIG-P12:217	ji ltar sgrub pa'i thabs bstan pa'o //	21	ji ltar sgrub ba thabs ston ba 
BO_TZ_TSASUM-OSEL-NYINGTHIG-P12:218	dang po ni /	21	dang po ni 
BO_TZ_TSASUM-OSEL-NYINGTHIG-P12:219	chos rnams kun gyi de nyid ni :sogs nas /	21	chos rnams kun gyi de nyid ni :sogs nas 
BO_TZ_TSASUM-OSEL-NYINGTHIG-P12:220	'dus par blta :	22	du ba lta 
BO_TZ_TSASUM-OSEL-NYINGTHIG-P12:221	zhes pa'i don te /	22	zhes ba don te 
BO_TZ_TSASUM-OSEL-NYINGTHIG-P12:222	ngo bo'i gnas tshhul gyis gzhal na chos rnams kun gyi de nyid ni bsam pa dang brjod pa'i yul las 'das pa gnyug ma'i dbyings rig pa 'od gsal thig le nyag gcig gi sbubs su 'jug pa la /	22	ngo bo gnas tshhul gyis jal na chos rnams kun gyi de nyid ni bsam ba dang rjod ba yul las da ba gnyug ma dbyings rig ba d gsal thig le nyag gcig gi sbub su jug ba la 
BO_TZ_TSASUM-OSEL-NYINGTHIG-P12:223	bcings pa dang grol ba'i gnas skabs tha dad med par ye sangs rgyas pa snang stong zung 'jug dbyings rig gnyis med rang byung gdod ma'i sangs rgyas kun tu bzang po nyid /	22	ching ba dang grol ba gnas skabs tha dad med ba ye sangs rgya ba snang stong zung jug dbyings rig gnyis med rang byung gdod ma sangs rgya kun tu bzang po nyid 
BO_TZ_TSASUM-OSEL-NYINGTHIG-P12:224	rnam pa'i snang tshhul gyis thabs 'od gsal snang ba'i cha 'chi med mtshho las brdzus te skyes pa lha pad+ma thod phreng rtshal yab dang / dbyings ka dag stong pa'i cha man+da rahba yum ste /	22	rnam ba snang tshhul gyis thabs d gsal snang ba cha chi med mtshho las brdzus te skye ba lha pad+ma thod phreng rtshal yab dang dbyings ka dag stong ba cha man+da rahba yum ste 
BO_TZ_TSASUM-OSEL-NYINGTHIG-P12:225	yab yum gdod nas gnyis med zung 'jug kha sbyor bde ba chen po bri gang dang bral ba'i rang bzhin gyi thugs rje ma 'gags rol pa'i cho 'phrul yi dam yongs rdzogs 'dus pa bla ma dbang chen pad+ma drag po dang tha mi dad pa'i sku ru bsgrub	22	yab yum gdod nas gnyis med zung jug kha sbyor bde ba chen po bri gang dang bral ba rang bzhin gyi thugs rje ma gag rol ba cho phrul yi dam yongs rdzogs du ba bla ma dbang chen pad+ma drag po dang tha mi dad ba sku ru sgrub 
BO_TZ_TSASUM-OSEL-NYINGTHIG-P12:226	par bya zhing /	22	ba byed zhing 
BO_TZ_TSASUM-OSEL-NYINGTHIG-P12:227	de yang ye shes gcig nyid gang 'dul sgyu 'phrul rdo rje bkod pa'i rol mor 'byams su klas par ston kyang /	22	de yang ye shes gcig nyid gang dul sgyu phrul rdo rje bkod ba rol mor byam su klas ba ston kyang 
BO_TZ_TSASUM-OSEL-NYINGTHIG-P12:228	don du ni snang grags rig pa gsum po lha dang sngags dang chos sku rtsha gsum 'dus pa rang rig bla ma'i ye shes gcig las gzhan du ma dmigs par shes pas bskyed rdzogs kyi zab gnad kun gyi 'gag der bsdu shes na /	22	don du ni snang grags rig ba gsum po lha dang sngags dang chos sku rtsha gsum du ba rang rig bla ma ye shes gcig las gzhan du ma dmigs ba shes ba skyed rdzogs kyi zab gnad kun gyi gag der sdud shes na 
BO_TZ_TSASUM-OSEL-NYINGTHIG-P12:229	mchog thun gyi dngos grub bde myur du thob pa'i thabs la nam yang bslu ba med pa ste /	22	mchog thun gyi dngos grub bde myur du thob ba thabs la nam yang bslu ba med ba ste 
BO_TZ_TSASUM-OSEL-NYINGTHIG-P12:230	rtsha gsum kun 'dril snying po'i rgyud las /	23	rtsha gsum kun dril snying po brgyud las 
BO_TZ_TSASUM-OSEL-NYINGTHIG-P12:231	bla ma sangs rgyas thog mar byung ba'i don :	23	bla ma sangs rgya thogs mar byung ba don 
BO_TZ_TSASUM-OSEL-NYINGTHIG-P12:232	rang rig rgyal po rang gsal bla ma'i mchog :	23	rang rig rgyal po rang gsal bla ma mchog 
BO_TZ_TSASUM-OSEL-NYINGTHIG-P12:233	tshhogs ma gsag dang mthong ba kun tu bzang :	23	tshhogs ma gsag dang mthong ba kun tu bzang 
BO_TZ_TSASUM-OSEL-NYINGTHIG-P12:234	de phyir kun bzang sngon du'ang bla ma byung :	23	de phyir kun bzang sngon du bla ma byung 
BO_TZ_TSASUM-OSEL-NYINGTHIG-P12:235	zhes dang / rgyal ba kun gyi spyi gzugs 'di kho na :	23	zhes dang rgyal ba kun gyi spyi gzugs di kho na 
BO_TZ_TSASUM-OSEL-NYINGTHIG-P12:236	chags shing zhi bas 'dul la zhi ba dang : sdang zhing khro bas 'dul la khro bor snang :	23	chags shing zhi ba dul la zhi ba dang sdang zhing khro ba dul la khro bor snang 
BO_TZ_TSASUM-OSEL-NYINGTHIG-P12:237	cir yang 'phrul pa rgyal sras pad+ma 'byung :	23	cir yang phrul ba rgyal sras pad+ma byung 
BO_TZ_TSASUM-OSEL-NYINGTHIG-P12:238	rang rig bla ma'i rgyal por bdag gis bshad :	23	rang rig bla ma rgyal por bdag gis chad 
BO_TZ_TSASUM-OSEL-NYINGTHIG-P12:239	ces so // gnyis pa ji ltar sgrub pa'i thabs ni /	23	ces so gnyis ba ji ltar sgrub ba thabs ni 
BO_TZ_TSASUM-OSEL-NYINGTHIG-P12:240	bcos min mos shing gdung ba'i sogs nas /	24	chos min mos shing gdung ba sogs nas 
BO_TZ_TSASUM-OSEL-NYINGTHIG-P12:241	hu~m hu~m hu~m: zhes pa ste /	24	hu~m hu~m hu~m: zhes ba ste 
BO_TZ_TSASUM-OSEL-NYINGTHIG-P12:242	sgrub gzhi nges don gyi bla ma mchog gsum rtsha gsum lha sngags chos sku kun 'dus kyi gnas lugs mngon sum du rtogs byed thabs kun gyi rtsha ba ni bcos ma min pa'i mos gus che zhing dad pas gdung ba'i blos gsol ba 'debs pa kho na la	24	sgrub gzhi nges don gyi bla ma mchog gsum rtsha gsum lha sngags chos sku kun du kyi gnas lugs mngon sum du rtogs byed thabs kun gyi rtsha ba ni chos ma min ba mos gus che zhing dad ba gdung ba blos gsol ba debs ba kho na la 
BO_TZ_TSASUM-OSEL-NYINGTHIG-P12:243	rag las pa ste /	24	rag las ba ste 
BO_TZ_TSASUM-OSEL-NYINGTHIG-P12:244	a ti bkod pa chen po las /	24	a ti bkod ba chen po las 
BO_TZ_TSASUM-OSEL-NYINGTHIG-P12:245	bla ma sgom dang bstod dang bsam pa yis //	24	bla ma sgom dang bstod dang bsam ba yis 
BO_TZ_TSASUM-OSEL-NYINGTHIG-P12:246	sangs rgyas 'bras bu cig car 'grub par nges //	24	sangs rgya bras bu cig car grub ba nges 
BO_TZ_TSASUM-OSEL-NYINGTHIG-P12:247	zhes gsungs pas /	24	zhes gsungs ba 
BO_TZ_TSASUM-OSEL-NYINGTHIG-P12:248	gsol 'debs rdo rje'i tshhig rkang bdun pa 'di nyid kyis thugs rgyud bskul te yang yang bzla bar bya zhing /	24	gsol debs rdo rje tshhig rkang bdun ba di nyid kyis thugs brgyud skul te yang yang bzla ba byed zhing 
BO_TZ_TSASUM-OSEL-NYINGTHIG-P12:249	de yang rtsha gsum bde gshegs kun 'dus kyi bla ma'i sku gsung thugs dang yon tan phrin las mi zad rgyan gyi 'khor lo'i rol pa las /	24	de yang rtsha gsum bde gshegs kun du kyi bla ma sku gsung thugs dang yon tan phrin las mi zad rgyan gyi khor lo rol ba las 
BO_TZ_TSASUM-OSEL-NYINGTHIG-P12:250	bla ma yi dam sangs rgyas byang sems dpa' bo mkha' 'gro chos skyong nor lha gter bdag dang bcas pa thams cad shar bar nges shes skyed /	25	bla ma yi dam sangs rgya byang sems dpa bo mkha gro chos skyong nor lha gter bdag dang cha ba thams cad char ba nges shes skyed 
BO_TZ_TSASUM-OSEL-NYINGTHIG-P12:251	thag bcad la /	25	thag gcod la 
BO_TZ_TSASUM-OSEL-NYINGTHIG-P12:252	mos gus gdung ba drag pos nyin mtshhan bar med du gsol ba btab pas /	25	mos gus gdung ba drag pos nyin mtshhan ba med du gsol ba debs ba 
BO_TZ_TSASUM-OSEL-NYINGTHIG-P12:253	mchog thun dngos grub mtha' dag de kho nas 'grub pa ni nges pa'o //	25	mchog thun dngos grub mtha dag de kho nas grub ba ni nges ba 
BO_TZ_TSASUM-OSEL-NYINGTHIG-P12:254	gu ru'i gsol 'debs kun gyi rgyal po rdo rje'i tshhig rkang bdun pa 'di nyid la mtha' drug tshhul bzhi'i rnam bshad zab cing rgya che ba /	25	gu ru gsol debs kun gyi rgyal po rdo rje tshhig rkang bdun ba di nyid la mtha drug tshhul bzhi rnam chad zab cing rgya che ba 
BO_TZ_TSASUM-OSEL-NYINGTHIG-P12:255	7kun gzigs mi pham 'jam pa'i dbyangs kyis legs bshad dgongs gter bstan bcos kyi tshhul du bstshal bar rgyas par bstan pa bzhin /	25	7kun gzigs mi pham jam ba dbyangs kyis legs chad dgongs gter ston chos kyi tshhul du bstshal ba rgya ba ston ba bzhin 
BO_TZ_TSASUM-OSEL-NYINGTHIG-P12:256	rdo rje'i tshhig rkang gcig gis kyang bla rdzogs thugs gsum gyi bskyed rdzogs man ngag dang bcas zhib rgyas su bstan pa'ang shes shing bshad par bya'o //	25	rdo rje tshhig rkang gcig gis kyang bla rdzogs thugs gsum gyi skyed rdzogs man ngag dang cha zhib rgya su ston ba shes shing chad ba byed 
BO_TZ_TSASUM-OSEL-NYINGTHIG-P12:257	gsum pa phan yon bstan pa ni /	25	gsum ba phan yon ston ba ni 
BO_TZ_TSASUM-OSEL-NYINGTHIG-P12:258	'dis ni snang srid sgyu mar sogs nas /	25	dis ni snang srid sgyu mar sogs nas 
BO_TZ_TSASUM-OSEL-NYINGTHIG-P12:259	thig le chen por gshegs :	25	thig le chen por gshegs 
BO_TZ_TSASUM-OSEL-NYINGTHIG-P12:260	rgya rgya rgya :	26	rgya rgya rgya 
BO_TZ_TSASUM-OSEL-NYINGTHIG-P12:261	brda thim : zhes phyir gsal ston 'khor gyi bkod pa nang dbyings su bsdu tshhul dang bcas zhib rgyas su bstan pa'o //	26	brda thim zhes phyir gsal ston khor gyi bkod ba nang dbyings su sdud tshhul dang cha zhib rgya su ston ba 
BO_TZ_TSASUM-OSEL-NYINGTHIG-P12:262	! //gsum pa man ngag 'ja' lus rdo rje'i tshhig rkang gis sgrub byed sngon 'gro dngos gzhi rjes kyi rim pas nyams su len bya'i lam rgyas par bshad pa la /	26	ba man ngag ja lus rdo rje tshhig rkang gis sgrub byed sngon gro dngos gzhi rjes kyi rim ba nyams su len byed lam rgya ba chad ba la 
BO_TZ_TSASUM-OSEL-NYINGTHIG-P12:263	sngon 'gro / dngos gzhi /	26	sngon gro dngos gzhi 
BO_TZ_TSASUM-OSEL-NYINGTHIG-P12:264	rjes so // dang po sngon 'gro la'ang /mtshhan /	26	rjes so dang po sngon gro la 
BO_TZ_TSASUM-OSEL-NYINGTHIG-P12:265	mchod brjod / mdor bstan pa gsum las /	26	mchod rjod mdor ston ba gsum las 
BO_TZ_TSASUM-OSEL-NYINGTHIG-P12:266	dang po ni /	26	dang po ni 
BO_TZ_TSASUM-OSEL-NYINGTHIG-P12:267	rtsha gsum 'od gsal snying tig las :	26	rtsha gsum d gsal snying tig las 
BO_TZ_TSASUM-OSEL-NYINGTHIG-P12:268	man ngag 'ja' lus rdo rje'i tshhig rkang bzhugs :	26	man ngag ja lus rdo rje tshhig rkang bzhugs 
BO_TZ_TSASUM-OSEL-NYINGTHIG-P12:269	zhes pa ste /	26	zhes ba ste 
BO_TZ_TSASUM-OSEL-NYINGTHIG-P12:270	de yang sgrub byed rgyud lung man ngag gi gnad kyis /	27	de yang sgrub byed brgyud lung man ngag gi gnad kyis 
BO_TZ_TSASUM-OSEL-NYINGTHIG-P12:271	bsgrub bya byin rlabs kyi rtsha ba bla ma /	27	sgrub byed byin rlabs kyi rtsha ba bla ma 
BO_TZ_TSASUM-OSEL-NYINGTHIG-P12:272	dngos grub kyi rtsha ba yi dam /	27	dngos grub kyi rtsha ba yi dam 
BO_TZ_TSASUM-OSEL-NYINGTHIG-P12:273	phrin las kyi rtsha ba mkha' 'gro chos skyong gsum ste /	27	phrin las kyi rtsha ba mkha gro chos skyong gsum ste 
BO_TZ_TSASUM-OSEL-NYINGTHIG-P12:274	sgrub tshhul bskyed rdzogs rdzogs chen gang gis sgrub kyang gdod nas dag pa'i 'od gsal sems kyi rdo rje'i chos nyid gcig tu 'bab cing gzhol ba ste /	27	sgrub tshhul skyed rdzogs rdzogs chen gang gis sgrub kyang gdod nas dag ba d gsal sems kyi rdo rje chos nyid gcig tu bab cing gzhol ba ste 
BO_TZ_TSASUM-OSEL-NYINGTHIG-P12:275	ye shes chen po de yi gnas snang dang mthun pa'i zab lam thams cad kyi nying khu'i bcud lta bu yin pas snying tig ces bya ba las /	27	ye shes chen po de yi gnas snang dang mthun ba zab lam thams cad kyi nying khu bcud lta bu yin ba snying tig ces byed ba las 
BO_TZ_TSASUM-OSEL-NYINGTHIG-P12:276	brjod pa'i don de rtogs pa'i phyir rjod byed kyi tshhig rtsha ba gsum gyi bskyed rdzogs dbang dang bcas pa'i man ngag tshhul bzhin nyams su blangs pas /	27	rjod ba don de rtogs ba phyir rjod byed kyi tshhig rtsha ba gsum gyi skyed rdzogs dbang dang cha ba man ngag tshhul bzhin nyams su blangs ba 
BO_TZ_TSASUM-OSEL-NYINGTHIG-P12:277	'bras bu mi slob pa'i go 'phang 'ja' lus rdo rje'i gnas la yud kyis sbyor nus pa'i rdo rje'i gsung rnam pa thams cad pa'i bdag nyid rang byung na da'i rang sgrar shar ba'i tshhig rkang bzhugs zhes so //	27	bras bu mi slob ba go phen ja lus rdo rje gnas la yud kyis sbyor nus ba rdo rje gsung rnam ba thams cad ba bdag nyid rang byung na da rang sgrar char ba tshhig rkang bzhugs zhes so 
BO_TZ_TSASUM-OSEL-NYINGTHIG-P12:278	gnyis pa mchod brjod ni /	27	gnyis ba mchod rjod ni 
BO_TZ_TSASUM-OSEL-NYINGTHIG-P12:279	rtsha gsum kun 'dus thod phreng rtshal la 'dud :	27	rtsha gsum kun du thod phreng rtshal la dud 
BO_TZ_TSASUM-OSEL-NYINGTHIG-P12:280	ces gsungs pa'i don /	28	ces gsungs ba don 
BO_TZ_TSASUM-OSEL-NYINGTHIG-P12:281	sangs rgyas kyi phrin las gang 'dul gyi rol pa gdul bya'i don du spro na /	28	sangs rgya kyi phrin las gang dul gyi rol ba gdul byed don du spro na 
BO_TZ_TSASUM-OSEL-NYINGTHIG-P12:282	lha'i sgo nas dbye ba'i bla ma yi dam mkha' 'gro chos skyong gi tshhul gyis rtsha gsum zhi khro rab 'byams kyi bkod pa bgrangs yas su ston pa thams cad kun kyang /	28	lha sgo nas byed ba bla ma yi dam mkha gro chos skyong gi tshhul gyis rtsha gsum zhi khro rab byam kyi bkod ba bgrong yas su ston ba thams cad kun kyang 
BO_TZ_TSASUM-OSEL-NYINGTHIG-P12:283	ngo bo dpal ldan bla ma rdo rje thod phreng rtshal gcig gi ye shes kyi thig ler 'dus pa ste /	28	ngo bo dpal ldan bla ma rdo rje thod phreng rtshal gcig gi ye shes kyi thig ler du ba ste 
BO_TZ_TSASUM-OSEL-NYINGTHIG-P12:284	spyir don gyi gnas lugs ngo bo'i dbang du byas na bla ma thams cad la sangs rgyas kun gyi gsang ba gsum 'dus par gsungs kyang /	28	spyir don gyi gnas lugs ngo bo dbang du byed na bla ma thams cad la sangs rgya kun gyi gsang ba gsum du ba gsungs kyang 
BO_TZ_TSASUM-OSEL-NYINGTHIG-P12:285	slob dpon rin po che la rtsha gsum rgyal ba rab 'byams kyi bdag nyid du gsungs pa gnas snang gnyis ka la dgongs pas khyad par che ste /	28	slob dpon rin po che la rtsha gsum rgyal ba rab byam kyi bdag nyid du gsungs ba gnas snang gnyis ka la dgongs ba khyad ba che ste 
BO_TZ_TSASUM-OSEL-NYINGTHIG-P12:286	gu ru rin po che nyid kyi rdo rje'i gsung las /	28	gu ru rin po che nyid kyi rdo rje gsung las 
BO_TZ_TSASUM-OSEL-NYINGTHIG-P12:287	nga nyid chos sku'i sangs rgyas thams cad kyis byin brlabs :	28	nga nyid chos sku sangs rgya thams cad kyis byin brlabs 
BO_TZ_TSASUM-OSEL-NYINGTHIG-P12:288	longs spyod rdzogs sku'i sangs rgyas thams cad kyis dbang bskur :	28	longs spyod rdzogs sku sangs rgya thams cad kyis dbang skur 
BO_TZ_TSASUM-OSEL-NYINGTHIG-P12:289	sprul sku'i sangs rgyas thams cad kyis bka' bgros mdzad de :	28	sprul sku sangs rgya thams cad kyis bka bgro mdzad de 
BO_TZ_TSASUM-OSEL-NYINGTHIG-P12:290	lho 'dzam bu'i gling du sangs rgyas kyi bstan pa dar bar bya ba dang : gsang sngags 'bras bu'i chos kyis 'gro ba 'dren pa'i phyir :	29	lho dzam bu gling du sangs rgya kyi ston ba dar ba byed ba dang gsang sngags bras bu chos kyis gro ba bgrang ba phyir 
BO_TZ_TSASUM-OSEL-NYINGTHIG-P12:291	rin chen mtshho gling pad+ma'i sdong po la :	29	rin chen mtshho gling pad+ma sdong po la 
BO_TZ_TSASUM-OSEL-NYINGTHIG-P12:292	rang byung sprul pa'i sku ru brda yis 'ong :	29	rang byung sprul ba sku ru brda yis ng 
BO_TZ_TSASUM-OSEL-NYINGTHIG-P12:293	gang zhig las can skyes bu dad pa can :	29	gang jig las can skye bu dad ba can 
BO_TZ_TSASUM-OSEL-NYINGTHIG-P12:294	bdag la gdung ba'i sems kyis gsol 'debs na :	29	bdag la gdung ba sems kyis gsol debs na 
BO_TZ_TSASUM-OSEL-NYINGTHIG-P12:295	rgyu 'bras rten 'brel smon lam khyad par gyis :	29	rgyu bras rten brel smon lam khyad ba gyis 
BO_TZ_TSASUM-OSEL-NYINGTHIG-P12:296	sangs rgyas gzhan bas bdag nyid thugs rje myur :	29	sangs rgya gzhan ba bdag nyid thugs rje myur 
BO_TZ_TSASUM-OSEL-NYINGTHIG-P12:297	mtshho rgyal mos pas rgyun du gsol ba thobs :	29	mtshho rgyal mos ba rgyun du gsol ba thobs 
BO_TZ_TSASUM-OSEL-NYINGTHIG-P12:298	zhes dang / smon lam gang btab de yis de thob byed :	29	zhes dang smon lam gang debs de yis de thob byed 
BO_TZ_TSASUM-OSEL-NYINGTHIG-P12:299	gsol btab pad 'byung nga las dgos 'dod 'byung :	29	gsol debs pad byung nga las dgos dod byung 
BO_TZ_TSASUM-OSEL-NYINGTHIG-P12:300	zhes ngo bo sangs rgyas thams cad 'dus pa'i thugs rje ye sprul /	30	zhes ngo bo sangs rgya thams cad du ba thugs rje ye sprul 
BO_TZ_TSASUM-OSEL-NYINGTHIG-P12:301	rnam pa mkhyen brtshe nus pa'i phrin las tshhad med pa pad+ma thod phreng rtshal ni /	30	rnam ba mkhyen brtshe nus ba phrin las tshhad med ba pad+ma thod phreng rtshal ni 
BO_TZ_TSASUM-OSEL-NYINGTHIG-P12:302	snyigs dus kyi gdul bya spyi dang lhag par bod kha ba can gdul zhing du smon lam dang thugs rje'i 'brel bas de la 'dud cing gsol ba btab pas 'dod pa'i 'bras bu myur du 'byin pa 'gyur ro //	30	snyigs dus kyi gdul byed spyi dang lhag ba bod kha ba can gdul zhing du smon lam dang thugs rje brel ba de la dud cing gsol ba debs ba dod ba bras bu myur du byin ba gyur ro 
BO_TZ_TSASUM-OSEL-NYINGTHIG-P12:303	gsum pa mdor bstan pa ni /	30	gsum ba mdor ston ba ni 
BO_TZ_TSASUM-OSEL-NYINGTHIG-P12:304	'khor 'das chos kun gdod nas rnam dag kyang :	30	khor da chos kun gdod nas rnam dag kyang 
BO_TZ_TSASUM-OSEL-NYINGTHIG-P12:305	zhes pa ste /	30	zhes ba ste 
BO_TZ_TSASUM-OSEL-NYINGTHIG-P12:306	sbyang gzhi don gyi gnas lugs 'khor 'das chos kun gdod nas rnam dag ka dag dag pa chen po bstan cing gzhi de ltar lags kyang /	30	sbyong gzhi don gyi gnas lugs khor da chos kun gdod nas rnam dag ka dag dag ba chen po ston cing gzhi de ltar lags kyang 
BO_TZ_TSASUM-OSEL-NYINGTHIG-P12:307	gnyis 'dzin glo bur 'khrul pa sbyang ba'i phyir :	30	gnyis dzin glo bur khrul ba sbyong ba phyir 
BO_TZ_TSASUM-OSEL-NYINGTHIG-P12:308	zhes sbyang bya gzhi snang lhun grub kyi snang cha rang snang du ma shes pas bdag tu bzung ba'i lhan skyes dang kun brtags kyi ma rig pas gnyis 'dzin med snang glo bur gyi 'khor chos 'khrul pa sbyang ba'i phyir /	30	zhes sbyong byed gzhi snang lhun grub kyi snang cha rang snang du ma shes ba bdag tu bzung ba lhan skye dang kun rtog kyi ma rig ba gnyis dzin med snang glo bur gyi khor chos khrul ba sbyong ba phyir 
BO_TZ_TSASUM-OSEL-NYINGTHIG-P12:309	thun mong khyad par bla med lam mchog 'di :	30	thun mong khyad ba bla med lam mchog di 
BO_TZ_TSASUM-OSEL-NYINGTHIG-P12:310	zhes sbyong byed thun mong kun brtags kyi zhen pa sbyong byed bskyed rim /	31	zhes sbyong byed thun mong kun rtog kyi zhen ba sbyong byed skyed rim 
BO_TZ_TSASUM-OSEL-NYINGTHIG-P12:311	khyad par bag chags kyi sgrib pa sbyong byed rdzogs rim /	31	khyad ba bag chags kyi sgrib ba sbyong byed rdzogs rim 
BO_TZ_TSASUM-OSEL-NYINGTHIG-P12:312	bla med lhan skyes kyi sgrib pa sbyong byed zung 'jug rdo rje sems dpa'i man ngag thun mong ma yin pa'i gseng lam sngon 'gro dngos gzhi rjes kyi lam yongs rdzogs rgyu 'bras theg pa kun gyi yang snying /	31	bla med lhan skye kyi sgrib ba sbyong byed zung jug rdo rje sems dpa man ngag thun mong ma yin ba gseng lam sngon gro dngos gzhi rjes kyi lam yongs rdzogs rgyu bras theg ba kun gyi yang snying 
BO_TZ_TSASUM-OSEL-NYINGTHIG-P12:313	rtog ge dang rang bzos ma bslad pa'i gsang mchog rdo rje'i tshhig rkang rgyud kyi rgyal po'i dgongs don gyi yang zhun 'di lta bu ni /	31	rtogs ge dang rang bzos ma bslad ba gsang mchog rdo rje tshhig rkang brgyud kyi rgyal po dgongs don gyi yang zhun di lta bu ni 
BO_TZ_TSASUM-OSEL-NYINGTHIG-P12:314	rang byung mtshho skyes rdo rje bdag gis bstan :	31	rang byung mtshho skye rdo rje bdag gis ston 
BO_TZ_TSASUM-OSEL-NYINGTHIG-P12:315	zhes sangs rgyas kun gyi gsung rdo rje rang byung gsang sngags kyi slob dpon gyi tshhul du bstan pa'i tshhe /	31	zhes sangs rgya kun gyi gsung rdo rje rang byung gsang sngags kyi slob dpon gyi tshhul du ston ba tshhe 
BO_TZ_TSASUM-OSEL-NYINGTHIG-P12:316	o rgyan d+ha na ko sha'i mtshho gling las pha ma'i rgyu rkyen la ma ltos par rig pa thol skyes kyis 'khrungs pa rdo rje'i rig 'dzin bdag gis bstan pa ltar nyams su blangs bas /	31	o rgyan d+ha na ko sha mtshho gling las pha ma rgyu rkyen la ma ltos ba rig ba thol skye kyis khrung ba rdo rje rig dzin bdag gis ston ba ltar nyams su blangs ba 
BO_TZ_TSASUM-OSEL-NYINGTHIG-P12:317	sbyangs 'bras sku dang ye shes kyi dpal la spyod pa nam yang mi bslu bar shugs la bstan to //	31	sbyong bras sku dang ye shes kyi dpal la spyod ba nam yang mi bslu ba shugs la ston to 
BO_TZ_TSASUM-OSEL-NYINGTHIG-P12:318	gnyis pa dngos gzhi la /	31	gnyis ba dngos gzhi la 
BO_TZ_TSASUM-OSEL-NYINGTHIG-P12:319	lam gyi 'jug sgo /	31	lam gyi jug sgo 
BO_TZ_TSASUM-OSEL-NYINGTHIG-P12:320	lam gyi gzhung shing /	32	lam gyi gzhung shing 
BO_TZ_TSASUM-OSEL-NYINGTHIG-P12:321	lam gyi myur lam /	32	lam gyi myur lam 
BO_TZ_TSASUM-OSEL-NYINGTHIG-P12:322	lam gyi sbas don /	32	lam gyi sbed don 
BO_TZ_TSASUM-OSEL-NYINGTHIG-P12:323	lam gyi man ngag gi rim pa lngas bstan pa'o //	32	lam gyi man ngag gi rim ba lngas ston ba 
BO_TZ_TSASUM-OSEL-NYINGTHIG-P12:324	dang po ni /	32	dang po ni 
BO_TZ_TSASUM-OSEL-NYINGTHIG-P12:325	dbang thob dam tshhig la gnas rnal 'byor pas :	32	dbang thob dam tshhig la gnas rnal byor ba 
BO_TZ_TSASUM-OSEL-NYINGTHIG-P12:326	zhes pa ltar /	32	zhes ba ltar 
BO_TZ_TSASUM-OSEL-NYINGTHIG-P12:327	gsang sngags chos kyi sgo 'byed dbang gis ma smin na lam la 'jug pa lta ci man ngag gi dpe tsham blta rtogs mi rung bas /	32	gsang sngags chos kyi sgo byed dbang gis ma smin na lam la jug ba lta ci man ngag gi dpe tsham lta rtogs mi rung ba 
BO_TZ_TSASUM-OSEL-NYINGTHIG-P12:328	mtshhan nyid dang ldan pa'i rdo rje slob dpon gyis phyi phan pa /	32	mtshhan nyid dang ldan ba rdo rje slob dpon gyis phyi phan ba 
BO_TZ_TSASUM-OSEL-NYINGTHIG-P12:329	nang nus 'jug /gsang ba zab mo'i dbang mtha' rten dang bcas pa thob pas rgyud snod rung du smin par byas nas /	32	nang nus jug ba zab mo dbang mtha rten dang cha ba thob ba brgyud snod rung du smin ba byed nas 
BO_TZ_TSASUM-OSEL-NYINGTHIG-P12:330	dam tshhig la legs par gnas pa'i dad brtshon shes rab dang ldan pa'i slob ma'am rnal 'byor pas rgyab rten man ngag gi lam la thos bsam gyi sgro 'dogs bcad cing nges pa rnyed par byas nas /	33	dam tshhig la legs ba gnas ba dad brtshon shes rab dang ldan ba slob ma rnal byor ba rgyab rten man ngag gi lam la thos bsam gyi sgro dogs gcod cing nges ba rnyed ba byed nas 
BO_TZ_TSASUM-OSEL-NYINGTHIG-P12:331	gangs khrod ri rtshe mtshho gling nags tshhal sogs :	33	gangs khrod ri rtshe mtshho gling nags tshhal sogs 
BO_TZ_TSASUM-OSEL-NYINGTHIG-P12:332	shin tu dben zhing nyams dga'i gnas mchog tu :	33	shin tu dben zhing nyams dga gnas mchog tu 
BO_TZ_TSASUM-OSEL-NYINGTHIG-P12:333	zhes rnam g.yeng dang 'du 'dzi'i spros pa med cing dngos grub sgrub pa'i mtshhan nyid tshhang ba'i gnas su /	33	zhes rnam g.yeng dang du dzi spros ba med cing dngos grub sgrub ba mtshhan nyid tshhang ba gnas su 
BO_TZ_TSASUM-OSEL-NYINGTHIG-P12:334	gcig pur bde ba'i stan la bag phab ste :	33	gcig pur bde ba stan la bag bebs ste 
BO_TZ_TSASUM-OSEL-NYINGTHIG-P12:335	zhes tshhe 'di'i spros pa rbad kyis bcad nas bsam gtan gyi spyod lam dang ldan pas sgo gsum rnal du phab ste nyams len gyi drod tshhad thob par bya dgos so //	33	zhes tshhe di spros ba rbod kyis gcod nas bsam gtan gyi spyod lam dang ldan ba sgo gsum rnal du bebs ste nyams len gyi drod tshhad thob ba byed dgos so 
BO_TZ_TSASUM-OSEL-NYINGTHIG-P12:336	gnyis pa lam gyi gzhung shing bstan pa la /	33	gnyis ba lam gyi gzhung shing ston ba la 
BO_TZ_TSASUM-OSEL-NYINGTHIG-P12:337	thun mong dang / thun min gnyis las /	33	thun mong dang thun min gnyis las 
BO_TZ_TSASUM-OSEL-NYINGTHIG-P12:338	dang po ni /	33	dang po ni 
BO_TZ_TSASUM-OSEL-NYINGTHIG-P12:339	dal 'byor lus 'di sogs /	33	dal byor lus di sogs 
BO_TZ_TSASUM-OSEL-NYINGTHIG-P12:340	tshhig rkang bzhis chos sgrub byed rten dal 'byor rnyed dka' bas snying po len dgos pa /	34	tshhig rkang bzhis chos sgrub byed rten dal byor rnyed dka ba snying po len dgos ba 
BO_TZ_TSASUM-OSEL-NYINGTHIG-P12:341	chos la bskul ba'i rkyen snod bcud mi rtag pas rgyud bskul te blo sna bstung ba /	34	chos la skul ba rkyen snod bcud mi rtag ba brgyud skul te blo sna stung ba 
BO_TZ_TSASUM-OSEL-NYINGTHIG-P12:342	chos kyi gnad rgyu 'bras la yid ches pas dge sdig spang blang du bya ba /	34	chos kyi gnad rgyu bras la yid ches ba dge sdig spong blang du byed ba 
BO_TZ_TSASUM-OSEL-NYINGTHIG-P12:343	chos kyi srog 'khor ba'i nyes pa mthong bas nges par 'byung ba'i blo bskyed pa'o //	34	chos kyi srog khor ba nyes ba mthong ba nges ba byung ba blo skyed ba 
BO_TZ_TSASUM-OSEL-NYINGTHIG-P12:344	de dag ni mdo sngags thun mong gi theg pa che chung thams cad kyi lam gyi khog dbub med du mi rung ba'i gces gnad do //	34	de dag ni mdo sngags thun mong gi theg ba che chung thams cad kyi lam gyi khog bubs med du mi rung ba gces gnad do 
BO_TZ_TSASUM-OSEL-NYINGTHIG-P12:345	gnyis pa thun min ni /	34	gnyis ba thun min ni 
BO_TZ_TSASUM-OSEL-NYINGTHIG-P12:346	bdag gzhan byang chub sogs nas /	34	bdag gzhan byang chub sogs nas 
BO_TZ_TSASUM-OSEL-NYINGTHIG-P12:347	mngon sum lhug pa'i ye shes de ru 'char :	34	mngon sum lhug ba ye shes de ru char 
BO_TZ_TSASUM-OSEL-NYINGTHIG-P12:348	zhes pa ste /	34	zhes ba ste 
BO_TZ_TSASUM-OSEL-NYINGTHIG-P12:349	rgyu 'bras theg pa che chung gi dgongs pa ltar skyabs 'gro'i rnam gzhag shes pas nyams su len par bya zhing theg pa chen po'i lam ltar rgyu 'bras ngo bo nyid gsum gyis skyabs su 'gro /	34	rgyu bras theg ba che chung gi dgongs ba ltar skyob gro rnam jog shes ba nyams su len ba byed zhing theg ba chen po lam ltar rgyu bras ngo bo nyid gsum gyis skyob su gro 
BO_TZ_TSASUM-OSEL-NYINGTHIG-P12:350	theg chen lam gyi rtsha ba kun rdzob don dam gyi sems bskyed stong nyid snying rje'i snying po can la nyams len gyi mthil bca'/	35	theg chen lam gyi rtsha ba kun rdzob don dam gyi sems skyed stong nyid snying rje snying po can la nyams len gyi mthil 
BO_TZ_TSASUM-OSEL-NYINGTHIG-P12:351	sdig ltung gi gnyen por rdor sems sgom bzlas kyis las nyon gyi 'khrul rtog sbyang /	35	sdig ltung gi gnyen por rdar sems sgom bzlas kyis las nyon gyi khrul rtogs sbyong 
BO_TZ_TSASUM-OSEL-NYINGTHIG-P12:352	tshhogs gsag gi snying po sku gsum gyi zhing khams mchod sprin du 'bul bas dag pa'i zhing khams sbyang /	35	tshhogs gsag gi snying po sku gsum gyi zhing khams mchod sprin du bul ba dag ba zhing khams sbyong 
BO_TZ_TSASUM-OSEL-NYINGTHIG-P12:353	lam 'bras kyi yon tan spyi dang rdo rje'i ye shes btshan thabs su 'beb pa bla ma'i rnal 'byor gyis byin rlabs 'pho bas dgongs brgyud kyi ye shes bskyed pa ste /	35	lam bras kyi yon tan spyi dang rdo rje ye shes btshan thabs su beb ba bla ma rnal byor gyis byin rlabs pho ba dgongs brgyud kyi ye shes skyed ba ste 
BO_TZ_TSASUM-OSEL-NYINGTHIG-P12:354	de lnga ni bskyed rdzogs rdzogs chen dang bcas lam gyi rkang rdo thun mong ma yin pa zab la khyer bde ba'i rnal 'byor rmad du byung ba'o //	35	de lnga ni skyed rdzogs rdzogs chen dang cha lam gyi rkang rdo thun mong ma yin ba zab la khyer bde ba rnal byor rmad du byung ba 
BO_TZ_TSASUM-OSEL-NYINGTHIG-P12:355	gsum pa lam gyi myur lam gsang sngags bla med gzhi ma ha yo ga'i dgongs pa bskyed rim gyi rnam gzhag la sku gsum gyi bskyed bzlas dngos dang / yan lag gi lha'i sgrub thabs la sogs pa dang / bskyed bzlas ji ltar nyams su len tshhul lo //	35	gsum ba lam gyi myur lam gsang sngags bla med gzhi ma ha yo ga dgongs ba skyed rim gyi rnam jog la sku gsum gyi skyed bzlas dngos dang yan lag gi lha sgrub thabs la sogs ba dang skyed bzlas ji ltar nyams su len tshhul lo 
BO_TZ_TSASUM-OSEL-NYINGTHIG-P12:356	dang po la'ang gsum /	35	dang po la gsum 
BO_TZ_TSASUM-OSEL-NYINGTHIG-P12:357	dang po phyi spros pa can bla ma sprul sku pad+ma thod phreng rtshal gyi sgrub pa ni /	35	dang po phyi spros ba can bla ma sprul sku pad+ma thod phreng rtshal gyi sgrub ba ni 
BO_TZ_TSASUM-OSEL-NYINGTHIG-P12:358	ting 'dzin gsum gyis sogs te /	35	ting dzin gsum gyis sogs te 
BO_TZ_TSASUM-OSEL-NYINGTHIG-P12:359	ting 'dzin gsum gyis bskyed pa'i mngon byang gi cho gas 'chi med pad+ma thod phreng chos sku rdo rje 'chang gsang ba 'dus pa'i lha tshhogs bsgom zhing bskyed bzlas mngal skyes kyi bag chags sbyong ba'i bskyed rim tshhe sgrub dang bcas pa dang / 'chi med pad+ma 'byung gnas la thod phreng rigs lnga lus dkyil du bkod pa'i tshhe sgrub 'chi med drwa ba /	35	ting dzin gsum gyis skyed ba mngon byang gi cho gas chi med pad+ma thod phreng chos sku rdo rje chang gsang ba du ba lha tshhogs bsgom zhing skyed bzlas mngal skye kyi bag chags sbyong ba skyed rim tshhe sgrub dang cha ba dang chi med pad+ma byung gnas la thod phreng rigs lnga lus dkyil du bkod ba tshhe sgrub chi med drwa ba 
BO_TZ_TSASUM-OSEL-NYINGTHIG-P12:360	thod phreng rigs lnga'i so so'i sgos sgrub las bzhi'i las tshhogs bcas dang / gnyis pa nang spros med bla ma longs sku thugs rje chen po pad+ma drwa ba'i sgrub pa ste /	36	thod phreng rigs lnga so so sgos sgrub las bzhi las tshhogs cha dang gnyis ba nang spros med bla ma longs sku thugs rje chen po pad+ma drwa ba sgrub ba ste 
BO_TZ_TSASUM-OSEL-NYINGTHIG-P12:361	skad cig bde stong sogs ltar skad cig gi dbyings rig bde stong zung 'jug gi sgyu 'phrul las sgyu ma lta bu'i skus 'phags mchog snying rje chen po'i gzugs sku bsgrub cing bskyed pa drod gsher skye ba'i bag chags sbyong ba'i bskyed rim ste /	36	skad cig bde stong sogs ltar skad cig gi dbyings rig bde stong zung jug gi sgyu phrul las sgyu ma lta bu skus phag mchog snying rje chen po gzugs sku sgrub cing skyed ba drod gsher skye ba bag chags sbyong ba skyed rim ste 
BO_TZ_TSASUM-OSEL-NYINGTHIG-P12:362	phyag rgya sku yi rnal 'byor ni :	36	phyag rgya sku yi rnal byor ni 
BO_TZ_TSASUM-OSEL-NYINGTHIG-P12:363	dbyings dang rig pa dbyer med las :	36	dbyings dang rig ba dbyer med las 
BO_TZ_TSASUM-OSEL-NYINGTHIG-P12:364	zung 'jug sgyu ma'i dkyil 'khor gsal :	36	zung jug sgyu ma dkyil khor gsal 
BO_TZ_TSASUM-OSEL-NYINGTHIG-P12:365	zhes so // gsum pa gsang ba shin tu spros med bla ma chos sku 'od dpag med pa'i sgrub pa 'od gsal drwa ba ni /	36	zhes so gsum ba gsang ba shin tu spros med bla ma chos sku d dpog med ba sgrub ba d gsal drwa ba ni 
BO_TZ_TSASUM-OSEL-NYINGTHIG-P12:366	ma bskyed ye rdzogs sogs ltar skad cig dran rdzogs rdzus skyes sbyong ba'i bskyed rim ste ma bskyed ye rdzogs chos sku'i ting 'dzin gyi 'od snang mtha' yas dkyil 'khor rang la shar ba ni /	36	ma skyed ye rdzogs sogs ltar skad cig dran rdzogs rdzus skye sbyong ba skyed rim ste ma skyed ye rdzogs chos sku ting dzin gyi d snang mtha yas dkyil khor rang la char ba ni 
BO_TZ_TSASUM-OSEL-NYINGTHIG-P12:367	khregs chod ka dag rig rtshal las :	36	khregs chod ka dag rig rtshal las 
BO_TZ_TSASUM-OSEL-NYINGTHIG-P12:368	lhun grub bskyed rdzogs dbyer med par :	36	lhun grub skyed rdzogs dbyer med ba 
BO_TZ_TSASUM-OSEL-NYINGTHIG-P12:369	'jug pa zhes gsungs so //	36	jug ba zhes gsungs so 
BO_TZ_TSASUM-OSEL-NYINGTHIG-P12:370	gzhan yang yang gsang bla ma drag po dmar chen yi dam dgongs 'dus bcas dang / gnyis pa de las 'phros pa yan lag gi lha'i sgrub tshhul ni /	37	gzhan yang yang gsang bla ma drag po dmar chen yi dam dgongs du cha dang gnyis ba de las phro ba yan lag gi lha sgrub tshhul ni 
BO_TZ_TSASUM-OSEL-NYINGTHIG-P12:371	gshin rje gshed dmar 'chi bdag zil gnon /	37	gshin rje gshed dmar chi bdag zil gnon 
BO_TZ_TSASUM-OSEL-NYINGTHIG-P12:372	rta mgrin 'chi med dbang chen 'dus pa /	37	rta mgrin chi med dbang chen du ba 
BO_TZ_TSASUM-OSEL-NYINGTHIG-P12:373	rdo rje rnam 'joms sgrub thabs las tshhogs dang rgyud sde bzhi 'brel gyi sgrub tshhul /	37	rdo rje rnam joms sgrub thabs las tshhogs dang brgyud sde bzhi brel gyi sgrub tshhul 
BO_TZ_TSASUM-OSEL-NYINGTHIG-P12:374	yang phur khrag 'thung 'dus pa'i dril sgrub /	37	yang phur khrag thung du ba dril sgrub 
BO_TZ_TSASUM-OSEL-NYINGTHIG-P12:375	phur pa 'dus pa'i dril sgrub bcas dang / mkha' 'gro phag dkar ye shes snang ba tshhe sgrub dang bcas /	37	phur ba du ba dril sgrub cha dang mkha gro phag dkar ye shes snang ba tshhe sgrub dang cha 
BO_TZ_TSASUM-OSEL-NYINGTHIG-P12:376	sgos bka' de rnams so sor dbang bcas bzhugs pa ste /	37	sgos bka de rnams so sor dbang cha bzhugs ba ste 
BO_TZ_TSASUM-OSEL-NYINGTHIG-P12:377	de ltar bstan pa'i rnal 'byor bla med kyi bskyed rim thams cad kyi lam gnad snying po ni dag rdzogs smin gsum ste /	37	de ltar ston ba rnal byor bla med kyi skyed rim thams cad kyi lam gnad snying po ni dag rdzogs smin gsum ste 
BO_TZ_TSASUM-OSEL-NYINGTHIG-P12:378	de'i tshhul ni kun mkhyen 'jigs med gling pas /	37	de tshhul ni kun mkhyen jigs med gling ba 
BO_TZ_TSASUM-OSEL-NYINGTHIG-P12:379	mdor na snang grags rig gsum tha mal du song ba'i bsnyen pas sa mi chod pas /	37	mdor na snang grags rig gsum tha mal du gro ba snyen ba sa mi chod ba 
BO_TZ_TSASUM-OSEL-NYINGTHIG-P12:380	snang zhen lha sku'i phyag rgyar rdzogasah	38	snang zhen lha sku phyag rgyar rdzogasah 
BO_TZ_TSASUM-OSEL-NYINGTHIG-P12:381	sgra grags bde chen sngags su dgah	38	sgra grags bde chen sngags su dgah 
BO_TZ_TSASUM-OSEL-NYINGTHIG-P12:382	dran rtog 'od gsal chos skur sminah	38	dran rtogs d gsal chos skur sminah 
BO_TZ_TSASUM-OSEL-NYINGTHIG-P12:383	zhes rang lugs kyi dag rdzogs smin gsum 'di bsnyen pa'i mdo chings chen po yin /	38	zhes rang lugs kyi dag rdzogs smin gsum di snyen ba mdo ching chen po yin 
BO_TZ_TSASUM-OSEL-NYINGTHIG-P12:384	zhes gsungs pa ltar /	38	zhes gsungs ba ltar 
BO_TZ_TSASUM-OSEL-NYINGTHIG-P12:385	snod bcud tha mal du snang zhing de la gzung 'dzin du zhen pas 'khor ba'i rgyu 'bras sdug bsngal dang kun 'byung gi bden pa ste /	38	snod bcud tha mal du snang zhing de la gzung dzin du zhen ba khor ba rgyu bras sdug sngal dang kun byung gi bden ba ste 
BO_TZ_TSASUM-OSEL-NYINGTHIG-P12:386	mdo lam nas 'bras bu sdug bsngal du shes par bya ba dang / de'i 'khrul rgyu las nyon kun 'byung spang bya dang / gnyen po lam bden rgyud la brten bya /	38	mdo lam nas bras bu sdug sngal du shes ba byed ba dang de khrul rgyu las nyon kun byung spong byed dang gnyen po lam bden brgyud la rten byed 
BO_TZ_TSASUM-OSEL-NYINGTHIG-P12:387	'gog pa mngon du bya bar gsungs pa gang /	38	gog ba mngon du byed ba gsungs ba gang 
BO_TZ_TSASUM-OSEL-NYINGTHIG-P12:388	sngags lam nas snang cha'i gnas lugs gdan gsum tshhang ba'i dkyil 'khor gyi lha yi sku dang zhing khams dngos zhen dag pa ye shes phyag rgya'i rol par gdod nas myang 'das dang mthun pa'i 'bras bu gzhi la rdzogs pa'i bzhugs tshhul shes pas /	38	sngags lam nas snang cha gnas lugs gdan gsum tshhang ba dkyil khor gyi lha yi sku dang zhing khams dngos zhen dag ba ye shes phyag rgya rol ba gdod nas myang da dang mthun ba bras bu gzhi la rdzogs ba bzhugs tshhul shes ba 
BO_TZ_TSASUM-OSEL-NYINGTHIG-P12:389	dag pa rab 'byams snang srid gzhir bzhengs kyi bskyed rim du gsal te sdug kun gnyis spang mi dgos par 'gog lam gyi bden pa ru shar bas spang blang med par mnyam zhing /	38	dag ba rab byam snang srid gzhir bzhengs kyi skyed rim du gsal te sdug kun gnyis spong mi dgos ba gog lam gyi bden ba ru char ba spong blang med ba mnyam zhing 
BO_TZ_TSASUM-OSEL-NYINGTHIG-P12:390	chos nyid rang gi ngo bo las mi 'gyur yang rig rtshal rlung rig g.yos pa rang snang rang rtshal du ngo ma shes pas chos can 'khrul pa rang rgyud du kha 'khyal te srid pa'i 'khrul 'khor bkod pa'i byed po ni las rlung ste /	39	chos nyid rang gi ngo bo las mi gyur yang rig rtshal rlung rig g.yos ba rang snang rang rtshal du ngo ma shes ba chos can khrul ba rang brgyud du kha khyal te srid ba khrul khor bkod ba byed po ni las rlung ste 
BO_TZ_TSASUM-OSEL-NYINGTHIG-P12:391	chos dang gang zag gi bdag tu rtog pa'i sems dang / lus /	39	chos dang gang zag gi bdag tu rtogs ba sems dang lus 
BO_TZ_TSASUM-OSEL-NYINGTHIG-P12:392	ming gsum gyis sgra tshhig rang mtshhan du zhen cing grags pa'i gnad shes pas las rlung gi g.yo 'khrul dbu mar zhugs gnas thim gsum gyi byed pas bcings nas /	39	ming gsum gyis sgra tshhig rang mtshhan du zhen cing grags ba gnad shes ba las rlung gi g.yo khrul dbu mar jug gnas thim gsum gyi byed ba ching nas 
BO_TZ_TSASUM-OSEL-NYINGTHIG-P12:393	'khor ba dang rnam pa mthun pa'i srid pa'i 'ching zhen thams cad gnas tshhul gsung rdo rje g.yo med bde ba chen po'i ye shes kyi bdag nyid rdo rje'i sngags su gdod nas dag pa'i yin lugs /	39	khor ba dang rnam ba mthun ba srid ba ching zhen thams cad gnas tshhul gsung rdo rje g.yo med bde ba chen po ye shes kyi bdag nyid rdo rje sngags su gdod nas dag ba yin lugs 
BO_TZ_TSASUM-OSEL-NYINGTHIG-P12:394	snang tshhul du yang mngon du sad pa'i thabs grol gyi myur lam zab mo'i gzhi 'ding ba'i gnad kyis /	39	snang tshhul du yang mngon du sad ba thabs grol gyi myur lam zab mo gzhi ding ba gnad kyis 
BO_TZ_TSASUM-OSEL-NYINGTHIG-P12:395	ma dag gnyis snang gi dran rtog thams cad gzhi med rtsha bral don gyi 'od gsal chos sku ru dag ste ye shes rjen pa'i snang ba lhug par spyod pa'i smin byed du gyur pa ni /	39	ma dag gnyis snang gi dran rtogs thams cad gzhi med rtsha bral don gyi d gsal chos sku ru dag ste ye shes rjen ba snang ba lhug ba spyod ba smin byed du gyur ba ni 
BO_TZ_TSASUM-OSEL-NYINGTHIG-P12:396	ming bskyed rim du btags kyang don bskyed rdzogs zung 'jug mchog gi dngos grub kyi nye rgyu ma nor ba'i gnad shes pas /	39	ming skyed rim du dogs kyang don skyed rdzogs zung jug mchog gi dngos grub kyi nye rgyu ma nor ba gnad shes ba 
BO_TZ_TSASUM-OSEL-NYINGTHIG-P12:397	skye gnas bzhi'i bag chags sbyong tshhul dang so so'i dag rdzogs smin gsum zhib par sbyor tshhul spyi ltar shes par bya dgos so //	39	skye gnas bzhi bag chags sbyong tshhul dang so so dag rdzogs smin gsum zhib ba sbyor tshhul spyi ltar shes ba byed dgos so 
BO_TZ_TSASUM-OSEL-NYINGTHIG-P12:398	gsum pa bskyed bzlas ji ltar nyams su len tshhul la /	39	gsum ba skyed bzlas ji ltar nyams su len tshhul la 
BO_TZ_TSASUM-OSEL-NYINGTHIG-P12:399	lha'i gsal snang sgrub pa /	39	lha gsal snang sgrub ba 
BO_TZ_TSASUM-OSEL-NYINGTHIG-P12:400	bogs 'byin bzlas pa gnyis las /	40	bogs byin bzlas ba gnyis las 
BO_TZ_TSASUM-OSEL-NYINGTHIG-P12:401	dang po ni /	40	dang po ni 
BO_TZ_TSASUM-OSEL-NYINGTHIG-P12:402	thun gcig lha yi gsal snang sogs te de ltar bskyed rim gyi thun gcig lha yi gsal snang sgrub pa'i tshhe rnam pa gsal bas tha mal du snang ba'i rtogs pa sbyang /	40	thun gcig lha yi gsal snang sogs te de ltar skyed rim gyi thun gcig lha yi gsal snang sgrub ba tshhe rnam ba gsal ba tha mal du snang ba rtogs ba sbyong 
BO_TZ_TSASUM-OSEL-NYINGTHIG-P12:403	nga rgyal brtan pas lha bdag gnyis su med pa'i nges shes kyis bdag rtog gi 'khrul pa bshig	40	nga rgyal brtan ba lha bdag gnyis su med ba nges shes kyis bdag rtogs gi khrul ba jig 
BO_TZ_TSASUM-OSEL-NYINGTHIG-P12:404	/rnam dag dran pas bden 'dzin a 'thas kyi zhen pa sbyang ste gsal snang tshhad du 'don pa'i tshhul la thun dang por bslab ste /	40	dag dran ba bden dzin a thas kyi zhen ba sbyong ste gsal snang tshhad du don ba tshhul la thun dang por bslab ste 
BO_TZ_TSASUM-OSEL-NYINGTHIG-P12:405	yang thun gcig la de ltar gsal ba de yang sgrub pa'i thabs tshhul thams cad sgyu ma lta bu /	40	yang thun gcig la de ltar gsal ba de yang sgrub ba thabs tshhul thams cad sgyu ma lta bu 
BO_TZ_TSASUM-OSEL-NYINGTHIG-P12:406	ming tshhig smig rgyu /	40	ming tshhig smig rgyu 
BO_TZ_TSASUM-OSEL-NYINGTHIG-P12:407	spyod lam rmi lam /	40	spyod lam rmi lam 
BO_TZ_TSASUM-OSEL-NYINGTHIG-P12:408	dngos po gzugs brnyan /	40	dngos po gzugs rnyan 
BO_TZ_TSASUM-OSEL-NYINGTHIG-P12:409	gnas yul dri za'i grong khyer /	40	gnas yul dri za grong khyer 
BO_TZ_TSASUM-OSEL-NYINGTHIG-P12:410	sgra thams cad brag cha /	41	sgra thams cad brag cha 
BO_TZ_TSASUM-OSEL-NYINGTHIG-P12:411	lha sku chu zla /	41	lha sku chu zla 
BO_TZ_TSASUM-OSEL-NYINGTHIG-P12:412	ting 'dzin chu bur /	41	ting dzin chu bur 
BO_TZ_TSASUM-OSEL-NYINGTHIG-P12:413	'du 'phro mig yor /	41	du phro mig yor 
BO_TZ_TSASUM-OSEL-NYINGTHIG-P12:414	cho 'phrul sprul pa lta bur shes par byas te dam tshhig bcu'i sgo nas nyams su blangs pas /	41	cho phrul sprul ba lta bur shes ba byed te dam tshhig chu sgo nas nyams su blangs ba 
BO_TZ_TSASUM-OSEL-NYINGTHIG-P12:415	snang tsham ma 'gags pa las rang bzhin gang yang grub pa med pa'i stong pa'i bdag nyid du shes pa'i lta ba'i rgyas yis gdab /	41	snang tsham ma gag ba las rang bzhin gang yang grub ba med ba stong ba bdag nyid du shes ba lta ba rgya yis gdab 
BO_TZ_TSASUM-OSEL-NYINGTHIG-P12:416	thun gcig la snang yang rang bzhin ma grub pa /	41	thun gcig la snang yang rang bzhin ma grub ba 
BO_TZ_TSASUM-OSEL-NYINGTHIG-P12:417	gsal la 'dzin pa med pa /	41	gsal la dzin ba med ba 
BO_TZ_TSASUM-OSEL-NYINGTHIG-P12:418	bde la zhen pa med pa'i sgyu ma lta bu'i snang stong zung 'jug dbyer med kyi ting 'dzin la rtshal sbyang zhing nga rgyal bsgom /	41	bde la zhen ba med ba sgyu ma lta bu snang stong zung jug dbyer med kyi ting dzin la rtshal sbyong zhing nga rgyal bsgom 
BO_TZ_TSASUM-OSEL-NYINGTHIG-P12:419	thun gcig la snang grags rig pa thams cad lha dang zhing khams gsang sngags dang chos nyid du gdod nas gnas pa blos rtshol bas bkod ma dgos par /	41	thun gcig la snang grags rig ba thams cad lha dang zhing khams gsang sngags dang chos nyid du gdod nas gnas ba blos rtshol ba bkod ma dgos ba 
BO_TZ_TSASUM-OSEL-NYINGTHIG-P12:420	gnyis med rang rtshal ma bsgom lhun grub kyi bskyed rim du ma ro gcig rang bzhin yongs shes kyi lta ba rdzogs pa'i rim pas rtshis zin pa'i skyed rdzogs zung 'jug ro mnyam dgongs pa'i ngang du gnas pa ni /	42	gnyis med rang rtshal ma bsgom lhun grub kyi skyed rim du ma ro gcig rang bzhin yongs shes kyi lta ba rdzogs ba rim ba rtshis zin ba skyed rdzogs zung jug ro mnyam dgongs ba ngang du gnas ba ni 
BO_TZ_TSASUM-OSEL-NYINGTHIG-P12:421	bskyed rim gyi srog sdom gzer bzhi'i snying po yin pas de dag rim pa bzhin rtshal sbyang /	42	skyed rim gyi srog sdom gzer bzhi snying po yin ba de dag rim ba bzhin rtshal sbyong 
BO_TZ_TSASUM-OSEL-NYINGTHIG-P12:422	goms nas phrugs gcig tu nyams su len par bya'o //	42	goms nas phrug gcig tu nyams su len ba byed 
BO_TZ_TSASUM-OSEL-NYINGTHIG-P12:423	gnyis pa bogs 'byin bzlas pa ni /	42	gnyis ba bogs byin bzlas ba ni 
BO_TZ_TSASUM-OSEL-NYINGTHIG-P12:424	sgrar bcas sgra med bde chen rdo rjer bzlas :	42	sgrar cha sgra med bde chen rdo rjer bzlas 
BO_TZ_TSASUM-OSEL-NYINGTHIG-P12:425	zhes pa ste de ltar bskyed rim gyis gsal snang sgrub pa'i tshhe skyo ba'am /	42	zhes ba ste de ltar skyed rim gyis gsal snang sgrub ba tshhe skyo ba 
BO_TZ_TSASUM-OSEL-NYINGTHIG-P12:426	lha yi thugs rgyud bskul bas dngos grub mchog gi gnas la myur du sbyor ba'i phyir bogs 'byin bzlas pa bya dgos te /	42	lha yi thugs brgyud skul ba dngos grub mchog gi gnas la myur du sbyor ba phyir bogs byin bzlas ba byed dgos te 
BO_TZ_TSASUM-OSEL-NYINGTHIG-P12:427	de yang lha sngags gnyis med kyi nges shes dad pa brtan pos bsnyen sgrub las sbyor gyi sngags rnams lce mchu'i rtshol bas bzla ba ni ngag bzlas sgrar bcas dang / thugs srog sngags la sems 'dzin gyis yid bzlas sgra med /	42	de yang lha sngags gnyis med kyi nges shes dad ba brtan pos snyen sgrub las sbyor gyi sngags rnams lce mchu rtshol ba bzla ba ni ngag bzlas sgrar cha dang thugs srog sngags la sems dzin gyis yid bzlas sgra med 
BO_TZ_TSASUM-OSEL-NYINGTHIG-P12:428	rlung bum pa can dang sbyar ba'i bde chen 'gog bzlas /	42	rlung bum ba can dang sbyor ba bde chen gog bzlas 
BO_TZ_TSASUM-OSEL-NYINGTHIG-P12:429	'byin 'jug gnas gsum lha gang bsgrub de'i sngags sam rdo rje'i 'bru gsum du shes pas rdor bzlas sam /	42	byin jug gnas gsum lha gang sgrub de sngags sam rdo rje bru gsum du shes ba rdar bzlas sam 
BO_TZ_TSASUM-OSEL-NYINGTHIG-P12:430	bum pa can dang sbyar ba'i rdo rjer bzlas pa bya zhing /	43	bum ba can dang sbyor ba rdo rjer bzlas ba byed zhing 
BO_TZ_TSASUM-OSEL-NYINGTHIG-P12:431	bzlas dmigs kyi rim pa yang sgrub thabs so so'i gzhung ltar bya ba'o //	43	bzlas dmigs kyi rim ba yang sgrub thabs so so gzhung ltar byed ba 
BO_TZ_TSASUM-OSEL-NYINGTHIG-P12:432	bzhi pa lam gyi sbas don lam a nu'i dgongs pa ltar bshad pa la gnyis /	43	bzhi ba lam gyi sbed don lam a nu dgongs ba ltar chad ba la gnyis 
BO_TZ_TSASUM-OSEL-NYINGTHIG-P12:433	rang lus dang gzhan lus so //	43	rang lus dang gzhan lus so 
BO_TZ_TSASUM-OSEL-NYINGTHIG-P12:434	dang po la'ang sngon 'gro /	43	dang po la sngon gro 
BO_TZ_TSASUM-OSEL-NYINGTHIG-P12:435	dngos gzhi / lam gyi yan lag go	43	dngos gzhi lam gyi yan lag go 
BO_TZ_TSASUM-OSEL-NYINGTHIG-P12:436	/dang po ni /	43	po ni 
BO_TZ_TSASUM-OSEL-NYINGTHIG-P12:437	lus sbyong rnam pa sogs te /	43	lus sbyong rnam ba sogs te 
BO_TZ_TSASUM-OSEL-NYINGTHIG-P12:438	sbyang gzhi shin tu phra ba'i gnyug ma'i sgo gsum rdo rje gsum gyi bsgrub gzhi la /	43	sbyong gzhi shin tu phra ba gnyug ma sgo gsum rdo rje gsum gyi sgrub gzhi la 
BO_TZ_TSASUM-OSEL-NYINGTHIG-P12:439	sbyong byed kyi lam yang rtsha rlung thig le gsum la gnad du bsnun pas /	43	sbyong byed kyi lam yang rtsha rlung thig le gsum la gnad du snun ba 
BO_TZ_TSASUM-OSEL-NYINGTHIG-P12:440	sbyangs 'bras sku gsung thugs rdo rje gnyis su med pa mi slob zung 'jug gi go 'phang mngon du byed pa la /	44	sbyong bras sku gsung thugs rdo rje gnyis su med ba mi slob zung jug gi go phen mngon du byed ba la 
BO_TZ_TSASUM-OSEL-NYINGTHIG-P12:441	sngon 'gro lus sbyong gis rtsha yi mdud pa bshigs te ye shes kyi dbu ma'i sgo 'byed pa'i phyir rnam pa nyi shu'i 'phrul 'khor gsungs pa dang 'dir zhal rgyun sogs phyag bzhes dmigs bsal ma byung bas rigs mthun klong chen snying gi thig le'i rtsha rlung gi	44	sngon gro lus sbyong gis rtsha yi mdud ba bshigs te ye shes kyi dbu ma sgo byed ba phyir rnam ba nyi shu phrul khor gsungs ba dang dir zhal rgyun sogs phyag bzhes dmigs bsal ma byung ba rigs mthun klong chen snying gi thig le rtsha rlung gi 
BO_TZ_TSASUM-OSEL-NYINGTHIG-P12:442	'phrul 'khor nyi shu lta bu sbyor du rung bar snyam zhing /	44	phrul khor nyi shu lta bu sbyor du rung ba snyam zhing 
BO_TZ_TSASUM-OSEL-NYINGTHIG-P12:443	ngag sbyong gis las rlung gi rgyu ba 'ching zhing dbu mar zhugs gnas thim gsum gyis ye shes kyi rlung sgrub pa'i phyir 'bru gsum rdo rje'i bzlas pa ste de lam du byed pa dang / yid sbyong gis sems gzung 'dzin gyi rtog pa'i g.yo 'khrul zhi phyir phyi lus kyi stong ra rtsha gsum lhag pa'i lha gang yin de'i sku snang stong sgrib g.yogs dang bral pa dar gyi gur phub pa lta bu dang /	44	ngag sbyong gis las rlung gi rgyu ba ching zhing dbu mar jug gnas thim gsum gyis ye shes kyi rlung sgrub ba phyir bru gsum rdo rje bzlas ba ste de lam du byed ba dang yid sbyong gis sems gzung dzin gyi rtogs ba g.yo khrul zhi phyir phyi lus kyi stong ra rtsha gsum lhag ba lha gang yin de sku snang stong sgrib g.yogs dang bral ba dar gyi gur bubs ba lta bu dang 
BO_TZ_TSASUM-OSEL-NYINGTHIG-P12:444	nang rtsha yi stong ra sku dbus drang por rtsha dbu ma mtshhan nyid bzhi ldan /	44	nang rtsha yi stong ra sku dbus dren por rtsha dbu ma mtshhan nyid bzhi ldan 
BO_TZ_TSASUM-OSEL-NYINGTHIG-P12:445	g.yas g.yon du ro rkyang gi mar sna dbu ma'i nang lte 'og sor bzhi nas chud cing /	44	g.yas g.yon du ro rkyang gi mar sna dbu ma nang lte g sor bzhi nas chud cing 
BO_TZ_TSASUM-OSEL-NYINGTHIG-P12:446	yar sne ltag pa nas gug ste sna bug gnyis su chud pa /	44	yar sne ltag ba nas gug ste sna bug gnyis su chud ba 
BO_TZ_TSASUM-OSEL-NYINGTHIG-P12:447	de thams cad stong sangs 'od kyi sbu gu dwangs gsal sgrib g.yogs dang bral bar bsgom /	44	de thams cad stong sangs d kyi sbu gu dwangs gsal sgrib g.yogs dang bral ba bsgom 
BO_TZ_TSASUM-OSEL-NYINGTHIG-P12:448	gsang ba sems kyi stong ra sems dus gsum skye 'gag gnas bral dngos po mtshhan ma gang yang ma dmigs pa'i stong nyid mtha' dbus bral ba /	44	gsang ba sems kyi stong ra sems dus gsum skye gag gnas bral dngos po mtshhan ma gang yang ma dmigs ba stong nyid mtha dbus bral ba 
BO_TZ_TSASUM-OSEL-NYINGTHIG-P12:449	rol pa 'gag med du shar yang dmigs gtad dang bral ba bsgom pa la blo gzhag pa'o /	44	rol ba gag med du char yang dmigs gtod dang bral ba bsgom ba la blo jog ba 
BO_TZ_TSASUM-OSEL-NYINGTHIG-P12:450	/gnyis pa dngos gzhi ni /	45	ba dngos gzhi ni 
BO_TZ_TSASUM-OSEL-NYINGTHIG-P12:451	srog rtshol kha sbyor sogs ltar srog ni thig le rtshol ba rlung ste de gnyis rten brten pa yin pa gnad du bsnun pa rnam bcas kyi rnal 'byor te /	45	srog rtshol kha sbyor sogs ltar srog ni thig le rtshol ba rlung ste de gnyis rten rten ba yin ba gnad du snun ba rnam cha kyi rnal byor te 
BO_TZ_TSASUM-OSEL-NYINGTHIG-P12:452	de'i tshhul ni phyi snod nang bcud 'khor 'das kyi dwangs bcud thams cad kun la khyab cing shis pa'i nam mkha'i rlung kha dog mthing gsal gyi rnam pa la tshhe sgrub gtsho bor byed na tshhe yi bdud rtshi'i rnam pa /	45	de tshhul ni phyi snod nang bcud khor da kyi dwangs bcud thams cad kun la khyab cing shis ba nam mkha rlung kha dog mthing gsal gyi rnam ba la tshhe sgrub gtsho bor byed na tshhe yi bdud rtshi rnam ba 
BO_TZ_TSASUM-OSEL-NYINGTHIG-P12:453	dbang sdud skabs khams gsum skye 'gro thams cad dang gang dbang du bsdu bya nyid rlung sems dwangs ma'i thig le'i ngo bo nam mkha'i rlung gi rnam par rngub pa sogs dang /	45	dbang sdud skabs khams gsum skye gro thams cad dang gang dbang du sdud byed nyid rlung sems dwangs ma thig le ngo bo nam mkha rlung gi rnam ba rngub ba sogs dang 
BO_TZ_TSASUM-OSEL-NYINGTHIG-P12:454	mchog sgrub gtshor bor byed na bde chen lhan skyes ye shes kyi dwangs ma'i ngo bor sogs skabs thob dmigs pas kha bsgyur te /	45	mchog sgrub gtshor bor byed na bde chen lhan skye ye shes kyi dwangs ma ngo bor sogs skabs thob dmigs ba kha sgyur te 
BO_TZ_TSASUM-OSEL-NYINGTHIG-P12:455	snying dbus mi shigs pa'i thig le 'od lnga'i rnam par snying gar gsal bar thim par bsam la steng rlung rngub /	45	snying dbus mi shigs ba thig le d lnga rnam ba snying gar gsal ba thim ba bsam la steng rlung rngub 
BO_TZ_TSASUM-OSEL-NYINGTHIG-P12:456	'og rlung bskum la /	45	g rlung skum la 
BO_TZ_TSASUM-OSEL-NYINGTHIG-P12:457	lte bar kha sbyor du 'ching bas snang stong srid zhi'i chos la dbang bsgyur ba'i thabs kyi man ngag la gnad du bsnun pas /	45	lte ba kha sbyor du ching ba snang stong srid zhi chos la dbang sgyur ba thabs kyi man ngag la gnad du snun ba 
BO_TZ_TSASUM-OSEL-NYINGTHIG-P12:458	sbyor ba bzhi ldan gyis bum can rlung gi khug pa brgya'am bdun cu nyer gcig sogs thun re la gnad du bsnun pa srog rtshol kha sbyor rlung gi rnal 'byor dang / de la goms shing brtan pa dang rtsha 'khor lngar bla sgrub sgyu 'phrul drwa ba'i skabs /	45	sbyor ba bzhi ldan gyis bum can rlung gi khug ba brgya bdun cu nyer gcig sogs thun re la gnad du snun ba srog rtshol kha sbyor rlung gi rnal byor dang de la goms shing brtan ba dang rtsha khor lngar bla sgrub sgyu phrul drwa ba skabs 
BO_TZ_TSASUM-OSEL-NYINGTHIG-P12:459	rang chos sku rdo rje 'chang du gsal ba la thod phreng rigs lnga 'khor dpa' bo mkha' 'gro'i tshhom bu bcas gsungs pas mtshhon rtsha ba gsum so sor dmigs pa'i lde kha bsgyur te /	45	rang chos sku rdo rje chang du gsal ba la thod phreng rigs lnga khor dpa bo mkha gro tshhom bu cha gsungs ba mtshhon rtsha ba gsum so sor dmigs ba lde kha sgyur te 
BO_TZ_TSASUM-OSEL-NYINGTHIG-P12:460	dbu ma'i mar snar lte 'og tu a shad rlung gis bskul te 'bar ba'i drod kyi zegs mas spyi bor dbu ma'i yar snar ham yig mgo thur bstan la reg pas thig le'i dwangs ma'i zegs ma char ltar brul bas /	46	dbu ma mar snar lte g tu a shad rlung gis skul te bar ba drod kyi zegs mas spyi bor dbu ma yar snar ham yig mgo thur ston la reg ba thig le dwangs ma zegs ma char ltar brul ba 
BO_TZ_TSASUM-OSEL-NYINGTHIG-P12:461	spyi bo nas yas rim gyis babs pas 'bar 'dzag gi bde drod spel ba'i dga' bzhi'i nyams skyong bas dbang bzhi'i rtogs pa bskyed /	46	spyi bo nas yas rim gyis bab ba bar dzag gi bde drod spel ba dga bzhi nyams skyong ba dbang bzhi rtogs ba skyed 
BO_TZ_TSASUM-OSEL-NYINGTHIG-P12:462	sad rmi gnyid 'thug snyoms 'jug gi gnas skabs bzhi'i sgrib pa dag	46	sad rmi rnyid thug snyom jug gi gnas skabs bzhi sgrib ba dag 
BO_TZ_TSASUM-OSEL-NYINGTHIG-P12:463	/sku gsung thugs ye shes rdo rje bzhi'i bdag nyid du byin gyis brlabs /	46	gsung thugs ye shes rdo rje bzhi bdag nyid du byin gyis brlabs 
BO_TZ_TSASUM-OSEL-NYINGTHIG-P12:464	chos longs sprul gsum ngo bo nyid sku bzhi'i bdag nyid du byang chub par bsam zhing bde stong ye shes chen po'i ngo bo la blta /	46	chos longs sprul gsum ngo bo nyid sku bzhi bdag nyid du byang chub ba bsam zhing bde stong ye shes chen po ngo bo la lta 
BO_TZ_TSASUM-OSEL-NYINGTHIG-P12:465	slar yang mas brtan gyis kyang rtogs pa bskyed cing nyams bskyang /	46	slar yang mas brtan gyis kyang rtogs ba skyed cing nyams skyong 
BO_TZ_TSASUM-OSEL-NYINGTHIG-P12:466	thun gyi mthar thug pa na snod bcud thams cad rim par dwangs ma'i rlung sems kyi ngo bor bsdus nas 'od du zhu ba rang la thim /	46	thun gyi mthar thug ba na snod bcud thams cad rim ba dwangs ma rlung sems kyi ngo bor sdud nas d du ju ba rang la thim 
BO_TZ_TSASUM-OSEL-NYINGTHIG-P12:467	rang yang 'od gsal thig le chen po'i ngang du'am dbyings su bsdus shing thim par bsam la bzhag nas rlung rig gnyis med du bsre ba'i rnam med kyi rnal 'byor la rtshal 'don bya'o //	46	rang yang d gsal thig le chen po ngang du dbyings su sdud shing thim ba bsam la jog nas rlung rig gnyis med du bsre ba rnam med kyi rnal byor la rtshal don byed 
BO_TZ_TSASUM-OSEL-NYINGTHIG-P12:468	gsum pa lam gyi yan lag ni /	46	gsum ba lam gyi yan lag ni 
BO_TZ_TSASUM-OSEL-NYINGTHIG-P12:469	rjes thob nyin mtshhan sgyu ma'i lha skur ldang : zhes pa ltar dngos gzhi mnyam bzhag gi nyams myong bde gsal stong pa nyid kyi ting nge 'dzin gyis snang grags rig pa'i chos kun la rgyas btab ste /	46	rjes thob nyin mtshhan sgyu ma lha skur ldang zhes ba ltar dngos gzhi mnyam jog gi nyams myong bde gsal stong ba nyid kyi ting nge dzin gyis snang grags rig ba chos kun la rgya debs ste 
BO_TZ_TSASUM-OSEL-NYINGTHIG-P12:470	snang stong / grags stong /	47	snang stong grags stong 
BO_TZ_TSASUM-OSEL-NYINGTHIG-P12:471	rig stong sgyu ma rmi lam lta bu'i rjes thob tu zhen med sgyu ma'i lam khyer gyis nyin mtshhan sgyu ma'i lha skur ldang la /	47	rig stong sgyu ma rmi lam lta bu rjes thob tu zhen med sgyu ma lam khyer gyis nyin mtshhan sgyu ma lha skur ldang la 
BO_TZ_TSASUM-OSEL-NYINGTHIG-P12:472	bzang ngan gang la'ang ched 'dzin rtshis gdab re dogs mi byed par bzang ngan thams cad stong nyid nam mkha' lta bur lam du khyer /	47	bzang ngan gang la ched dzin rtshis gdab re dogs mi byed ba bzang ngan thams cad stong nyid nam mkha lta bur lam du khyer 
BO_TZ_TSASUM-OSEL-NYINGTHIG-P12:473	gzhan yang mtshhan mo'i rnal 'byor mgrin pa'i dbus su a yig dmar gsal la rlung sems bsdus te gnyid du 'gro bar byas pas 'od gsal zin pa dang / nyin par sgo gsum gyi bya spyod rmi lam du lam khyer sbyangs la /	47	gzhan yang mtshhan mo rnal byor mgrin ba dbus su a yig dmar gsal la rlung sems sdud te rnyid du gro ba byed ba d gsal zin ba dang nyin ba sgo gsum gyi byed spyod rmi lam du lam khyer sbyong la 
BO_TZ_TSASUM-OSEL-NYINGTHIG-P12:474	rmi lam 'dzin bsgyur sprul pa sogs 'dod na rdzogs rim spyi ltar lam gyi bogs 'byin du bya'o //	47	rmi lam dzin sgyur sprul ba sogs dod na rdzogs rim spyi ltar lam gyi bogs byin du byed 
BO_TZ_TSASUM-OSEL-NYINGTHIG-P12:475	gnyis pa gzhan lus ni /	47	gnyis ba gzhan lus ni 
BO_TZ_TSASUM-OSEL-NYINGTHIG-P12:476	dngos yid phyag rgya'i lam gyis bogs 'byin bya :	47	dngos yid phyag rgya lam gyis bogs byin byed 
BO_TZ_TSASUM-OSEL-NYINGTHIG-P12:477	zhes rang lus thabs kyi rnal 'byor gyis rlung sems las su rung bas lam la bogs 'byin pa'i slad dngos rig gam yid rig gi phyag rgya'i lam la bsten nas /	47	zhes rang lus thabs kyi rnal byor gyis rlung sems las su rung ba lam la bogs byin ba slad dngos rig gam yid rig gi phyag rgya lam la sten nas 
BO_TZ_TSASUM-OSEL-NYINGTHIG-P12:478	dpe yi thabs byas pa'i don gyi ye shes mngon du rtogs par byed pa'i thabs kyi nye rgyu la bogs 'don par bya ba'i phyir bslab pas /	47	dpe yi thabs byed ba don gyi ye shes mngon du rtogs ba byed ba thabs kyi nye rgyu la bogs don ba byed ba phyir bslab ba 
BO_TZ_TSASUM-OSEL-NYINGTHIG-P12:479	don dam ye shes kyi de nyid mngon du rtogs par byed pa'ang rang nyams dang bstun te nyams su len par bya'o //	47	don dam ye shes kyi de nyid mngon du rtogs ba byed ba rang nyams dang bstun te nyams su len ba byed 
BO_TZ_TSASUM-OSEL-NYINGTHIG-P12:480	lnga pa lam gyi man ngag 'bras bu rdzogs pa chen po shin tu rnal 'byor gyi nyams len la gsum /	48	lnga ba lam gyi man ngag bras bu rdzogs ba chen po shin tu rnal byor gyi nyams len la gsum 
BO_TZ_TSASUM-OSEL-NYINGTHIG-P12:481	skye 'chi bar do'i snang ba lam du khyer ba'o //	48	skye chi ba do snang ba lam du khyer ba 
BO_TZ_TSASUM-OSEL-NYINGTHIG-P12:482	dang po skye ba tshhe 'di'i nyams len la /	48	dang po skye ba tshhe di nyams len la 
BO_TZ_TSASUM-OSEL-NYINGTHIG-P12:483	lta ba ka dag gi nyams len dang / sgom pa lhun grub kyis bogs 'byin gnyis las /	48	lta ba ka dag gi nyams len dang sgom ba lhun grub kyis bogs byin gnyis las 
BO_TZ_TSASUM-OSEL-NYINGTHIG-P12:484	dang po ni /	48	dang po ni 
BO_TZ_TSASUM-OSEL-NYINGTHIG-P12:485	sgo gsum zhen log sogs nas /	48	sgo gsum zhen log sogs nas 
BO_TZ_TSASUM-OSEL-NYINGTHIG-P12:486	srang du gzhug :	48	srang du jug 
BO_TZ_TSASUM-OSEL-NYINGTHIG-P12:487	ces pa'i bar te /	48	ces ba ba te 
BO_TZ_TSASUM-OSEL-NYINGTHIG-P12:488	'di la'ang khyad par gyi sngon 'gros phyi nang gi 'khor 'das ru shan dbye ba dang / lus sbyong /	48	di la khyad ba gyi sngon gros phyi nang gi khor da ru shan byed ba dang lus sbyong 
BO_TZ_TSASUM-OSEL-NYINGTHIG-P12:489	ngag sbyong la rgyas gdab /	48	ngag sbyong la rgya gdab 
BO_TZ_TSASUM-OSEL-NYINGTHIG-P12:490	rtshal sbyang / mnyen btshal /	49	rtshal sbyong mnyen btshal 
BO_TZ_TSASUM-OSEL-NYINGTHIG-P12:491	lam gzhug bzhi /	49	lam jug bzhi 
BO_TZ_TSASUM-OSEL-NYINGTHIG-P12:492	sems sbyong bcas dang / sgo gsum rnal dbab dang / sor gzhug bcas bgyis pas rtshol bcas kyi bya ba la blo mi 'jug par zhen pa ldog pa dang / sngon 'gro de dag gis 'khrul pa'i bya spyod la snying po med par shes pas zhen pa log cing lus sems shin tu sbyangs pa'i yon tan skye ba zhi gnas kyi gzhi thengs pa la /	49	sems sbyong cha dang sgo gsum rnal bebs dang sor jug cha bgyid ba rtshol cha kyi byed ba la blo mi jug ba zhen ba ldog ba dang sngon gro de dag gis khrul ba byed spyod la snying po med ba shes ba zhen ba log cing lus sems shin tu sbyong ba yon tan skye ba zhi gnas kyi gzhi theng ba la 
BO_TZ_TSASUM-OSEL-NYINGTHIG-P12:493	sems kyi 'khrul pa'i khang bu byung gnas 'gro gsum tshhol bas bshig nas bral bar byas te /	49	sems kyi khrul ba khang bu byung gnas gro gsum tshhol ba jig nas bral ba byed te 
BO_TZ_TSASUM-OSEL-NYINGTHIG-P12:494	rig stong rjen pa ngo bo rang bzhin thugs rje gsum ldan gyi ye shes tshhig dang yid dpyod kyis ma bslad pa'i ye shes rjen pa 'phags pa'i rtogs rig mthar thug theg chen 'gog bden nyid lta bas ngo sprad cing shes par byas la /	49	rig stong rjen ba ngo bo rang bzhin thugs rje gsum ldan gyi ye shes tshhig dang yid dpyod kyis ma bslad ba ye shes rjen ba phag ba rtogs rig mthar thug theg chen gog bden nyid lta ba ngo sprod cing shes ba byed la 
BO_TZ_TSASUM-OSEL-NYINGTHIG-P12:495	lus gnad skyil krung mnyam gzhag gis mig mi g.yo bar thad kar gzhag la /	49	lus gnad skyil krung mnyam jog gis mig mi g.yo ba thad kar jog la 
BO_TZ_TSASUM-OSEL-NYINGTHIG-P12:496	tshhogs drug gi yul snang bzang ngan chags sdang 'dzin zhen gyi 'khrul rtog gis bcas bcos spro bsdu gang gis kyang bcos bslad dang bral ba'i ngang du ma bcos pa rig stong rjen pa'i klong du mnyam par bzhag pas /	49	tshhogs drug gi yul snang bzang ngan chags sdang dzin zhen gyi khrul rtogs gis cha chos spro sdud gang gis kyang chos bslad dang bral ba ngang du ma chos ba rig stong rjen ba klong du mnyam ba jog ba 
BO_TZ_TSASUM-OSEL-NYINGTHIG-P12:497	ci zhig na sems kyi 'jur mdud zhig pa'i chos nyid gnyug ma'i ngang du bzhag pa ni gnad kyi nyams len snying po'i srog tig ste /	49	ci jig na sems kyi jur mdud jig ba chos nyid gnyug ma ngang du jog ba ni gnad kyi nyams len snying po srog tig ste 
BO_TZ_TSASUM-OSEL-NYINGTHIG-P12:498	de'i tshhe rtog pa bzang ngan gang byung yang ched du mi bkag cing bzo bcos mi bya /	49	de tshhe rtogs ba bzang ngan gang byung yang ched du mi gog cing bzo chos mi byed 
BO_TZ_TSASUM-OSEL-NYINGTHIG-P12:499	ma bcos gnyug ma'i lta ba dang ma bral bar bskyangs pas rtshal gyi 'phro 'du thams cad kyis phan gnod bsgyur bcos gang yang mi nus par gzhi thim la song ba'i gnad ngos zin te /	49	ma chos gnyug ma lta ba dang ma bral ba skyong ba rtshal gyi phro du thams cad kyis phan gnod sgyur chos gang yang mi nus ba gzhi thim la gro ba gnad ngos zin te 
BO_TZ_TSASUM-OSEL-NYINGTHIG-P12:500	rgan pos bu chung gi spyod pa mthong ba ltar rtshis gdab med par skyong bas goms pa brtan pa'i tshhe /	50	rgan pos bu chung gi spyod ba mthong ba ltar rtshis gdab med ba skyong ba goms ba brtan ba tshhe 
BO_TZ_TSASUM-OSEL-NYINGTHIG-P12:501	snang spyod thams cad la chos nyid 'dra ba'i ye shes kho nar gdeng 'cha' nus kyi bar bslab cing nyin mtshhan 'od gsal gyi 'khor lor spyod pa'i man ngag	50	snang spyod thams cad la chos nyid dra ba ye shes kho nar gdeng cha nus kyi ba bslab cing nyin mtshhan d gsal gyi khor lor spyod ba man ngag 
BO_TZ_TSASUM-OSEL-NYINGTHIG-P12:502	/nyin par dbyings rig zung 'jug lta sgom spyod pa ye shes gcig gi rang bzhin du dag par lam khyer dang / srod la dbang po gnad du bsdu bas shes pa nang du bsdu ba dang / nam gung shes bya bum par gzhug pa /	50	ba dbyings rig zung jug lta sgom spyod ba ye shes gcig gi rang bzhin du dag ba lam khyer dang srod la dbang po gnad du sdud ba shes ba nang du sdud ba dang nam gung shes byed bum ba jug ba 
BO_TZ_TSASUM-OSEL-NYINGTHIG-P12:503	tho rangs ye shes rang gsal gdab pa'i rnal 'byor bzhi'i sgo nas mtshhan bcas dang mtshhan med kyi dge sbyor thams cad chos nyid yang dag gi nyams len gyi srang du gzhug nas grogs su 'gyur bar bslab bo //	50	tho rangs ye shes rang gsal gdab ba rnal byor bzhi sgo nas mtshhan cha dang mtshhan med kyi dge sbyor thams cad chos nyid yang dag gi nyams len gyi srang du jug nas grogs su gyur ba bslab bo 
BO_TZ_TSASUM-OSEL-NYINGTHIG-P12:504	gnyis pa sgom pa lhun grub kyis bogs 'byin ni /	50	gnyis ba sgom ba lhun grub kyis bogs byin ni 
BO_TZ_TSASUM-OSEL-NYINGTHIG-P12:505	lhun grub sgo yul rlung sogs nas /	50	lhun grub sgo yul rlung sogs nas 
BO_TZ_TSASUM-OSEL-NYINGTHIG-P12:506	mngon du 'gyur :	50	mngon du gyur 
BO_TZ_TSASUM-OSEL-NYINGTHIG-P12:507	zhes pa ste /	50	zhes ba ste 
BO_TZ_TSASUM-OSEL-NYINGTHIG-P12:508	'od gsal lhun grub kyi snang ba rig rtshal ma 'gags pa'i 'char cha yin yang /	50	d gsal lhun grub kyi snang ba rig rtshal ma gag ba char cha yin yang 
BO_TZ_TSASUM-OSEL-NYINGTHIG-P12:509	rdo rje'i lus la rten brten par 'brel ba'i rtsha rlung thig le rnams gnad du gcun te dbyings rig gzir na 'od gsal snang bzhi'i ye shes gong 'phel du 'gyur bas /	50	rdo rje lus la rten rten ba brel ba rtsha rlung thig le rnams gnad du jun te dbyings rig gzir na d gsal snang bzhi ye shes gong phel du gyur ba 
BO_TZ_TSASUM-OSEL-NYINGTHIG-P12:510	ye shes 'char ba'i sgo mig gzigs stangs gsum /	51	ye shes char ba sgo mig gzigs stangs gsum 
BO_TZ_TSASUM-OSEL-NYINGTHIG-P12:511	ye shes kyi rten rtsha ka ti shel sbug 'ching ba'i phyir lus bzhugs stangs gsum dang ma bral bas /	51	ye shes kyi rten rtsha ka ti shel sbug ching ba phyir lus bzhugs stangs gsum dang ma bral ba 
BO_TZ_TSASUM-OSEL-NYINGTHIG-P12:512	gnas g.ya' gangs kyi khrod sogs 'du 'dzi med cing nyi zla 'char snga nub phyi ba'i dben par sgo gsum gyi bya ba dgu phrugs su btang nas /	51	gnas g.ya gangs kyi khrod sogs du dzi med cing nyi zla char snga nub phyi ba dben ba sgo gsum gyi byed ba dgu phrug su gtong nas 
BO_TZ_TSASUM-OSEL-NYINGTHIG-P12:513	ye shes 'char ba'i yul nam mkha' slad byed kyi skyon gsum dang bral bar nyi zla 'char nub kyi zer gnyis la thog mar brten cing /	51	ye shes char ba yul nam mkha slad byed kyi skyon gsum dang bral ba nyi zla char nub kyi zer gnyis la thogs mar rten cing 
BO_TZ_TSASUM-OSEL-NYINGTHIG-P12:514	goms nas nyin mtshhan bar ma chad du rlung kha nas dal gyis rgyu zhing cung zad phyir 'dzin byas te /	51	goms nas nyin mtshhan ba ma chad du rlung kha nas dal gyis rgyu zhing cung zad phyir dzin byed te 
BO_TZ_TSASUM-OSEL-NYINGTHIG-P12:515	rig pa 'phro rgod kyi rkyen dang bral bar gnad du gcun pas /	51	rig ba phro rgod kyi rkyen dang bral ba gnad du jun ba 
BO_TZ_TSASUM-OSEL-NYINGTHIG-P12:516	phyi nang gi dbyings snang 'ja' zer dang po 'char ba'i steng du rdo rje lu gu rgyud dang thig le gsum 'brel tshhun chad du 'char ba'i tshhe /	51	phyi nang gi dbyings snang ja zer dang po char ba steng du rdo rje lu gu brgyud dang thig le gsum brel tshhun chad du char ba tshhe 
BO_TZ_TSASUM-OSEL-NYINGTHIG-P12:517	thig le'i ra bar rig pa rdo rje lu gu rgyud mi g.yo bar gzir zhing bskyangs pas nang du chos nyid rjen pa'i ye shes kyi myong ba shar ba chos nyid mngon sum /	51	thig le ra ba rig ba rdo rje lu gu brgyud mi g.yo ba gzir zhing skyong ba nang du chos nyid rjen ba ye shes kyi myong ba char ba chos nyid mngon sum 
BO_TZ_TSASUM-OSEL-NYINGTHIG-P12:518	de ltar goms pa'i snang ba'i nyams 'ja' zer thig les rgya che ba yul gru tsham khyab cing /	51	de ltar goms ba snang ba nyams ja zer thig les rgya che ba yul gru tsham khyab cing 
BO_TZ_TSASUM-OSEL-NYINGTHIG-P12:519	thig le lnga tshhom gyi klong ngam nang du sangs rgyas sprul pa'i sku'i gtshug tor zhal phyag thams cad dang / sku yum dang / rgyan phyag mtshhan med pa 'char ba nyams snang gong 'phel gyi snang ba sprul sku'i tshhom bu 'char ba dang / snang yul thams cad rigs lnga ye shes kyi 'khor lo zhi khro longs spyod rdzogs par 'char nas snod bcud ma dag pa'i snang ba nub cing /	51	thig le lnga tshhom gyi klong ngam nang du sangs rgya sprul ba sku gtshug tor zhal phyag thams cad dang sku yum dang rgyan phyag mtshhan med ba char ba nyams snang gong phel gyi snang ba sprul sku tshhom bu char ba dang snang yul thams cad rigs lnga ye shes kyi khor lo zhi khro longs spyod rdzogs ba char nas snod bcud ma dag ba snang ba nub cing 
BO_TZ_TSASUM-OSEL-NYINGTHIG-P12:520	dgongs pa chos nyid las mi g.yo ba'i gdeng khel ba rig pa tshhad la phebs pa dag pa rab 'byams kyis 'khor ba'i 'khrul rtog gzhi rtsha dang bcas pa dag ste snang ba'i 'phel rdzogs nas /	52	dgongs ba chos nyid las mi g.yo ba gdeng khel ba rig ba tshhad la phebs ba dag ba rab byam kyis khor ba khrul rtogs gzhi rtsha dang cha ba dag ste snang ba phel rdzogs nas 
BO_TZ_TSASUM-OSEL-NYINGTHIG-P12:521	chos can kun rdzob kyi snang cha chos nyid gting gsal gyi sbubs su zad cing sdud pas blo las 'das shing bral ba gdod ma'i gzhi klong du 'ub chub pa'i dgongs par gdeng khel ba dag ni /	52	chos can kun rdzob kyi snang cha chos nyid gting gsal gyi sbub su zad cing sdud ba blo las da shing bral ba gdod ma gzhi klong du ub chub ba dgongs ba gdeng khel ba dag ni 
BO_TZ_TSASUM-OSEL-NYINGTHIG-P12:522	snang bzhi mthar son chos zad kyi rnal 'byor zhes rten 'dir 'bras bu'i mthar thug gi go 'phang mngon du gyur pas sa lam mthar phyin pa'o //	52	snang bzhi mthar son chos zad kyi rnal byor zhes rten dir bras bu mthar thug gi go phen mngon du gyur ba sa lam mthar phyin ba 
BO_TZ_TSASUM-OSEL-NYINGTHIG-P12:523	gnyis pa 'chi ba'i sun ma lam khyer gyi gdam pa ni /	52	gnyis ba chi ba sun ma lam khyer gyi gdam ba ni 
BO_TZ_TSASUM-OSEL-NYINGTHIG-P12:524	gal te tshhe 'dir sogs nas /	52	gal te tshhe dir sogs nas 
BO_TZ_TSASUM-OSEL-NYINGTHIG-P12:525	rnam par 'pho :	52	rnam ba pho 
BO_TZ_TSASUM-OSEL-NYINGTHIG-P12:526	zhes pa ste /	52	zhes ba ste 
BO_TZ_TSASUM-OSEL-NYINGTHIG-P12:527	dbang po 'bring dag gal te tshhe 'dir grol tshhad kyi grub mtha' mngon du ma gyur nas gdod ma'i sa la ma snyogs na /	52	dbang po bring dag gal te tshhe dir grol tshhad kyi grub mtha mngon du ma gyur nas gdod ma sa la ma snyogs na 
BO_TZ_TSASUM-OSEL-NYINGTHIG-P12:528	da lta goms pa'i 'od gsal skyel ma lta bu dang 'chi kha'i tshhe bar do dang po'i rig stong 'od gsal gyi snang ba sun ma lta bu gnyis nang 'dzom ste /	52	da lta goms ba d gsal skyel ma lta bu dang chi kha tshhe ba do dang po rig stong d gsal gyi snang ba sun ma lta bu gnyis nang dzom ste 
BO_TZ_TSASUM-OSEL-NYINGTHIG-P12:529	tshhes bco lnga'i nyi ma nub pa dang zla ba shar ba'i dus mnyam pa lta bu'i gzhi lam gyi 'od gsal ma bu 'phrad nas grol ba mngon du bya ba 'od gsal sbubs su 'jug pa dang / de'i don da lta'ang rig pa mig	52	tshhes chos lnga nyi ma nub ba dang zla ba char ba dus mnyam ba lta bu gzhi lam gyi d gsal ma bu phrad nas grol ba mngon du byed ba d gsal sbub su jug ba dang de don da lta rig ba mig 
BO_TZ_TSASUM-OSEL-NYINGTHIG-P12:530	/mig dbyings rig gam nam mkha' la gtad de bsre ba'i ngang nas sbyang ba dang / 'chi ba'i tshhe bla ma mched grogs kyis ngo sprod gdab pa dang / dus ma yin pa'i 'chi ba bslu ba'i man ngag dang / dus la babs na tshhe 'di'i 'khri ba gcad cing blo ma 'phreng bas 'chi srid kyi gdams pa gsal 'debs bya ba dang /	53	dbyings rig gam nam mkha la gtod de bsre ba ngang nas sbyong ba dang chi ba tshhe bla ma mched grogs kyis ngo sprod gdab ba dang dus ma yin ba chi ba bslu ba man ngag dang dus la bab na tshhe di khri ba gcod cing blo ma phreng ba chi srid kyi doms ba gsal debs byed ba dang 
BO_TZ_TSASUM-OSEL-NYINGTHIG-P12:531	nyams chag bshags pa sogs bya /	53	nyams chag chags ba sogs byed 
BO_TZ_TSASUM-OSEL-NYINGTHIG-P12:532	de tsham gdeng du ma khel na rang gi gzhi lus bla ma rtsha gsum gang mos su gsal ba'i lus dbus rtsha dbu ma lte ba nas spyi bor zug pa'i snying dbus su rlung sems dbyer med dwangs ma'i ngo bo yi ge hrihyig gi rnam par gsal zhing	53	de tsham gdeng du ma khel na rang gi gzhi lus bla ma rtsha gsum gang mos su gsal ba lus dbus rtsha dbu ma lte ba nas spyi bor zug ba snying dbus su rlung sems dbyer med dwangs ma ngo bo yi ge hrihyig gi rnam ba gsal zhing 
BO_TZ_TSASUM-OSEL-NYINGTHIG-P12:533	/ spyi bor bla ma dang gnyis su med pa'i snang ba mtha' yas gsal ba la mos gus bskyed te hika? gi sgras yang yang 'pho bas /	53	spyi bor bla ma dang gnyis su med ba snang ba mtha yas gsal ba la mos gus skyed te hika? gi sgras yang yang pho ba 
BO_TZ_TSASUM-OSEL-NYINGTHIG-P12:534	da lta rtags 'byongs par sbyangs nas 'chi ba'i tshhe las la sbyar ba rlung sems gong du 'pho ba'i man ngag la brten nas dag pa'i zhing du 'pho bar bya'o //	53	da lta rtags byong ba sbyong nas chi ba tshhe las la sbyor ba rlung sems gong du pho ba man ngag la rten nas dag ba zhing du pho ba byed 
BO_TZ_TSASUM-OSEL-NYINGTHIG-P12:535	gsum pa bar do'i lam khyer ni /	53	gsum ba ba do lam khyer ni 
BO_TZ_TSASUM-OSEL-NYINGTHIG-P12:536	bar do rnam gsum sku gsum lam du khyer :	53	ba do rnam gsum sku gsum lam du khyer 
BO_TZ_TSASUM-OSEL-NYINGTHIG-P12:537	sa ma ya :	53	sa ma ya 
BO_TZ_TSASUM-OSEL-NYINGTHIG-P12:538	zhes pa ste /	53	zhes ba ste 
BO_TZ_TSASUM-OSEL-NYINGTHIG-P12:539	skye 'chi'i mtshhan ma dbyings su dag pas rten 'dir grol ba'i gdeng ma 'thob na bar do dang por 'chi ba chos sku /	53	skye chi mtshhan ma dbyings su dag ba rten dir grol ba gdeng ma thob na ba do dang por chi ba chos sku 
BO_TZ_TSASUM-OSEL-NYINGTHIG-P12:540	gnyis pa chos nyid bar dor 'od gsal lhun grub longs sku zhi khro'i snang ba /	54	gnyis ba chos nyid ba dor d gsal lhun grub longs sku zhi khro snang ba 
BO_TZ_TSASUM-OSEL-NYINGTHIG-P12:541	gsum pa srid pa bar do rlung sems kyi gzhan dbang sprul skur lam du khyer ba rnam pa gsum po gang la yang ste /	54	gsum ba srid ba ba do rlung sems kyi gzhan dbang sprul skur lam du khyer ba rnam ba gsum po gang la yang ste 
BO_TZ_TSASUM-OSEL-NYINGTHIG-P12:542	spyir bar do'i snang ba thams cad rang snang rig pa'i rtshal gyi rol pa las ma 'das pas dang por ngo shes /	54	spyir ba do snang ba thams cad rang snang rig ba rtshal gyi rol ba las ma da ba dang por ngo shes 
BO_TZ_TSASUM-OSEL-NYINGTHIG-P12:543	shes thog tu gzhag	54	shes thogs tu jog 
BO_TZ_TSASUM-OSEL-NYINGTHIG-P12:544	/bzhag thog tu gzhi med la grol /	54	thogs tu gzhi med la grol 
BO_TZ_TSASUM-OSEL-NYINGTHIG-P12:545	grol thog la gdeng khel nas phyir mi ldog pa'i dbyings su btshan sa zin pas sku gsum gyi sa la grol ba ste /	54	grol thogs la gdeng khel nas phyir mi ldog ba dbyings su btshan sa zin ba sku gsum gyi sa la grol ba ste 
BO_TZ_TSASUM-OSEL-NYINGTHIG-P12:546	snang ba'i 'char tshhul re re bzhin lam du byed cing khyer tshhul sogs khrid gzhung gzhan las 'byung ba ltar shes par bya'o //	54	snang ba char tshhul re re bzhin lam du byed cing khyer tshhul sogs khrid gzhung gzhan las byung ba ltar shes ba byed 
BO_TZ_TSASUM-OSEL-NYINGTHIG-P12:547	gsum pa rjes lam kun gyi grol tshhad bstan pa ni /	54	gsum ba rjes lam kun gyi grol tshhad ston ba ni 
BO_TZ_TSASUM-OSEL-NYINGTHIG-P12:548	thun mong grub pa sogs nas brda thim :	54	thun mong grub ba sogs nas brda thim 
BO_TZ_TSASUM-OSEL-NYINGTHIG-P12:549	bar te de ltar nyams su blangs par byas pas /	54	ba te de ltar nyams su blangs ba byed ba 
BO_TZ_TSASUM-OSEL-NYINGTHIG-P12:550	bskyed rim la gtsho bor brten pas ni rdo rje gur las /	55	skyed rim la gtsho bor rten ba ni rdo rje gur las 
BO_TZ_TSASUM-OSEL-NYINGTHIG-P12:551	gang phyir des ni dka' ba min //	55	gang phyir des ni dka ba min 
BO_TZ_TSASUM-OSEL-NYINGTHIG-P12:552	mig sman dang ni rkang mgyogs dang // ral gri dang ni sa 'og grub //	55	mig sman dang ni rkang mgyog dang ral gri dang ni sa g grub 
BO_TZ_TSASUM-OSEL-NYINGTHIG-P12:553	ril bu dang ni mkha' spyod nyid //	55	ril bu dang ni mkha spyod nyid 
BO_TZ_TSASUM-OSEL-NYINGTHIG-P12:554	mi snang ba dang bcud kyis len //	55	mi snang ba dang bcud kyis len 
BO_TZ_TSASUM-OSEL-NYINGTHIG-P12:555	gang phyir des ni rdo rje 'dzin //	55	gang phyir des ni rdo rje dzin 
BO_TZ_TSASUM-OSEL-NYINGTHIG-P12:556	mnyes par byas las myur du thob //	55	mnyes ba byed las myur du thob 
BO_TZ_TSASUM-OSEL-NYINGTHIG-P12:557	ces gsungs pa ltar thun mong gi grub pa brgyad dang / 'jigs pa brgyad zhi ba /	55	ces gsungs ba ltar thun mong gi grub ba brgyad dang jigs ba brgyad zhi ba 
BO_TZ_TSASUM-OSEL-NYINGTHIG-P12:558	'byor drug rgyas pa /	55	byor drug rgya ba 
BO_TZ_TSASUM-OSEL-NYINGTHIG-P12:559	mos pa bzhis skye 'gro dbang du bya ba /	55	mos ba bzhis skye gro dbang du byed ba 
BO_TZ_TSASUM-OSEL-NYINGTHIG-P12:560	drag shul gyi las chen bcu gnyis kyis dgra bgegs 'dul ba sogs thun mong gi phrin las bzhi dang / tshhogs sbyor dang mthun pa'i rnam smin /	56	drag shul gyi las chen chu gnyis kyis dgra bgegs dul ba sogs thun mong gi phrin las bzhi dang tshhogs sbyor dang mthun ba rnam smin 
BO_TZ_TSASUM-OSEL-NYINGTHIG-P12:561	mthong lam tshhe dbang /	56	mthong lam tshhe dbang 
BO_TZ_TSASUM-OSEL-NYINGTHIG-P12:562	dag sa gsum phyag chen /	56	dag sa gsum phyag chen 
BO_TZ_TSASUM-OSEL-NYINGTHIG-P12:563	rgyun mtha'am sku lnga lhun grub kyi rig 'dzin mngon du gyur pas sa lam yongs su rdzogs pa mchog gi dngos grub thob pa dang / rdzogs rim la gtsho bor brten pas ni /	56	rgyun mtha sku lnga lhun grub kyi rig dzin mngon du gyur ba sa lam yongs su rdzogs ba mchog gi dngos grub thob ba dang rdzogs rim la gtsho bor rten ba ni 
BO_TZ_TSASUM-OSEL-NYINGTHIG-P12:564	bde stong mtshhan bcas kyi rdzogs rim gyis dbu ma'i mdud pa nyer gcig grol te gnyug ma'i rdo rje gsum mngon du gyur pas bde stong lhan skyes kyi ye shes dang mngon shes dang rdzu 'phrul la dbang 'byor ba dang / mtshhan med rdzogs pa chen po'i lam nas blo bral chos nyid gnyug ma'i dgongs pa khyab brdal klong du grol te 'od gsal bsam mi khyab pa'i gsang mdzod la spyod pas /	56	bde stong mtshhan cha kyi rdzogs rim gyis dbu ma mdud ba nyer gcig grol te gnyug ma rdo rje gsum mngon du gyur ba bde stong lhan skye kyi ye shes dang mngon shes dang rdzu phrul la dbang byor ba dang mtshhan med rdzogs ba chen po lam nas blo bral chos nyid gnyug ma dgongs ba khyab rdal klong du grol te d gsal bsam mi khyab ba gsang mdzod la spyod ba 
BO_TZ_TSASUM-OSEL-NYINGTHIG-P12:565	sku dang ye shes kyi chos khams rgya mtshho lta bur dbang 'byor nas nam mkha' ji srid bar sems can gyi don byed pa'i phrin las lhun gyis grub pa'i 'bras bu la dbang 'byor ba nges par 'grub pa'o //	56	sku dang ye shes kyi chos khams rgya mtshho lta bur dbang byor nas nam mkha ji srid ba sems can gyi don byed ba phrin las lhun gyis grub ba bras bu la dbang byor ba nges ba grub ba 
BO_TZ_TSASUM-OSEL-NYINGTHIG-P12:566	'od gsal gsang ba chen po'i ye shes mchog	56	d gsal gsang ba chen po ye shes mchog 
BO_TZ_TSASUM-OSEL-NYINGTHIG-P12:567	/'od gsal dgongs pa mngon byed rdo rje'i tshhig	56	gsal dgongs ba mngon byed rdo rje tshhig 
BO_TZ_TSASUM-OSEL-NYINGTHIG-P12:568	/'od gsal snying gi ti ga'i dgongs pa'i bcud //	56	gsal snying gi ti ga dgongs ba bcud 
BO_TZ_TSASUM-OSEL-NYINGTHIG-P12:569	'od gsal ye shes nyin byed 'dir gsal mthus //	56	d gsal ye shes nyin byed dir gsal mthus 
BO_TZ_TSASUM-OSEL-NYINGTHIG-P12:570	'od gsal bstan pa'i shing rta phyogs kun 'dren //	57	d gsal ston ba shing rta phyogs kun bgrang 
BO_TZ_TSASUM-OSEL-NYINGTHIG-P12:571	'od gsal dbyings su 'gro kun ngal 'tshhos te //	57	d gsal dbyings su gro kun ngal tshhos te 
BO_TZ_TSASUM-OSEL-NYINGTHIG-P12:572	'od gsal bsam mi khyab pa'i gzhi klong du //	57	d gsal bsam mi khyab ba gzhi klong du 
BO_TZ_TSASUM-OSEL-NYINGTHIG-P12:573	'od gsal rdo rje'i lam 'dis khrid gyur cig	57	d gsal rdo rje lam dis khrid gyur cig 
BO_TZ_TSASUM-OSEL-NYINGTHIG-P12:574	/'od gsal snang bzhi'i ltad mor 'byams klas pa'i //	57	gsal snang bzhi ltad mor byam klas ba 
BO_TZ_TSASUM-OSEL-NYINGTHIG-P12:575	'od gsal snying po'i rnal 'byor bdag gyur nas //	57	d gsal snying po rnal byor bdag gyur nas 
BO_TZ_TSASUM-OSEL-NYINGTHIG-P12:576	'od gsal 'ba' zhig 'char ba'i dben gnas su //	57	d gsal ba jig char ba dben gnas su 
BO_TZ_TSASUM-OSEL-NYINGTHIG-P12:577	'od gsal grub pa'i dga' ston spyod gyur cig	57	d gsal grub ba dga ston spyod gyur cig 
BO_TZ_TSASUM-OSEL-NYINGTHIG-P12:578	/ces pa'ang 'od gsal rdo rje snying po'i bstan pa'i mnga' bdag rig 'dzin mkhas dang grub brgya'i gtshug rgyan kun mkhyen 7'jam pa'i dbyangs chos kyi blo gros rin po ches tshhul 'dis smin grol zab mo'i skal bzang la sbyor ba'i tshhe /	57	ba d gsal rdo rje snying po ston ba mnga bdag rig dzin mkhas dang grub brgya gtshug rgyan kun mkhyen 7jam ba dbyangs chos kyi blo gros rin po ches tshhul dis smin grol zab mo skal bzang la sbyor ba tshhe 
BO_TZ_TSASUM-OSEL-NYINGTHIG-P12:579	man ngag 'ja' lus rdo rje'i tshhig rkang 'di dgyes pa chen pos ljags bshad bka' drin bstshal pa'i skabs /	57	man ngag ja lus rdo rje tshhig rkang di dgyes ba chen pos ljags chad bka drin bstshal ba skabs 
BO_TZ_TSASUM-OSEL-NYINGTHIG-P12:580	gter chen rol pa'i rdo rje'i mchog sprul rin po che karma dri med 'od zer nas bla ma'i zhal rgyun zin bris su 'god par gal che zhes bka' nan yang yang bstshal pa dang / khrid rgyun mi chad pa la phan phyir 'di ltar bris zhes 'khor lo'i mgon pos kyang rten dang bcas bka' yi gnang ba thob pa bzhin /	58	gter chen rol ba rdo rje mchog sprul rin po che karma dri med d zer nas bla ma zhal rgyun zin bri su god ba gal che zhes bka nan yang yang bstshal ba dang khrid rgyun mi chad ba la phan phyir di ltar bri zhes khor lo mgon pos kyang rten dang cha bka yi gnang ba thob ba bzhin 
BO_TZ_TSASUM-OSEL-NYINGTHIG-P12:581	'dus gsal snying po mdo tsham du sngags rig 'dzin pa'i gzugs brnyan 'jigs med mkhyen brtshe'i 'od zer bkra shis dpal 'byor du 'bod pas /	58	du gsal snying po mdo tsham du sngags rig dzin ba gzugs rnyan jigs med mkhyen brtshe d zer bkra shis dpal byor du bod ba 
BO_TZ_TSASUM-OSEL-NYINGTHIG-P12:582	'dan ljongs lha dkar ri khrod g.yu shug zil pa mtha' yas tshhal du 'khrigs pa'i dben gnas su mig sman thig le'i lding gur la brten pa'i skabs bris pa /	58	dan ljongs lha dkar ri khrod g.yu shug zil ba mtha yas tshhal du khrig ba dben gnas su mig sman thig le lding gur la rten ba skabs bri ba 
BO_TZ_TSASUM-OSEL-NYINGTHIG-P12:583	slar yang gsal bar byas pas zab gsang rdo rje snying po'i bstan pa dar rgyas yun ring du gnas pa'i rgyur gyur cig	58	slar yang gsal ba byed ba zab gsang rdo rje snying po ston ba dar rgya yun ring du gnas ba rgyur gyur cig 
