segmentnr	original	folio	stemmed
BO_TZ_PEMA-SANGTHIG-P32:0	@#// bla ma'i thugs sgrub pad+ma gsang ba'i thig le las /	0	bla ma thugs sgrub pad+ma gsang ba thig le las 
BO_TZ_PEMA-SANGTHIG-P32:1	rtsha ba'i dbang bskur rgyas pa'i cho ga bklag chog tu bsdebs pa ye shes chu rgyun zhes bya ba bzhugs so //	0	rtsha ba dbang skur rgya ba cho ga klog chog tu sdeb ba ye shes chu rgyun zhes byed ba bzhugs so 
BO_TZ_PEMA-SANGTHIG-P32:2	na mo rat+na gu ru pad+maka ra ye /	0	na mo rat+na gu ru pad+maka ra ye 
BO_TZ_PEMA-SANGTHIG-P32:3	kun khyab chos kyi sku las dgongs brgyud dang // lhun grub longs spyod rdzogs las brda' yi brgyud //	0	kun khyab chos kyi sku las dgongs brgyud dang lhun grub longs spyod rdzogs las brda yi brgyud 
BO_TZ_PEMA-SANGTHIG-P32:4	thugs rje'i rig rtshal gang zag snyan brgyud de //	0	thugs rje rig rtshal gang zag snyan brgyud de 
BO_TZ_PEMA-SANGTHIG-P32:5	brgyud gsum rig 'dzin bla mas shis pa stshol //	0	brgyud gsum rig dzin bla mas shis ba stshol 
BO_TZ_PEMA-SANGTHIG-P32:6	rtsha gsum kun 'dus pad+ma sam b+ha wa'i //	0	rtsha gsum kun du pad+ma sam b+ha wa 
BO_TZ_PEMA-SANGTHIG-P32:7	dgongs bcud mthar thug pad+ma zab pa yi //	0	dgongs bcud mthar thug pad+ma zab ba yi 
BO_TZ_PEMA-SANGTHIG-P32:8	spros bcas spros med shin tu rab spros med //	0	spros cha spros med shin tu rab spros med 
BO_TZ_PEMA-SANGTHIG-P32:9	smin byed ye shes chu rgyun khrigs su bsdeb //	0	smin byed ye shes chu rgyun khrigs su sdeb 
BO_TZ_PEMA-SANGTHIG-P32:10	'di la gsum sbyor dngos rjes so //	1	di la gsum sbyor dngos rjes so 
BO_TZ_PEMA-SANGTHIG-P32:11	dang po la'ang cho gar ma gtogs dang gtogs pa'o //	1	dang po la cho gar ma gtogs dang gtogs ba 
BO_TZ_PEMA-SANGTHIG-P32:12	dang po ni /	1	dang po ni 
BO_TZ_PEMA-SANGTHIG-P32:13	dur khrod sogs gnas dben zhing zil dang ldan par rtsha gsum gyi snang brnyan bkram pa'i mdun /	1	dur khrod sogs gnas dben zhing zil dang ldan ba rtsha gsum gyi snang rnyan grem ba mdun 
BO_TZ_PEMA-SANGTHIG-P32:14	gzhi ma dul ba yin na sa'i cho ga spyi ltar bya /	1	gzhi ma dul ba yin na sa cho ga spyi ltar byed 
BO_TZ_PEMA-SANGTHIG-P32:15	sgrub khang rnying pa sogs la mi dgos /	1	sgrub khang rnying ba sogs la mi dgos 
BO_TZ_PEMA-SANGTHIG-P32:16	gang ltar yang stegs bu khod snyoms par dri yis chag chag gdab pa'i khar rdul tshhon nam ras bris kyi dkyil 'khor gzhal yas sgo rdzogs kyi dbus su pad+ma 'dab brgyad ge sar dang bcas par lha yi mtshhan ma rang mdog dang mthun pa grangs mnyam bkod pa'am	1	gang ltar yang stegs bu khod snyom ba dri yis chag chag gdab ba khar rdul tshhon nam ras bri kyi dkyil khor jal yas sgo rdzogs kyi dbus su pad+ma dab brgyad ge sar dang cha ba lha yi mtshhan ma rang mdog dang mthun ba grangs mnyam bkod ba 
BO_TZ_PEMA-SANGTHIG-P32:17	/ yang na man+dal du 'bru'i tshhom bu lha grangs bkod pas kyang rung la /	1	yang na man+dal du bru tshhom bu lha grangs bkod ba kyang rung la 
BO_TZ_PEMA-SANGTHIG-P32:18	gang ltar dkyil 'khor gyi dbus su many+dzi'i khar bum pa bcud ldan chas kyis spras pa'i khar thod pa mtshhan ldan gsang rdzas a mr-ita sbyar bas bkang ba dar dmar gyis kha bkab pa'i steng du man shel dang / gzhan yang rig tshaka dang gtsho 'khor sgo ma dang bcas pa'i tshaka li /	1	gang ltar dkyil khor gyi dbus su many+dzi khar bum ba bcud ldan cha kyis spras ba khar thod ba mtshhan ldan gsang rdzas a mr-ita sbyor ba geng ba dar dmar gyis kha gebs ba steng du man shel dang gzhan yang rig tshaka dang gtsho khor sgo ma dang cha ba tshaka li 
BO_TZ_PEMA-SANGTHIG-P32:19	sngags phreng / me long /	1	sngags phreng me long 
BO_TZ_PEMA-SANGTHIG-P32:20	rdor dril / sman raka gtor gsum /	2	rdar dril sman raka thor gsum 
BO_TZ_PEMA-SANGTHIG-P32:21	me tog /mig dar /	2	me tog dar 
BO_TZ_PEMA-SANGTHIG-P32:22	bgegs gtor / zhal zas sogs 'og tu dgos pa'i yo byad rnams ma tshhang ba med par 'du bya'o //	2	bgegs thor zhal zas sogs g tu dgos ba yo byad rnams ma tshhang ba med ba du byed 
BO_TZ_PEMA-SANGTHIG-P32:23	gnyis pa cho gar gtogs pa'i sbyor ba ni /	2	gnyis ba cho gar gtogs ba sbyor ba ni 
BO_TZ_PEMA-SANGTHIG-P32:24	brgyud 'debs nas brtsham tshhe yi phrin las gtang zhing bzlas pa'i thog mar /	2	brgyud debs nas brtsham tshhe yi phrin las gtong zhing bzlas ba thogs mar 
BO_TZ_PEMA-SANGTHIG-P32:25	rtsha sngags mthar phat dzahzhes pas dzapa? khang dbyes la /	2	rtsha sngags mthar phat dzahzhes ba dzapa? khang dbyes la 
BO_TZ_PEMA-SANGTHIG-P32:26	rang snang ye shes kyi 'khor lo las gnyis pa zhig 'phros te mdun gyi nam mkhar me ri 'dabs 'byor gyi tshhul du bzhugs par mos la /	2	rang snang ye shes kyi khor lo las gnyis ba jig phro te mdun gyi nam mkhar me ri dabs byor gyi tshhul du bzhugs ba mos la 
BO_TZ_PEMA-SANGTHIG-P32:27	bdag mdun lha yi skur gsal ba'i :	2	bdag mdun lha yi skur gsal ba 
BO_TZ_PEMA-SANGTHIG-P32:28	snying dbus dag pa'i thig le ru :	2	snying dbus dag ba thig le ru 
BO_TZ_PEMA-SANGTHIG-P32:29	bde chen chos sku tshhe dpag med :	2	bde chen chos sku tshhe dpog med 
BO_TZ_PEMA-SANGTHIG-P32:30	dmar gsal mnyam gzhag tshhe bum 'dzin :	3	dmar gsal mnyam jog tshhe bum dzin 
BO_TZ_PEMA-SANGTHIG-P32:31	de yi thugs kar nyi zla yi :	3	de yi thugs kar nyi zla yi 
BO_TZ_PEMA-SANGTHIG-P32:32	thabs shes gwa 'u 'bar ba'i dbus :	3	thabs shes gwa u bar ba dbus 
BO_TZ_PEMA-SANGTHIG-P32:33	mi 'gyur thugs srog hrihyig mthar :	3	mi gyur thugs srog hrihyig mthar 
BO_TZ_PEMA-SANGTHIG-P32:34	rdo rje'i sngags kyis bskor ba las :	3	rdo rje sngags kyis skor ba las 
BO_TZ_PEMA-SANGTHIG-P32:35	gsal zhing 'bar ba'i 'od zer gyis :	3	gsal zhing bar ba d zer gyis 
BO_TZ_PEMA-SANGTHIG-P32:36	snod bcud skye 'gro'i rgud pa sbyangs :	3	snod bcud skye gro rgud ba sbyong 
BO_TZ_PEMA-SANGTHIG-P32:37	'khor 'das dwangs bcud tshhur 'dus pas :	3	khor da dwangs bcud tshhur du ba 
BO_TZ_PEMA-SANGTHIG-P32:38	bde chen rdo rje'i sku ru bsam :	3	bde chen rdo rje sku ru bsam 
BO_TZ_PEMA-SANGTHIG-P32:39	om ahhu~m badzra gu ru pad+ma sid+d+hi dz+nya na a yu she hu~m b+h+ru~m nr-i dza :	3	om ahhu~m badzra gu ru pad+ma sid+d+hi dz+nya na a yu she hu~m b+h+ru~m nr-i dza 
BO_TZ_PEMA-SANGTHIG-P32:40	dmigs gnad dang ldan pa'i bzlas pa ci nus mthar /	4	dmigs gnad dang ldan ba bzlas ba ci nus mthar 
BO_TZ_PEMA-SANGTHIG-P32:41	dbyangs gsal rten snying lan gsum brjod la lhag chad kha bskang /	4	dbyangs gsal rten snying lan gsum rjod la lhag chad kha skong 
BO_TZ_PEMA-SANGTHIG-P32:42	bum pa / a mr-ita bsang /	4	bum ba a mr-ita bsang 
BO_TZ_PEMA-SANGTHIG-P32:43	swa b+ha was sbyang /	4	swa b+ha was sbyong 
BO_TZ_PEMA-SANGTHIG-P32:44	bum pa b+h+ru~m las gzhal yas khang :	4	bum ba b+h+ru~m las jal yas khang 
BO_TZ_PEMA-SANGTHIG-P32:45	tshhad dang mtshhan nyid yongs rdzogs dbus :	4	tshhad dang mtshhan nyid yongs rdzogs dbus 
BO_TZ_PEMA-SANGTHIG-P32:46	rtsha gsum tshhe yi lha tshhogs rnams :	4	rtsha gsum tshhe yi lha tshhogs rnams 
BO_TZ_PEMA-SANGTHIG-P32:47	chu zla 'ja' tshhon lta bur bsam :	4	chu zla ja tshhon lta bur bsam 
BO_TZ_PEMA-SANGTHIG-P32:48	rang srog sngags kyi 'od zer ni //	4	rang srog sngags kyi d zer ni 
BO_TZ_PEMA-SANGTHIG-P32:49	gzung thag la 'khril bum nang song //	4	gzung thag la khril bum nang gro 
BO_TZ_PEMA-SANGTHIG-P32:50	bum lha'i sku las bdud rtshi'i rgyun //	5	bum lha sku las bdud rtshi rgyun 
BO_TZ_PEMA-SANGTHIG-P32:51	babs pas bum pa yongs gang gyur //	5	bab ba bum ba yongs gang gyur 
BO_TZ_PEMA-SANGTHIG-P32:52	sngags mthar ka la sha a b+hi shiny+tsha b+h+ru~m:	5	sngags mthar ka la sha a b+hi shiny+tsha b+h+ru~m: 
BO_TZ_PEMA-SANGTHIG-P32:53	zhes stong du tshhang bar bzlas mthar /	5	zhes stong du tshhang ba bzlas mthar 
BO_TZ_PEMA-SANGTHIG-P32:54	ye shes lha tshhogs sogs brjod la stong tshhigs 'bul /	5	ye shes lha tshhogs sogs rjod la stong tshhigs bul 
BO_TZ_PEMA-SANGTHIG-P32:55	om ahhu~m zhes pas mchod yon phul pas bum pa'i lha bde stong chen po'i ngo bor 'od du zhu nas bum chu dang ro gcig tu gyur par bsam la /	5	om ahhu~m zhes ba mchod yon bul ba bum ba lha bde stong chen po ngo bor d du ju nas bum chu dang ro gcig tu gyur ba bsam la 
BO_TZ_PEMA-SANGTHIG-P32:56	las bum la gzungs thag bkod de /	5	las bum la gzungs thag bkod de 
BO_TZ_PEMA-SANGTHIG-P32:57	a mr-itas bsang /	5	a mr-itas bsang 
BO_TZ_PEMA-SANGTHIG-P32:58	swa b+ha was sbyang /	5	swa b+ha was sbyong 
BO_TZ_PEMA-SANGTHIG-P32:59	las bum nang du pad nyi'i steng /	5	las bum nang du pad nyi steng 
BO_TZ_PEMA-SANGTHIG-P32:60	khro chen rta mgrin sku mdog dmar //	6	khro chen rta mgrin sku mdog dmar 
BO_TZ_PEMA-SANGTHIG-P32:61	dbyug tho zhags 'dzin de'i sku las //	6	dbyug tho zhags dzin de sku las 
BO_TZ_PEMA-SANGTHIG-P32:62	babs pa'i bdud rtshis bum pa gang //	6	bab ba bdud rtshis bum ba gang 
BO_TZ_PEMA-SANGTHIG-P32:63	om h+ya gr-i wa hu~m phatah	6	om h+ya gr-i wa hu~m phatah 
BO_TZ_PEMA-SANGTHIG-P32:64	ces brgya rtsha brgyad bzlas mthar /	6	ces brgya rtsha brgyad bzlas mthar 
BO_TZ_PEMA-SANGTHIG-P32:65	om ahhu~m zhes pas mchod yon phul pas bum lha 'od du zhu bas bdud rtshi'i chur gyur pa dngos po gang la 'thor ba'i nyes skyon thams cad sbyong ba'i nus pa dang ldan par bsam /	6	om ahhu~m zhes ba mchod yon bul ba bum lha d du ju ba bdud rtshi chur(d) gyur ba dngos po gang la thor ba nyes skyon thams cad sbyong ba nus ba dang ldan ba bsam 
BO_TZ_PEMA-SANGTHIG-P32:66	tshhe dbang dang 'brel na bcas bshom skabs bum pa dang tshhe rdzas sogs bshams la skabs 'dir tshhe 'gugs brjod cing rtsha sngags gang mang bzlas la dmigs pas khyab par bya /	6	tshhe dbang dang brel na cha bshom skabs bum ba dang tshhe rdzas sogs bshams la skabs dir tshhe gugs rjod cing rtsha sngags gang mang bzlas la dmigs ba khyab ba byed 
BO_TZ_PEMA-SANGTHIG-P32:67	de nas bka' gter srung ma'i gtor bsngos dang / gzhung gi tshhogs byin rlabs nas brtsham bstab pa'i mthar thug pa'i bar gtong zhing /	6	de nas bka gter srung ma thor sngo dang gzhung gi tshhogs byin rlabs nas brtsham stob ba mthar thug ba ba gtong zhing 
BO_TZ_PEMA-SANGTHIG-P32:68	bdag nyid 'jug pa la khrus dang man+dal nas gtang rag gi bar 'og tu bshad pa'i dbang rnams kha bsgyur 'dor len phran bu dang bcas brjod pa'am /	6	bdag nyid jug ba la khru dang man+dal nas gtong rag gi ba g tu chad ba dbang rnams kha sgyur dor len phran bu dang cha rjod ba 
BO_TZ_PEMA-SANGTHIG-P32:69	cis kyang mi lcogs na rig pa'i me tog dor bas bdag nyid 'jug cing slob ma gzhug par gnang ba nod pa bcas spyi ltar bya zhing dkyil 'khor yol bas sgrib bo //	6	cis kyang mi lcogs na rig ba me tog dor ba bdag nyid jug cing slob ma jug ba gnang ba nod ba cha spyi ltar byed zhing dkyil khor yol ba sgrib bo 
BO_TZ_PEMA-SANGTHIG-P32:70	gnyis pa dngos gzhi dbang bskur ba la 'jug pa'i chos dang dbang bskur ba gnyis las /	7	gnyis ba dngos gzhi dbang skur ba la jug ba chos dang dbang skur ba gnyis las 
BO_TZ_PEMA-SANGTHIG-P32:71	dang po ni /	7	dang po ni 
BO_TZ_PEMA-SANGTHIG-P32:72	slob ma rnams phyi rol du las khrus bya /	7	slob ma rnams phyi rol du las khru byed 
BO_TZ_PEMA-SANGTHIG-P32:73	ting lo changs bu gtor ma rnams bshams la /	7	ting lo changs bu thor ma rnams bshams la 
BO_TZ_PEMA-SANGTHIG-P32:74	ram yam kham gis sbyang /	7	ram yam kham gis sbyong 
BO_TZ_PEMA-SANGTHIG-P32:75	stong pa'i ngang las b+h+ru~m las rin po che'i snod du gtor ma 'dod pa'i yon tan lnga dang ldan par bsam la /	7	stong ba ngang las b+h+ru~m las rin po che snod du thor ma dod ba yon tan lnga dang ldan ba bsam la 
BO_TZ_PEMA-SANGTHIG-P32:76	om ahhu~m gis brlabs /	7	om ahhu~m gis brlabs 
BO_TZ_PEMA-SANGTHIG-P32:77	om sarba big+h+nan na mahsarba ta tha ga ta sogs lan gsum gyis zhi ba /	7	om sarba big+h+nan na mahsarba ta tha ga ta sogs lan gsum gyis zhi ba 
BO_TZ_PEMA-SANGTHIG-P32:78	sum+b+ha ni sogs lan gsum gyis zhi drag phyed ma /	7	sum+b+ha ni sogs lan gsum gyis zhi drag phyed ma 
BO_TZ_PEMA-SANGTHIG-P32:79	hu~m: nga ni ye nas ngang gis khro :	7	hu~m: nga ni ye nas ngang gis khro 
BO_TZ_PEMA-SANGTHIG-P32:80	khro la khros pas zhi mdzad pa'i :	8	khro la khro ba zhi mdzad ba 
BO_TZ_PEMA-SANGTHIG-P32:81	thugs rje khros dpal rta yi rgyal :	8	thugs rje khro dpal rta yi rgyal 
BO_TZ_PEMA-SANGTHIG-P32:82	rig rtshal 'phro 'du 'bar ba'i sprin :	8	rig rtshal phro du bar ba sprin 
BO_TZ_PEMA-SANGTHIG-P32:83	ye shes rol pa'i rgyan du shar :	8	ye shes rol ba rgyan du char 
BO_TZ_PEMA-SANGTHIG-P32:84	nyon cig ma rig bdud dgra'i dpung :	8	nyon cig ma rig bdud dgra dpung 
BO_TZ_PEMA-SANGTHIG-P32:85	kun tu brtags pa'i gdon tshhogs kun :	8	kun tu rtog ba don tshhogs kun 
BO_TZ_PEMA-SANGTHIG-P32:86	ye shes rgyan gyi gtor ma longs :	8	ye shes rgyan gyi thor ma longs 
BO_TZ_PEMA-SANGTHIG-P32:87	yongs grub chos sku'i klong du dengs :	8	yongs grub chos sku klong du dengs 
BO_TZ_PEMA-SANGTHIG-P32:88	'pho 'gyur med par mtshhams bcad do :	8	pho gyur med ba mtshhams gcod do 
BO_TZ_PEMA-SANGTHIG-P32:89	zhes dang / rta sngags lan gsum dang yungs thun bcas kyis drag pos sbyangs nas /	8	zhes dang rta sngags lan gsum dang yungs thun cha kyis drag pos sbyong nas 
BO_TZ_PEMA-SANGTHIG-P32:90	om hrihbadzra kro d+ha rak+sha rak+sha hu~m phat:kyis srung ba'i 'khor los phyogs mtshhams gtams pa song nas /	9	om hrihbadzra kro d+ha rak+sha rak+sha hu~m phat:kyis srung ba khor los phyogs mtshhams gtams ba gro nas 
BO_TZ_PEMA-SANGTHIG-P32:91	sems bskyed gsal gdab sngon du 'gro bas chos bshad kyi khyad par /	9	sems skyed gsal gdab sngon du gro ba chos chad kyi khyad ba 
BO_TZ_PEMA-SANGTHIG-P32:92	de la 'dir bskal bzang sgron me stong rtsha'i nang nas thugs bskyed kyi go cha sus kyang 'gran du mi bzod pa ston mchog mnyam med shakya'i rgyal po de nyid kyis chos 'khor mtha' klas pa zhig bskor pa thams cad /	9	de la dir bskal bzang sgron me stong rtsha nang nas thugs skyed kyi go cha sus kyang gran du mi bzod ba ston mchog mnyam med shakya rgyal po de nyid kyis chos khor mtha klas ba jig skor ba thams cad 
BO_TZ_PEMA-SANGTHIG-P32:93	phung por bsdus na nyon mongs pa'i rtog tshhogs brgyad khri bzhi stong gi gnyen po chos kyi phung po yang de nyid kyi grangs dang mnyam zhing /	9	phung por sdud na nyon mongs ba rtogs tshhogs brgyad khri bzhi stong gi gnyen po chos kyi phung po yang de nyid kyi grangs dang mnyam zhing 
BO_TZ_PEMA-SANGTHIG-P32:94	sde tshhan du bsdus na gleng gzhi dang skyes rabs la sogs pa'i mtshhon sde snod rnam pa bcu gnyis kyi tshhul dang / dbang po'i rim pa dang mtshhungs par bsdus na /	9	sde tshhan du sdud na gleng gzhi dang skye rabs la sogs ba mtshhon sde snod rnam ba chu gnyis kyi tshhul dang dbang po rim ba dang mtshhungs ba sdud na 
BO_TZ_PEMA-SANGTHIG-P32:95	mtshhan nyid rgyu yi theg pa dang / 'bras bu rdo rje'i theg pa rnam pa gnyis su 'du ba yin te /	9	mtshhan nyid rgyu yi theg ba dang bras bu rdo rje theg ba rnam ba gnyis su du ba yin te 
BO_TZ_PEMA-SANGTHIG-P32:96	kun byed las /	9	kun byed las 
BO_TZ_PEMA-SANGTHIG-P32:97	mtshhan nyid rgyu yi theg pa dang // 'bras bu sngags kyi theg pa 'o //	9	mtshhan nyid rgyu yi theg ba dang bras bu sngags kyi theg ba mang 
BO_TZ_PEMA-SANGTHIG-P32:98	zhes gsungs pa ltar theg pa gnyis su dbye ba dang dgur dbye ba sogs rnam grangs mang du mchis pa las /	9	zhes gsungs ba ltar theg ba gnyis su byed ba dang dgur byed ba sogs rnam grangs mang du mchis ba las 
BO_TZ_PEMA-SANGTHIG-P32:99	da lam gyi skabs su bab pa la slob dpon ma ti tshi tra'i tshhul gsum sgron me las /	9	da lam gyi skabs su bab ba la slob dpon ma ti tshi tra tshhul gsum sgron me las 
BO_TZ_PEMA-SANGTHIG-P32:100	don gcig na yang ma rmongs dang // thabs mang dka' ba med pa dang // dbang po rnon po'i dbang byas nas //	10	don gcig na yang ma rmongs dang thabs mang dka ba med ba dang dbang po rnon po dbang byed nas 
BO_TZ_PEMA-SANGTHIG-P32:101	sngags kyi theg pa khyad par 'phags //	10	sngags kyi theg ba khyad ba phag 
BO_TZ_PEMA-SANGTHIG-P32:102	zhes gsungs pa ltar mtshhan nyid rgyu yi theg pa ring ba'i dbang du btang ste /	10	zhes gsungs ba ltar mtshhan nyid rgyu yi theg ba ring ba dbang du gtong ste 
BO_TZ_PEMA-SANGTHIG-P32:103	nye lam gsang sngags rdo rje theg pa'i 'jug sgo dbang bskur ba'i skabs su bab pa yin /	10	nye lam gsang sngags rdo rje theg ba jug sgo dbang skur ba skabs su bab ba yin 
BO_TZ_PEMA-SANGTHIG-P32:104	de la'ang gsang sngags gsar rnying gnyis las /	10	de la gsang sngags gsar rnying gnyis las 
BO_TZ_PEMA-SANGTHIG-P32:105	'dir gsang sngags rnying ma /	10	dir gsang sngags rnying ma 
BO_TZ_PEMA-SANGTHIG-P32:106	de la'ang bka' gter dag snang ste bab so gsum du mchis pa las /	10	de la bka gter dag snang ste bab so gsum du mchis ba las 
BO_TZ_PEMA-SANGTHIG-P32:107	'dir ni zab mo gter gyi phyogs su gtogs pa yin /	10	dir ni zab mo gter gyi phyogs su gtogs ba yin 
BO_TZ_PEMA-SANGTHIG-P32:108	de la'ang rgyud dang sgrub thabs gnyis su bzhugs pa las /	10	de la brgyud dang sgrub thabs gnyis su bzhugs ba las 
BO_TZ_PEMA-SANGTHIG-P32:109	da lam gyi skabs su bab pa gsung rdo rje pad+ma gar dbang gi rgyud dang / de nyid dkyil 'khor yongs kyi gtsho mchog tu bzhengs pa ma ha gu ru snang srid zil gnon rtshal /	10	da lam gyi skabs su bab ba gsung rdo rje pad+ma gar dbang gi brgyud dang de nyid dkyil khor yongs kyi gtsho mchog tu bzhengs ba ma ha gu ru snang srid zil gnon rtshal 
BO_TZ_PEMA-SANGTHIG-P32:110	ngo bo'i cha las dpal chen che mchog yang dag he ru ka go'u ri lha mo brgyad kyi snang char bzhengs pa ste /	11	ngo bo cha las dpal chen che mchog yang dag he ru ka gou ri lha mo brgyad kyi snang char bzhengs ba ste 
BO_TZ_PEMA-SANGTHIG-P32:111	mdor na dkyil 'khor yongs kyi gtsho mchog bde ba chen po pad+ma sam b+ha wa longs sku tshhe dpag med kyi snang char shar ba'i sgrub thabs zab mo 'di nyid /	11	mdor na dkyil khor yongs kyi gtsho mchog bde ba chen po pad+ma sam b+ha wa longs sku tshhe dpog med kyi snang char char ba sgrub thabs zab mo di nyid 
BO_TZ_PEMA-SANGTHIG-P32:112	kho bo bdud 'joms nam mkha'i rdo rjes mdo khams yel brag nam mkha' mdzod kyi gu ru'i gsang phug nas dngos grub tu thob pa 'di nyid kyi dkyil 'khor du /	11	kho bo bdud joms nam mkha rdo rjes mdo khams yel brag nam mkha mdzod kyi gu ru gsang bugs nas dngos grub tu thob ba di nyid kyi dkyil khor du 
BO_TZ_PEMA-SANGTHIG-P32:113	rtsha ba'i smin byed rgyas pa bsgrub par bgyi ba la /	11	rtsha ba smin byed rgya ba sgrub ba bgyid ba la 
BO_TZ_PEMA-SANGTHIG-P32:114	dkyil 'khor du 'jug pa'i chos dang zhugs nas mngon par dbang bskur ba gnyis las /	11	dkyil khor du jug ba chos dang jug nas mngon ba dbang skur ba gnyis las 
BO_TZ_PEMA-SANGTHIG-P32:115	dang po dkyil 'khor du 'jug pa'i chos rnams zhu ba'i yon du man+dal zhes mtshhams sbyar la 'bul du gzhug	11	dang po dkyil khor du jug ba chos rnams ju ba yon du man+dal zhes mtshhams sbyor la bul du jug 
BO_TZ_PEMA-SANGTHIG-P32:116	/de nas bla ma dkyil 'khor gyi gtsho bor bzhengs pa la gsol ba 'debs pa 'di'i rjes zlos /	11	nas bla ma dkyil khor gyi gtsho bor bzhengs ba la gsol ba debs ba di rjes zlos 
BO_TZ_PEMA-SANGTHIG-P32:117	kye hohrdo rje 'dzin rgyal po :	11	kye hohrdo rje dzin rgyal po 
BO_TZ_PEMA-SANGTHIG-P32:118	bdag la dgongs par mdzad du gsol :	11	bdag la dgongs ba mdzad du gsol 
BO_TZ_PEMA-SANGTHIG-P32:119	khams gsum 'khor ba'i g.yang sa las :	11	khams gsum khor ba g.yang sa las 
BO_TZ_PEMA-SANGTHIG-P32:120	sgrol phyir dbang mchog bstshal du gsol :	12	sgrol phyir dbang mchog bstshal du gsol 
BO_TZ_PEMA-SANGTHIG-P32:121	lan gsum / sngon chad brda dang brda can gyi dkyil 'khor ma mthong ba la mtshhon byed mig dar 'ching bar zhu /	12	lan gsum sngon chad brda dang brda can gyi dkyil khor ma mthong ba la mtshhon byed mig dar ching ba ju 
BO_TZ_PEMA-SANGTHIG-P32:122	om tshak+shur b+han+d+ha wa ra ma na ye hu~m/	12	om tshak+shur b+han+d+ha wa ra ma na ye 
BO_TZ_PEMA-SANGTHIG-P32:123	zhes mig dar bcing /	12	zhes mig dar ching 
BO_TZ_PEMA-SANGTHIG-P32:124	rigs kyi lha dang dngos grub kyi mtshhan ma nges par bya ba'i phyir me tog pad+ma'i chun po re thogs par bsam la /	12	rigs kyi lha dang dngos grub kyi mtshhan ma nges ba byed ba phyir me tog pad+ma chun po re thogs ba bsam la 
BO_TZ_PEMA-SANGTHIG-P32:125	a kham bi ra hu~m gis me tog bkye /	12	a kham bi ra hu~m gis me tog gyed 
BO_TZ_PEMA-SANGTHIG-P32:126	mdun gyi nam mkhar bla ma dang gnyis su med pa'i skyabs yul nam mkha' gang bar bzhugs pa'i spyan sngar skyabs su 'gro ba'i 'dun pas 'di'i rjes zlos /	12	mdun gyi nam mkhar bla ma dang gnyis su med ba skyob yul nam mkha gang ba bzhugs ba spyan sngar skyob su gro ba dun ba di rjes zlos 
BO_TZ_PEMA-SANGTHIG-P32:127	na mo : gdod nas dag pa sogs lan gsum /	12	na mo gdod nas dag ba sogs lan gsum 
BO_TZ_PEMA-SANGTHIG-P32:128	yul mchog de dag gi spyan sngar smon pa dang 'jug pa'i bdag nyid can gyi byang chub kyi mchog tu sems bskyed pa 'di'i rjes zlos /	12	yul mchog de dag gi spyan sngar smon ba dang jug ba bdag nyid can gyi byang chub kyi mchog tu sems skyed ba di rjes zlos 
BO_TZ_PEMA-SANGTHIG-P32:129	ho : med bzhin snang ba sogs lan gsum /	12	ho med bzhin snang ba sogs lan gsum 
BO_TZ_PEMA-SANGTHIG-P32:130	tshhogs gsag yan lag brgyad pa 'di'i rjes zlos /	13	tshhogs gsag yan lag brgyad ba di rjes zlos 
BO_TZ_PEMA-SANGTHIG-P32:131	'chi med tshhe yi lha tshhogs sogs lan gsum /	13	chi med tshhe yi lha tshhogs sogs lan gsum 
BO_TZ_PEMA-SANGTHIG-P32:132	de nas kun rdzob dang don dam gyi sems gsal gdab pa ni /	13	de nas kun rdzob dang don dam gyi sems gsal gdab ba ni 
BO_TZ_PEMA-SANGTHIG-P32:133	khyed rang rnams kyi snying gar kun rdzob byang chub sems kyi ngo bo zla ba'i dkyil 'khor nya gang ba /	13	khyed rang rnams kyi snying gar kun rdzob byang chub sems kyi ngo bo zla ba dkyil khor nya gang ba 
BO_TZ_PEMA-SANGTHIG-P32:134	de'i steng du don dam byang chub sems kyi rang bzhin rdo rje dkar po rtshe lnga pa bsgom la /	13	de steng du don dam byang chub sems kyi rang bzhin rdo rje dkar po rtshe lnga ba bsgom la 
BO_TZ_PEMA-SANGTHIG-P32:135	stong nyid snying rje'i snying po can gyi sems gzung ba 'di'i rjes zlos /	13	stong nyid snying rje snying po can gyi sems gzung ba di rjes zlos 
BO_TZ_PEMA-SANGTHIG-P32:136	om sarba yo ga tshit+ta u pa da ya mi :	13	om sarba yo ga tshit+ta u ba da ya mi 
BO_TZ_PEMA-SANGTHIG-P32:137	zhes lan gsum rjes zlos byar gzhug	13	zhes lan gsum rjes zlos byar jug 
BO_TZ_PEMA-SANGTHIG-P32:138	/sngags de nyid brjod bzhin du rdo rje snying gar bzhag ste brtan par bya /	13	de nyid rjod bzhin du rdo rje snying gar jog ste brtan ba byed 
BO_TZ_PEMA-SANGTHIG-P32:139	gsang sngags dbang gi dam tshhig kho na la rag las pas dam tshhig gi gnas su 'god pa la rdo rje'i chu nan gyi khe nyan bsgrag pa ni /	13	gsang sngags dbang gi dam tshhig kho na la rag las ba dam tshhig gi gnas su god ba la rdo rje chu nan gyi khe nyan sgrog ba ni 
BO_TZ_PEMA-SANGTHIG-P32:140	mna' chu blud la /	14	mna chu blud la 
BO_TZ_PEMA-SANGTHIG-P32:141	hu~m: 'di ni dam tshhig rdo rje'i chu :	14	hu~m: di ni dam tshhig rdo rje chu 
BO_TZ_PEMA-SANGTHIG-P32:142	dam tshhig nyams na sreg par byed :	14	dam tshhig nyams na sreg ba byed 
BO_TZ_PEMA-SANGTHIG-P32:143	dam tshhig bsrung na dngos grub ni :	14	dam tshhig bsrung na dngos grub ni 
BO_TZ_PEMA-SANGTHIG-P32:144	rdo rje bdud rtshi'i chu 'dis 'grub :	14	rdo rje bdud rtshi chu dis grub 
BO_TZ_PEMA-SANGTHIG-P32:145	om pany+tsha a mr-ita u da ka tha tha hu~m:	14	om pany+tsha a mr-ita u da ka tha tha hu~m: 
BO_TZ_PEMA-SANGTHIG-P32:146	zhes sbyin / rdo rje mgor bzhag la /	14	zhes sbyin rdo rje mgor jog la 
BO_TZ_PEMA-SANGTHIG-P32:147	slob dpon bka' gnyan par gdams pa ni /	14	slob dpon bka gnyan ba doms ba ni 
BO_TZ_PEMA-SANGTHIG-P32:148	bdag ni rdo rje slob dpon te :	14	bdag ni rdo rje slob dpon te 
BO_TZ_PEMA-SANGTHIG-P32:149	khyod kyis nga la brnyas ma byed :	14	khyod kyis nga la brnyas ma byed 
BO_TZ_PEMA-SANGTHIG-P32:150	gal te brnyas par byed pa na :	15	gal te brnyas ba byed ba na 
BO_TZ_PEMA-SANGTHIG-P32:151	dmyal ba chen por ltung ta re :	15	dmyal ba chen por ltung ta re 
BO_TZ_PEMA-SANGTHIG-P32:152	rdo rje snying gar bzhag ste /	15	rdo rje snying gar jog ste 
BO_TZ_PEMA-SANGTHIG-P32:153	gsang ba mi smra bar gdams pa ni /	15	gsang ba mi smra ba doms ba ni 
BO_TZ_PEMA-SANGTHIG-P32:154	'di ni dam tshhig rdo rje ste :	15	di ni dam tshhig rdo rje ste 
BO_TZ_PEMA-SANGTHIG-P32:155	khyod kyi snying la yang dag zhugs :	15	khyod kyi snying la yang dag jug 
BO_TZ_PEMA-SANGTHIG-P32:156	gal te tshhul 'di smras na ni :	15	gal te tshhul di smras na ni 
BO_TZ_PEMA-SANGTHIG-P32:157	de ma thag tu dral te gshegs :	15	de ma thag tu dral te gshegs 
BO_TZ_PEMA-SANGTHIG-P32:158	badzra sa ma ya rak+shan+tu :	15	badzra sa ma ya rak+shan+tu 
BO_TZ_PEMA-SANGTHIG-P32:159	de nas nang 'jug gi thog mar ye shes pa dbab pa ni /	15	de nas nang jug gi thogs mar ye shes ba bebs ba ni 
BO_TZ_PEMA-SANGTHIG-P32:160	slob ma langs te rkang pa gshib lag pa spyi bor thal mo sbyar /	16	slob ma ldang te rkang ba gshib lag ba spyi bor thal mo sbyor 
BO_TZ_PEMA-SANGTHIG-P32:161	rlung bum pa can 'dzin du bcug	16	rlung bum ba can dzin du jug 
BO_TZ_PEMA-SANGTHIG-P32:162	/dmigs pa 'di ltar gsal gdab bo //	16	ba di ltar gsal gdab bo 
BO_TZ_PEMA-SANGTHIG-P32:163	las sngags kyis bsang /	16	las sngags kyis bsang 
BO_TZ_PEMA-SANGTHIG-P32:164	swa b+ha was sbyang /	16	swa b+ha was sbyong 
BO_TZ_PEMA-SANGTHIG-P32:165	sgo gsum dngos 'dzin mi dmigs par //	16	sgo gsum dngos dzin mi dmigs ba 
BO_TZ_PEMA-SANGTHIG-P32:166	slob ma dpal chen he ru ka :	16	slob ma dpal chen he ru ka 
BO_TZ_PEMA-SANGTHIG-P32:167	rta mchog rgyal por gsal ba yi :	16	rta mchog rgyal por gsal ba yi 
BO_TZ_PEMA-SANGTHIG-P32:168	snying gar chu skyes nyi zla'i dbus :	16	snying gar chu skye nyi zla dbus 
BO_TZ_PEMA-SANGTHIG-P32:169	'chi med ye shes tshhe dpag med :	16	chi med ye shes tshhe dpog med 
BO_TZ_PEMA-SANGTHIG-P32:170	de yi thugs kar mkha' 'gro ma :	17	de yi thugs kar mkha gro ma 
BO_TZ_PEMA-SANGTHIG-P32:171	gsang ba ye shes dmar gsal mdangs :	17	gsang ba ye shes dmar gsal mdangs 
BO_TZ_PEMA-SANGTHIG-P32:172	da ru dkrol zhing thod chang bsnams :	17	da ru khrol zhing thod chang snom 
BO_TZ_PEMA-SANGTHIG-P32:173	'od dmar zhags pas bskor ba yi :	17	d dmar zhags ba skor ba yi 
BO_TZ_PEMA-SANGTHIG-P32:174	gsang bar g.yung drung ris dmar po :	17	gsang ba g.yung drung ris dmar po 
BO_TZ_PEMA-SANGTHIG-P32:175	g.yon phyogs drag tu 'khor ba las :	17	g.yon phyogs drag tu khor ba las 
BO_TZ_PEMA-SANGTHIG-P32:176	mkha' 'gro bde ba'i gar dang sgras :	17	mkha gro bde ba gar dang sgras 
BO_TZ_PEMA-SANGTHIG-P32:177	sras bcas rgyal rnams dbang med bkug :	17	sras cha rgyal rnams dbang med gugs 
BO_TZ_PEMA-SANGTHIG-P32:178	slob ma'i lus la thim par bsam :	17	slob ma lus la thim ba bsam 
BO_TZ_PEMA-SANGTHIG-P32:179	spro na byin 'beb dbyangs dang bcas gyer ba ni /	17	spro na byin beb dbyangs dang cha gyer ba ni 
BO_TZ_PEMA-SANGTHIG-P32:180	hu~m: rang bzhin gdod nas rnam dag pa :	18	hu~m: rang bzhin gdod nas rnam dag ba 
BO_TZ_PEMA-SANGTHIG-P32:181	zhi ba chen po'i byin phob cig :	18	zhi ba chen po byin phob cig 
BO_TZ_PEMA-SANGTHIG-P32:182	longs spyod yongs rdzogs rol pa'i sprin :	18	longs spyod yongs rdzogs rol ba sprin 
BO_TZ_PEMA-SANGTHIG-P32:183	bde ba chen po'i byin phob cig :	18	bde ba chen po byin phob cig 
BO_TZ_PEMA-SANGTHIG-P32:184	sna tshhogs 'gro 'dul sprul pa'i gar :	18	sna tshhogs gro dul sprul ba gar 
BO_TZ_PEMA-SANGTHIG-P32:185	bsam mi khyab pa'i byin phob cig :	18	bsam mi khyab ba byin phob cig 
BO_TZ_PEMA-SANGTHIG-P32:186	hu~m: lho nub rnga yab sprul pa'i zhing :	18	hu~m: lho nub rnga yab sprul ba zhing 
BO_TZ_PEMA-SANGTHIG-P32:187	'chi med dag pa'i grong khyer nas :	18	chi med dag ba grong khyer nas 
BO_TZ_PEMA-SANGTHIG-P32:188	bde chen chos sku pad+ma 'byung :	18	bde chen chos sku pad+ma byung 
BO_TZ_PEMA-SANGTHIG-P32:189	rab 'byams tshhe lha'i tshhogs dang bcas :	18	rab byam tshhe lha tshhogs dang cha 
BO_TZ_PEMA-SANGTHIG-P32:190	mi mngon dbyings nas skur bzhengs shig :	19	mi mngon dbyings nas skur bzhengs shig 
BO_TZ_PEMA-SANGTHIG-P32:191	gsang ba'i gnas 'dir byin chen phobs :	19	gsang ba gnas dir byin chen phobs 
BO_TZ_PEMA-SANGTHIG-P32:192	tshhe mda' 'di la tshhad cig ston :	19	tshhe mda di la tshhad cig ston 
BO_TZ_PEMA-SANGTHIG-P32:193	sgrub rdzas 'di la zhag cig skyil :	19	sgrub rdzas di la zhag cig skyil 
BO_TZ_PEMA-SANGTHIG-P32:194	'chi med tshhe yi dngos grub stshol :	19	chi med tshhe yi dngos grub stshol 
BO_TZ_PEMA-SANGTHIG-P32:195	rtsha sngags mthar /	19	rtsha sngags mthar 
BO_TZ_PEMA-SANGTHIG-P32:196	satwam b+ha ya satwam b+ha ya /	19	satwam b+ha ya satwam b+ha ya 
BO_TZ_PEMA-SANGTHIG-P32:197	ra ra ra ra /	19	ra ra ra ra 
BO_TZ_PEMA-SANGTHIG-P32:198	tsha la ya tsha la ya /	19	tsha la ya tsha la ya 
BO_TZ_PEMA-SANGTHIG-P32:199	hrim hrim/ phem phem/	19	hrim phem 
BO_TZ_PEMA-SANGTHIG-P32:200	hu~m ahha dz+ha+aimh zhes drag tu brjod cing rol mo'i sgra dal brel spel ma dang bcas te ye shes 'beb pa'i rdzas gzhung mthun bdug	20	hu~m ahha dz+ha+aimh zhes drag tu rjod cing rol mo sgra dal brel spel ma dang cha te ye shes beb ba rdzas gzhung mthun bdug 
BO_TZ_PEMA-SANGTHIG-P32:201	/ye shes phebs pa'i rtags byung na de nyid byang chub snying po'i bar du brtan par bsam la /	20	shes phebs ba rtags byung na de nyid byang chub snying po ba du brtan ba bsam la 
BO_TZ_PEMA-SANGTHIG-P32:202	tish+tha badzra zhes rdo rje me tog dang bcas pa spyi bor bzhag	20	tish+tha badzra zhes rdo rje me tog dang cha ba spyi bor jog 
BO_TZ_PEMA-SANGTHIG-P32:203	/de nas dkyil 'khor nang du gzhug par gsol ba gdab pa 'di'i rjes zlos /	20	nas dkyil khor nang du jug ba gsol ba gdab ba di rjes zlos 
BO_TZ_PEMA-SANGTHIG-P32:204	kyai ho : rnal 'byor chen po bde ba che :	20	kyai ho rnal byor chen po bde ba che 
BO_TZ_PEMA-SANGTHIG-P32:205	ye shes chen po gsal ba che :	20	ye shes chen po gsal ba che 
BO_TZ_PEMA-SANGTHIG-P32:206	dkyil 'khor chen po bdag 'tshhal na :	20	dkyil khor chen po bdag tshhal na 
BO_TZ_PEMA-SANGTHIG-P32:207	dpa' bo chen pos gnad du gsol :	20	dpa bo chen pos gnad du gsol 
BO_TZ_PEMA-SANGTHIG-P32:208	lan gsum / dzahhu~m bam ho pra be sha ya phatah	20	lan gsum dzahhu~m bam ho pra be sha ya phatah 
BO_TZ_PEMA-SANGTHIG-P32:209	dkyil 'khor gyi sgo bzhi shag gi phye bar gyur /	20	dkyil khor gyi sgo bzhi shag gi byed ba gyur 
BO_TZ_PEMA-SANGTHIG-P32:210	yol ba bsal /	21	yol ba bsal 
BO_TZ_PEMA-SANGTHIG-P32:211	slob dpon gyi thugs ka nas ye shes kyi 'od zer gser gyi thur ma lta bu 'phros ma rig pa'i sgrib g.yogs mig dar dang lhan cig bsal bar bsam la /	21	slob dpon gyi thugs ka nas ye shes kyi d zer gser gyi thur ma lta bu phro ma rig ba sgrib g.yogs mig dar dang lhan cig bsal ba bsam la 
BO_TZ_PEMA-SANGTHIG-P32:212	om badzra tshak+shu pra we sha ya phatah	21	om badzra tshak+shu pra we sha ya phatah 
BO_TZ_PEMA-SANGTHIG-P32:213	zhes pas mig dar dbye /	21	zhes ba mig dar byed 
BO_TZ_PEMA-SANGTHIG-P32:214	lha ngo bstan pa ni /	21	lha ngo ston ba ni 
BO_TZ_PEMA-SANGTHIG-P32:215	'di na rang snang ye shes kyi dkyil 'khor chen po tshhad dang mtshhan nyid thams cad yongs su rdzogs pa'i dbus su pad+ma 'dab brgyad ge sar dang bcas pa'i lte bar nyi ma dang zla ba'i steng du /	21	di na rang snang ye shes kyi dkyil khor chen po tshhad dang mtshhan nyid thams cad yongs su rdzogs ba dbus su pad+ma dab brgyad ge sar dang cha ba lte ba nyi ma dang zla ba steng du 
BO_TZ_PEMA-SANGTHIG-P32:216	bde ba chen po pad+ma sam b+ha wa gzungs ma me tog man+da rahba dang mnyam par sbyor ba /	21	bde ba chen po pad+ma sam b+ha wa gzungs ma me tog man+da rahba dang mnyam ba sbyor ba 
BO_TZ_PEMA-SANGTHIG-P32:217	phyogs mtshhams kyi 'dab mar sgeg sogs mchod pa'i lha mo sgo ma mgyogs ma bzhi dang bcas pa dag pa rab 'byams lha yi dkyil 'khor chen por mngon sum du mthong ba'i mos pa gyis la dad mos spro ba rgya chen po bskyed cing /	21	phyogs mtshhams kyi dab mar sgeg sogs mchod ba lha mo sgo ma mgyog ma bzhi dang cha ba dag ba rab byam lha yi dkyil khor chen por mngon sum du mthong ba mos ba gyis la dad mos spro ba rgya chen po skyed cing 
BO_TZ_PEMA-SANGTHIG-P32:218	de nas sngar byin pa'i me tog de nyid rang rigs kyi lha gang yin pa la 'bab par shog cig snyam pa'i mos pa dang bcas te tshhig 'di'i rjes zlos gyis la tshhom bu'i dkyil 'khor du 'dor ba zhu /	21	de nas sngar byin ba me tog de nyid rang rigs kyi lha gang yin ba la bab ba shog cig snyam ba mos ba dang cha te tshhig di rjes zlos gyis la tshhom bu dkyil khor du dor ba ju 
BO_TZ_PEMA-SANGTHIG-P32:219	hoh sngon nas 'brel pa'i lha mchog la //	21	hoh sngon nas brel ba lha mchog la 
BO_TZ_PEMA-SANGTHIG-P32:220	rig pa'i me tog 'di phul bas //	22	rig ba me tog di bul ba 
BO_TZ_PEMA-SANGTHIG-P32:221	sngon nas las 'phro gang yod pa'i //	22	sngon nas las phro gang yod ba 
BO_TZ_PEMA-SANGTHIG-P32:222	yi dam lha la 'bab par shog	22	yi dam lha la bab ba shog 
BO_TZ_PEMA-SANGTHIG-P32:223	/push+pe pra titsh+tshha g+h+rih+na hoh	22	pra titsh+tshha g+h+rih+na hoh 
BO_TZ_PEMA-SANGTHIG-P32:224	zhes pa'i me tog dor la rigs brtags /	22	zhes ba me tog dor la rigs rtog 
BO_TZ_PEMA-SANGTHIG-P32:225	me tog rang rigs kyi lhas bzung ste dngos grub cod pan gyi tshhul du spyi bor bcings par mos la /	22	me tog rang rigs kyi lhas bzung ste dngos grub cod pan gyi tshhul du spyi bor ching ba mos la 
BO_TZ_PEMA-SANGTHIG-P32:226	om pra ti g+h+rih+na satwam i mam satwa ma ha ba la /	22	om pra ti g+h+rih+na satwam i mam satwa ma ha ba la 
BO_TZ_PEMA-SANGTHIG-P32:227	zhes me tog spyi bor bkod /	22	zhes me tog spyi bor bkod 
BO_TZ_PEMA-SANGTHIG-P32:228	de dag gis 'jug pa'i chos 'khor dang bcas pa grub nas /	22	de dag gis jug ba chos khor dang cha ba grub nas 
BO_TZ_PEMA-SANGTHIG-P32:229	gnyis pa zhugs nas mngon par dbang bskur ba la /	22	gnyis ba jug nas mngon ba dbang skur ba la 
BO_TZ_PEMA-SANGTHIG-P32:230	thog mar spros bcas bum pa'i dbang gsan pa'i ched du man+dal /	23	thogs mar spros cha bum ba dbang gsan ba ched du man+dal 
BO_TZ_PEMA-SANGTHIG-P32:231	gsol ba 'debs pa 'di'i rjes zlos /	23	gsol ba debs ba di rjes zlos 
BO_TZ_PEMA-SANGTHIG-P32:232	byang chub rdo rjes sangs rgyas la //	23	byang chub rdo rjes sangs rgya la 
BO_TZ_PEMA-SANGTHIG-P32:233	mchod sbyin ji ltar bstshal pa ltar //	23	mchod sbyin ji ltar bstshal ba ltar 
BO_TZ_PEMA-SANGTHIG-P32:234	bdag kyang skyob pa'i don gyi phyir //	23	bdag kyang skyob ba don gyi phyir 
BO_TZ_PEMA-SANGTHIG-P32:235	nam mkha'i rdo rje deng bdag stshol //	23	nam mkha rdo rje deng bdag stshol 
BO_TZ_PEMA-SANGTHIG-P32:236	ces gsum / de nas slob dpon dkyil 'khor gyi gtsho bor gsal ba'i thugs ka nas 'od zer 'phros /	23	ces gsum de nas slob dpon dkyil khor gyi gtsho bor gsal ba thugs ka nas d zer phro 
BO_TZ_PEMA-SANGTHIG-P32:237	gdan gsum tshhang ba'i dbang gi lha tshhogs nam mkha' gang bar spyan drangs /	23	gdan gsum tshhang ba dbang gi lha tshhogs nam mkha gang ba spyan drangs 
BO_TZ_PEMA-SANGTHIG-P32:238	de rnams kyi phyag na rin po che'i bum pa bdud rtshi'i chu rgyun gyis gang ba thogs te mngon par dbang bskur bar bsam la /	23	de rnams kyi phyag na rin po che bum ba bdud rtshi chu rgyun gyis gang ba thogs te mngon ba dbang skur ba bsam la 
BO_TZ_PEMA-SANGTHIG-P32:239	hu~m: bum pa zlum po chos sku'i gzhal yas khang :	23	hu~m: bum ba zlum po chos sku jal yas khang 
BO_TZ_PEMA-SANGTHIG-P32:240	bum rdzas snang ba longs spyod rdzogs pa'i dpal :	24	bum rdzas snang ba longs spyod rdzogs ba dpal 
BO_TZ_PEMA-SANGTHIG-P32:241	gnyis med zung 'jug 'chi med bdud rtshi'i chus :	24	gnyis med zung jug chi med bdud rtshi chus 
BO_TZ_PEMA-SANGTHIG-P32:242	skal ldan rigs kyi bu la dbang bskur pas :	24	skal ldan rigs kyi bu la dbang skur ba 
BO_TZ_PEMA-SANGTHIG-P32:243	lus kyi sgrib dag phung khams lha skur smin :	24	lus kyi sgrib dag phung khams lha skur smin 
BO_TZ_PEMA-SANGTHIG-P32:244	rigs lnga rgyal ba'i dbang mchog yongs rdzogs te :	24	rigs lnga rgyal ba dbang mchog yongs rdzogs te 
BO_TZ_PEMA-SANGTHIG-P32:245	rnam smin rig 'dzin sa bon nyer thob shog :	24	rnam smin rig dzin sa bon nyer thob shog 
BO_TZ_PEMA-SANGTHIG-P32:246	bud+d+ha ka la sha a b+hi shiny+tsha hu~m:	24	bud+d+ha ka la sha a b+hi shiny+tsha hu~m: 
BO_TZ_PEMA-SANGTHIG-P32:247	badzra\u0f8e rat+na\u0f8e pad+ma\u0f8e karma\u0f8e	24	badzra\u0f8e rat+na\u0f8e pad+ma\u0f8e karma\u0f8e 
BO_TZ_PEMA-SANGTHIG-P32:248	zhes sbyar la mgo bo'i gnas lngar bzhag cing dbang bskur te bum chu ngag tu blud /	24	zhes sbyor la mgo bo gnas lngar jog cing dbang skur te bum chu ngag tu blud 
BO_TZ_PEMA-SANGTHIG-P32:249	de'i rjes 'brel du sku gsung thugs kyi dbang bskur ba la /	24	de rjes brel du sku gsung thugs kyi dbang skur ba la 
BO_TZ_PEMA-SANGTHIG-P32:250	dang po lha sku phyag rgya'i dbang bskur ba ni /	25	dang po lha sku phyag rgya dbang skur ba ni 
BO_TZ_PEMA-SANGTHIG-P32:251	dkyil 'khor gyi lha tshhogs rnams kyi sku las ye shes kyi sku gnyis pa re spros te khyed rang rnams kyi dpral bar thim pas rdo rje sku yi byin rlabs lus la zhugs par mos shig	25	dkyil khor gyi lha tshhogs rnams kyi sku las ye shes kyi sku gnyis ba re spros te khyed rang rnams kyi dpral ba thim ba rdo rje sku yi byin rlabs lus la jug ba mos shig 
BO_TZ_PEMA-SANGTHIG-P32:252	/om ahhu~m: chos sku stong gsal ma bcos spros dang bral :	25	ahhu~m: chos sku stong gsal ma chos spros dang bral 
BO_TZ_PEMA-SANGTHIG-P32:253	longs sku gsal la ma 'dres gu ru'i sku :	25	longs sku gsal la ma dre gu ru sku 
BO_TZ_PEMA-SANGTHIG-P32:254	sprul sku sna tshhogs thabs kyis 'gro don mdzad :	25	sprul sku sna tshhogs thabs kyis gro don mdzad 
BO_TZ_PEMA-SANGTHIG-P32:255	sngon tshhe pad 'byung khyed dang smon lam gcig :	25	sngon tshhe pad byung khyed dang smon lam gcig 
BO_TZ_PEMA-SANGTHIG-P32:256	da lta bdag dang slob ma'i stangs bzung ste :	25	da lta bdag dang slob ma stangs bzung ste 
BO_TZ_PEMA-SANGTHIG-P32:257	srog gi phyir yang mi gtong sgrub lags na :	25	srog gi phyir yang mi gtong sgrub lags na 
BO_TZ_PEMA-SANGTHIG-P32:258	ye shes rab 'byams dbang chen bskur du gsol :	25	ye shes rab byam dbang chen skur du gsol 
BO_TZ_PEMA-SANGTHIG-P32:259	ka ya badzra a b+hi shiny+tsha hu~m:	25	ka ya badzra a b+hi shiny+tsha hu~m: 
BO_TZ_PEMA-SANGTHIG-P32:260	gnyis pa gsung bzlas pa sngags kyi lung blang ba ni /	26	gnyis ba gsung bzlas ba sngags kyi lung blang ba ni 
BO_TZ_PEMA-SANGTHIG-P32:261	lha tshhogs rnams kyi mgrin pa nas sngags kyi phreng ba dpag tu med pa byung /	26	lha tshhogs rnams kyi mgrin ba nas sngags kyi phreng ba dpog tu med ba byung 
BO_TZ_PEMA-SANGTHIG-P32:262	khyed rang rnams kyi mgrin par thim pas gsung gi byin rlabs rgyud la zhugs par bsam la phreng ba sbrel te rtsha sngags lan gsum rjes zlos byar gzhug	26	khyed rang rnams kyi mgrin ba thim ba gsung gi byin rlabs brgyud la jug ba bsam la phreng ba sbrel te rtsha sngags lan gsum rjes zlos byar jug 
BO_TZ_PEMA-SANGTHIG-P32:263	/de brtan par bya ba'i slad du sngags phreng mgrin par bzhag ste dbang bskur bar bsam la /	26	brtan ba byed ba slad du sngags phreng mgrin ba jog ste dbang skur ba bsam la 
BO_TZ_PEMA-SANGTHIG-P32:264	a: brjod pa kun gyi gzhi ru gnas gyur pa'i :	26	a: rjod ba kun gyi gzhi ru gnas gyur ba 
BO_TZ_PEMA-SANGTHIG-P32:265	ngag la rdo rje'i sngags kyi dbang bskur pas :	26	ngag la rdo rje sngags kyi dbang skur ba 
BO_TZ_PEMA-SANGTHIG-P32:266	grags stong rdo rje'i rol mor 'byams klas pa :	26	grags stong rdo rje rol mor byam klas ba 
BO_TZ_PEMA-SANGTHIG-P32:267	mi 'gag gsung gi dbang mchog thob par shog :	26	mi gag gsung gi dbang mchog thob ba shog 
BO_TZ_PEMA-SANGTHIG-P32:268	wa ka badzra a b+hi shiny+tsha a:	26	wa ka badzra a b+hi shiny+tsha a: 
BO_TZ_PEMA-SANGTHIG-P32:269	thugs 'od gsal gyi dgongs pa ngo sprad pa'i slad du dwangs gsal me long snying gar bzhag ste /	26	thugs d gsal gyi dgongs ba ngo sprod ba slad du dwangs gsal me long snying gar jog ste 
BO_TZ_PEMA-SANGTHIG-P32:270	spros bral don gyi ye shes rgyud la 'phos pa'i mos pa mdzod cig	27	spros bral don gyi ye shes brgyud la pho ba mos ba mdzod cig 
BO_TZ_PEMA-SANGTHIG-P32:271	/hu~m: ma bcos spros dang bral ba'i rang rig pa :	27	ma chos spros dang bral ba rang rig ba 
BO_TZ_PEMA-SANGTHIG-P32:272	'od gsal ka nas dag pa gdod ma'i gshis :	27	d gsal ka nas dag ba gdod ma gshis 
BO_TZ_PEMA-SANGTHIG-P32:273	ye grol lhun 'byams dgongs pa'i srog gtad pas :	27	ye grol lhun byam dgongs ba srog gtod ba 
BO_TZ_PEMA-SANGTHIG-P32:274	mi shigs thugs kyi dbang mchog thob par shog :	27	mi shigs thugs kyi dbang mchog thob ba shog 
BO_TZ_PEMA-SANGTHIG-P32:275	tshit+ta badzra a b+hi shiny+tsha hu~m:	27	tshit+ta badzra a b+hi shiny+tsha hu~m: 
BO_TZ_PEMA-SANGTHIG-P32:276	de ltar rdo rje'i sku gsung thugs su lhun gyis grub pa la /	27	de ltar rdo rje sku gsung thugs su lhun gyis grub ba la 
BO_TZ_PEMA-SANGTHIG-P32:277	sgeg sogs mchod pa'i lha mo las rang snang gi sku gnyis pa re 'phros te 'dod yon gyi rol pas mnga' gsol ba'i mos pa mdzod cig	27	sgeg sogs mchod ba lha mo las rang snang gi sku gnyis ba re phro te dod yon gyi rol ba mnga gsol ba mos ba mdzod cig 
BO_TZ_PEMA-SANGTHIG-P32:278	/tram: dga' ba bzhi dang stong pa bzhi :	27	dga ba bzhi dang stong ba bzhi 
BO_TZ_PEMA-SANGTHIG-P32:279	lha yi phyag rgyar rang shar ba'i :	27	lha yi phyag rgyar rang char ba 
BO_TZ_PEMA-SANGTHIG-P32:280	sgeg sogs mchod pa'i lha mo yi :	28	sgeg sogs mchod ba lha mo yi 
BO_TZ_PEMA-SANGTHIG-P32:281	yon tan rab 'byams dbang mchog bskur :	28	yon tan rab byam dbang mchog skur 
BO_TZ_PEMA-SANGTHIG-P32:282	om badzra la s+yai ma l+ye girti nirti push+pe d+hu pe a lo ke gan+d+he ahhu~m:	28	om badzra la s+yai ma l+ye girti nirti push+pe d+hu pe a lo ke gan+d+he ahhu~m: 
BO_TZ_PEMA-SANGTHIG-P32:283	brjod cing mnga' gsol /	28	rjod cing mnga gsol 
BO_TZ_PEMA-SANGTHIG-P32:284	de nas rdo rje dril bu lag tu gtad cing bdag po chen po'i dbang bskur ba ni /	28	de nas rdo rje dril bu lag tu gtod cing bdag po chen po dbang skur ba ni 
BO_TZ_PEMA-SANGTHIG-P32:285	hu~m: khyod ni rdo rje slob dpon te :	28	hu~m: khyod ni rdo rje slob dpon te 
BO_TZ_PEMA-SANGTHIG-P32:286	las rnams ma lus kun byos shig :	28	las rnams ma lus kun byos shig 
BO_TZ_PEMA-SANGTHIG-P32:287	sku gsung thugs kyi dam bzung la :	28	sku gsung thugs kyi dam bzung la 
BO_TZ_PEMA-SANGTHIG-P32:288	khams gsum dag pa'i sa la skyol :	28	khams gsum dag ba sa la skyol 
BO_TZ_PEMA-SANGTHIG-P32:289	badzra ka wa tshi sa ma ya b+ho d+hi tshit+ta a:	28	badzra ka wa tshi sa ma ya b+ho d+hi tshit+ta a: 
BO_TZ_PEMA-SANGTHIG-P32:290	sku gsung thugs kyi dam tshhig sbyin /	29	sku gsung thugs kyi dam tshhig sbyin 
BO_TZ_PEMA-SANGTHIG-P32:291	dkyil 'khor gyi phrin las sgo ma'i sku las sku gnyis pa re 'phros te khyed rang rnams kyi lag tu gtad pas las bzhi'i phrin las lhun gyis grub par bsam la /	29	dkyil khor gyi phrin las sgo ma sku las sku gnyis ba re phro te khyed rang rnams kyi lag tu gtod ba las bzhi phrin las lhun gyis grub ba bsam la 
BO_TZ_PEMA-SANGTHIG-P32:292	hri: tshhad med bzhi po gnas dag pa'i :	29	hri: tshhad med bzhi po gnas dag ba 
BO_TZ_PEMA-SANGTHIG-P32:293	mi shigs sprul pa'i sgo ma bzhi :	29	mi shigs sprul ba sgo ma bzhi 
BO_TZ_PEMA-SANGTHIG-P32:294	lha sku phyag rgya'i dbang bskur pas :	29	lha sku phyag rgya dbang skur ba 
BO_TZ_PEMA-SANGTHIG-P32:295	phrin las rab 'byams dbang thob shog :	29	phrin las rab byam dbang thob shog 
BO_TZ_PEMA-SANGTHIG-P32:296	dzahhu~m bam hoha b+hi shiny+tsha hu~m:	29	dzahhu~m bam hoha b+hi shiny+tsha hu~m: 
BO_TZ_PEMA-SANGTHIG-P32:297	de dag gi mtshhan ma rdzas kyi dkyil 'khor du spros bcas bum pa'i dbang bskur pa thob /	29	de dag gi mtshhan ma rdzas kyi dkyil khor du spros cha bum ba dbang skur ba thob 
BO_TZ_PEMA-SANGTHIG-P32:298	lus kyi sgrib pa dag	29	lus kyi sgrib ba dag 
BO_TZ_PEMA-SANGTHIG-P32:299	/lam snang stong chu zla lta bu lha yi bskyed rim sgom pa la dbang /	29	snang stong chu zla lta bu lha yi skyed rim sgom ba la dbang 
BO_TZ_PEMA-SANGTHIG-P32:300	rnam smin rig 'dzin gyi sa bon thebs /	30	rnam smin rig dzin gyi sa bon thebs 
BO_TZ_PEMA-SANGTHIG-P32:301	'bras bu sprul pa'i sku thob pa'i skal pa rgyud la bzhag pa yin no //	30	bras bu sprul ba sku thob ba skal ba brgyud la jog ba yin no 
BO_TZ_PEMA-SANGTHIG-P32:302	de ltar bum pa'i dbang bskur pa dang 'brel ba'i lam snang stong chu zla lta bu'i bskyed rim bsgom pa'i tshhul yang rdo rje'i rgyud kyi tshhig don la gsan pas khyab par gda'/	30	de ltar bum ba dbang skur ba dang brel ba lam snang stong chu zla lta bu skyed rim bsgom ba tshhul yang rdo rje brgyud kyi tshhig don la gsan ba khyab ba 
BO_TZ_PEMA-SANGTHIG-P32:303	zhes brjod la rtsha ba'i rgyud kyi dbu nas le'u dang po dang / de rjes ma tshhang kha skong gi rgyud yongs rdzogs /	30	zhes rjod la rtsha ba brgyud kyi dbu nas leu dang po dang de rjes ma tshhang kha skong gi brgyud yongs rdzogs 
BO_TZ_PEMA-SANGTHIG-P32:304	de nas le'u gnyis pa'i rjes bar tshhang ba dal bar brjod /	30	de nas leu gnyis ba rjes ba tshhang ba dal ba rjod 
BO_TZ_PEMA-SANGTHIG-P32:305	de nas zur gsal thun mong tshhe yi dbang bskur skabs 'dir bya /	30	de nas zur gsal thun mong tshhe yi dbang skur skabs dir byed 
BO_TZ_PEMA-SANGTHIG-P32:306	gnyis pa spros med gsang ba'i dbang bskur ba ni /	30	gnyis ba spros med gsang ba dbang skur ba ni 
BO_TZ_PEMA-SANGTHIG-P32:307	bla ma longs spyod yongs rdzogs tshhe mtha' yas pa'i spyan sngar bcu gsum lon pa'i rig ma rgyan dang ldan pa dang / gser la sogs pa'i man+dal phul bar mos la zhing khams 'bul du gzhug	30	bla ma longs spyod yongs rdzogs tshhe mtha yas ba spyan sngar chu gsum lon ba rig ma rgyan dang ldan ba dang gser la sogs ba man+dal bul ba mos la zhing khams bul du jug 
BO_TZ_PEMA-SANGTHIG-P32:308	/thal mo snying gar sbyar te gsol ba 'debs pa 'di'i rjes zlos /	30	mo snying gar sbyor te gsol ba debs ba di rjes zlos 
BO_TZ_PEMA-SANGTHIG-P32:309	e ma ho :	30	e ma ho 
BO_TZ_PEMA-SANGTHIG-P32:310	ngo mtshhar rmad du byung ba yi :	31	ngo mtshhar rmad du byung ba yi 
BO_TZ_PEMA-SANGTHIG-P32:311	rdo rje bdud rtshi dri med mchog :	31	rdo rje bdud rtshi dri med mchog 
BO_TZ_PEMA-SANGTHIG-P32:312	ma rig nyes pa 'joms byed pa :	31	ma rig nyes ba joms byed ba 
BO_TZ_PEMA-SANGTHIG-P32:313	gsang ba'i dam pa bdag la stshol :	31	gsang ba dam ba bdag la stshol 
BO_TZ_PEMA-SANGTHIG-P32:314	lan gsum / de nas bla ma pad+ma 'byung :	31	lan gsum de nas bla ma pad+ma byung 
BO_TZ_PEMA-SANGTHIG-P32:315	rig ma bde chen man+da ra :	31	rig ma bde chen man+da ra 
BO_TZ_PEMA-SANGTHIG-P32:316	mnyam sbyor dga' ba'i sgra dang ni :	31	mnyam sbyor dga ba sgra dang ni 
BO_TZ_PEMA-SANGTHIG-P32:317	bde ba'i 'od kyis sad byas pa'i :	31	bde ba d kyis sad byed ba 
BO_TZ_PEMA-SANGTHIG-P32:318	phyogs bcu'i rgyal ba ma lus pa :	31	phyogs chu rgyal ba ma lus ba 
BO_TZ_PEMA-SANGTHIG-P32:319	zhal zhugs sku yi dbyibs brgyud nas :	31	zhal jug sku yi dbyibs brgyud nas 
BO_TZ_PEMA-SANGTHIG-P32:320	mkha' gsang pad+mo bde chen por :	32	mkha gsang pad+mo bde chen por 
BO_TZ_PEMA-SANGTHIG-P32:321	dkar dmar 'dres pa'i byang sems kyi :	32	dkar dmar dre ba byang sems kyi 
BO_TZ_PEMA-SANGTHIG-P32:322	rnam par 'od zhu 'khyil pa nyid :	32	rnam ba d ju khyil ba nyid 
BO_TZ_PEMA-SANGTHIG-P32:323	yum gyi mkha' las lce yis blang :	32	yum gyi mkha las lce yis blang 
BO_TZ_PEMA-SANGTHIG-P32:324	zhes mos la ka pa la'i bdud rtshi lce thog tu bzhag la /	32	zhes mos la ka ba la bdud rtshi lce thogs tu jog la 
BO_TZ_PEMA-SANGTHIG-P32:325	e ma ho :	32	e ma ho 
BO_TZ_PEMA-SANGTHIG-P32:326	'di ni sangs rgyas thams cad kyi :	32	di ni sangs rgya thams cad kyi 
BO_TZ_PEMA-SANGTHIG-P32:327	gsang gsum las byung rdo rje'i chu :	32	gsang gsum las byung rdo rje chu 
BO_TZ_PEMA-SANGTHIG-P32:328	myang bas ma rig nyes pa 'joms :	32	myang ba ma rig nyes ba joms 
BO_TZ_PEMA-SANGTHIG-P32:329	tshhe la dbang ba'i rig 'dzin 'grub :	32	tshhe la dbang ba rig dzin grub 
BO_TZ_PEMA-SANGTHIG-P32:330	a ho ma ha su kha sid+d+hi sa ma ya :	33	a ho ma ha su kha sid+d+hi sa ma ya 
BO_TZ_PEMA-SANGTHIG-P32:331	de ltar gsang ba'i dbang bskur pas /	33	de ltar gsang ba dbang skur ba 
BO_TZ_PEMA-SANGTHIG-P32:332	ngag gi sgrib pa dag	33	ngag gi sgrib ba dag 
BO_TZ_PEMA-SANGTHIG-P32:333	/bdag byin gyis brlab pa'i rnal 'byor sgom pa la dbang /	33	byin gyis brlab ba rnal byor sgom ba la dbang 
BO_TZ_PEMA-SANGTHIG-P32:334	tshhe dbang rig 'dzin gyi sa bon thebs /	33	tshhe dbang rig dzin gyi sa bon thebs 
BO_TZ_PEMA-SANGTHIG-P32:335	longs spyod rdzogs pa'i sku thob pa'i skal pa rgyud la bzhag par mos shig	33	longs spyod rdzogs ba sku thob ba skal ba brgyud la jog ba mos shig 
BO_TZ_PEMA-SANGTHIG-P32:336	/de ltar gsang dbang dang 'brel ba'i lam rim rtsha rlung thig le'i rnal 'byor bsgom pa'i tshhul yang 'di la gsan pas khyab par gda'/	33	ltar gsang dbang dang brel ba lam rim rtsha rlung thig le rnal byor bsgom ba tshhul yang di la gsan ba khyab ba 
BO_TZ_PEMA-SANGTHIG-P32:337	zhes brjod la slar yang byang chub kyi sogs le'u gsum pa mjug yan rdzogs par 'don /	33	zhes rjod la slar yang byang chub kyi sogs leu gsum ba mjug yan rdzogs ba don 
BO_TZ_PEMA-SANGTHIG-P32:338	gsum pa shin tu spros med shes rab ye shes kyi dbang bskur ba la /	33	gsum ba shin tu spros med shes rab ye shes kyi dbang skur ba la 
BO_TZ_PEMA-SANGTHIG-P32:339	bla ma 'chi med chos sku'i rang bzhin gsal ba'i spyan sngar bcu drug lon pa'i rig ma rgyan gyis spras pa dang / gser g.yu'i man+dal 'bul bar bsam la zhing khams 'bul du gzhug	33	bla ma chi med chos sku rang bzhin gsal ba spyan sngar chu drug lon ba rig ma rgyan gyis spras ba dang gser g.yu man+dal bul ba bsam la zhing khams bul du jug 
BO_TZ_PEMA-SANGTHIG-P32:340	/gsol ba 'debs pa 'di'i rjes zlos /	34	ba debs ba di rjes zlos 
BO_TZ_PEMA-SANGTHIG-P32:341	e ma ho :	34	e ma ho 
BO_TZ_PEMA-SANGTHIG-P32:342	rab tu zhi ba'i bdag nyid kyi :	34	rab tu zhi ba bdag nyid kyi 
BO_TZ_PEMA-SANGTHIG-P32:343	sku gsung thugs kyi phyag rgya ni :	34	sku gsung thugs kyi phyag rgya ni 
BO_TZ_PEMA-SANGTHIG-P32:344	rdo rje sbyor las yang dag byung :	34	rdo rje sbyor las yang dag byung 
BO_TZ_PEMA-SANGTHIG-P32:345	mnga' bdag chen pos bdag la stshol :	34	mnga bdag chen pos bdag la stshol 
BO_TZ_PEMA-SANGTHIG-P32:346	lan gsum / mtshhan nyid ldan pa'i rig ma ni :	34	lan gsum mtshhan nyid ldan ba rig ma ni 
BO_TZ_PEMA-SANGTHIG-P32:347	sangs rgyas ma lus pang bkod de :	34	sangs rgya ma lus pang bkod de 
BO_TZ_PEMA-SANGTHIG-P32:348	yang dag thar pa brten pa'i phyir :	34	yang dag thar ba rten ba phyir 
BO_TZ_PEMA-SANGTHIG-P32:349	snying gi bu la gdam par bya :	34	snying gi bu la gdam ba byed 
BO_TZ_PEMA-SANGTHIG-P32:350	dngos sam rig tshaka gtad la /	35	dngos sam rig tshaka gtod la 
BO_TZ_PEMA-SANGTHIG-P32:351	om: dus gsum sangs rgyas thams cad kyang :	35	om: dus gsum sangs rgya thams cad kyang 
BO_TZ_PEMA-SANGTHIG-P32:352	thabs 'dir brten nas rdzogs sangs rgyas :	35	thabs dir rten nas rdzogs sangs rgya 
BO_TZ_PEMA-SANGTHIG-P32:353	phyag rgya chen po'i rig 'dzin 'grub :	35	phyag rgya chen po rig dzin grub 
BO_TZ_PEMA-SANGTHIG-P32:354	rmongs pa gang zhig 'di spong ba :	35	rmongs ba gang jig di spong ba 
BO_TZ_PEMA-SANGTHIG-P32:355	de la mchog gi dngos grub med :	35	de la mchog gi dngos grub med 
BO_TZ_PEMA-SANGTHIG-P32:356	gzungs ma yid 'ong nyams dga' ba :	35	gzungs ma yid ng nyams dga ba 
BO_TZ_PEMA-SANGTHIG-P32:357	bsten byar sangs rgyas rnams kyis bsngags :	35	sten byar sangs rgya rnams kyis bsngags 
BO_TZ_PEMA-SANGTHIG-P32:358	'khor lo'i gnas bzhi'i dga' ba che :	35	khor lo gnas bzhi dga ba che 
BO_TZ_PEMA-SANGTHIG-P32:359	bde chen chos nyid rtogs par gyis :	35	bde chen chos nyid rtogs ba gyis 
BO_TZ_PEMA-SANGTHIG-P32:360	b+hany+dza mok+sha ho :	36	b+hany+dza mok+sha ho 
BO_TZ_PEMA-SANGTHIG-P32:361	zhes gtad pas rig ma des gsang ba'i gnas la spro ba dri ba ni 'di la gsan pas khyab ste /	36	zhes gtod ba rig ma des gsang ba gnas la spro ba dri ba ni di la gsan ba khyab ste 
BO_TZ_PEMA-SANGTHIG-P32:362	bud med rnams la rab gus shing :	36	bud med rnams la rab gus shing 
BO_TZ_PEMA-SANGTHIG-P32:363	bshang lci khu khrag la sogs bza':	36	bshang lci khu khrag la sogs bza: 
BO_TZ_PEMA-SANGTHIG-P32:364	pad+mor bde ba'i 'o byed par :	36	pad+mor bde ba mang byed ba 
BO_TZ_PEMA-SANGTHIG-P32:365	bu khyod ci dgar spro 'am smros :	36	bu khyod ci dgar spro mang smros 
BO_TZ_PEMA-SANGTHIG-P32:366	lan gdab pa 'di'i rjes zlos /	36	lan gdab ba di rjes zlos 
BO_TZ_PEMA-SANGTHIG-P32:367	bshang lci la sogs dwangs bas za :	36	bshang lci la sogs dwangs ba za 
BO_TZ_PEMA-SANGTHIG-P32:368	bud med rnams la rtag par gus :	36	bud med rnams la rtag ba gus 
BO_TZ_PEMA-SANGTHIG-P32:369	b+ha ga'i pad+mor 'o byed par :	36	b+ha ga pad+mor mang byed ba 
BO_TZ_PEMA-SANGTHIG-P32:370	bdag ni ci dgar spro lags so :	37	bdag ni ci dgar spro lags so 
BO_TZ_PEMA-SANGTHIG-P32:371	de nas lha mo des dbyings phyug gsang ba'i rtsha bstan te /	37	de nas lha mo des dbyings phyug gsang ba rtsha ston te 
BO_TZ_PEMA-SANGTHIG-P32:372	nga yi b+ha ga gsang chen 'di :	37	nga yi b+ha ga gsang chen di 
BO_TZ_PEMA-SANGTHIG-P32:373	sangs rgyas kun gyi bzhugs gnas yin :	37	sangs rgya kun gyi bzhugs gnas yin 
BO_TZ_PEMA-SANGTHIG-P32:374	dbab gzung ldog khyab sbyor ba yis :	37	bebs gzung ldog khyab sbyor ba yis 
BO_TZ_PEMA-SANGTHIG-P32:375	bde chen chos nyid rtogs par gyis :	37	bde chen chos nyid rtogs ba gyis 
BO_TZ_PEMA-SANGTHIG-P32:376	zhes pas pang du 'khod pa la /	37	zhes ba pang du khod ba la 
BO_TZ_PEMA-SANGTHIG-P32:377	slob ma bde ba chen po pad+ma sam b+ha wa rig ma lha lcam man+da rahba /	37	slob ma bde ba chen po pad+ma sam b+ha wa rig ma lha lcam man+da rahba 
BO_TZ_PEMA-SANGTHIG-P32:378	mkha' gsang rdo rje dang pad+ma /	37	mkha gsang rdo rje dang pad+ma 
BO_TZ_PEMA-SANGTHIG-P32:379	thabs 'di la brten nas rang gnas kyi ye shes mngon du bya'o snyam pas snyom par zhugs par bsam la /	37	thabs di la rten nas rang gnas kyi ye shes mngon du byed snyam ba snyom ba jug ba bsam la 
BO_TZ_PEMA-SANGTHIG-P32:380	om sarba ta tha ga ta ma ha u nu ra ga na badzra swa b+ha wa at+ma ko\u0f85 ham:	38	om sarba ta tha ga ta ma ha u nu ra ga na badzra swa b+ha wa at+ma ko\u0f85 ham: 
BO_TZ_PEMA-SANGTHIG-P32:381	zhes snyom par zhugs pas dga' bral gyi rang ngo bskyang du gzhug	38	zhes snyom ba jug ba dga bral gyi rang ngo skyong du jug 
BO_TZ_PEMA-SANGTHIG-P32:382	/de ltar shes rab ye shes kyi dbang bskur pas /	38	ltar shes rab ye shes kyi dbang skur ba 
BO_TZ_PEMA-SANGTHIG-P32:383	yid kyi dri ma dag	38	yid kyi dri ma dag 
BO_TZ_PEMA-SANGTHIG-P32:384	/lam gzhan lus pho nya'i rnal 'byor sgom pa la dbang /	38	gzhan lus pho nya rnal byor sgom ba la dbang 
BO_TZ_PEMA-SANGTHIG-P32:385	phyag chen rig 'dzin gyi sa bon thebs /	38	phyag chen rig dzin gyi sa bon thebs 
BO_TZ_PEMA-SANGTHIG-P32:386	'bras bu chos sku thob pa'i skal pa rgyud la bzhag par bsam /	38	bras bu chos sku thob ba skal ba brgyud la jog ba bsam 
BO_TZ_PEMA-SANGTHIG-P32:387	de ltar sher dbang bskur pa dang 'brel ba'i lam gyi rim pa gzhan lus bde ba chen po'i rnal 'byor bsgom pa yang 'di la gsan pas khyab par gda'/	38	de ltar sher dbang skur ba dang brel ba lam gyi rim ba gzhan lus bde ba chen po rnal byor bsgom ba yang di la gsan ba khyab ba 
BO_TZ_PEMA-SANGTHIG-P32:388	zhes brjod la /	38	zhes rjod la 
BO_TZ_PEMA-SANGTHIG-P32:389	slar yang zung 'jug sogs nas /	38	slar yang zung jug sogs nas 
BO_TZ_PEMA-SANGTHIG-P32:390	bzhi pa rdzogs so :	39	bzhi ba rdzogs so 
BO_TZ_PEMA-SANGTHIG-P32:391	zhes pa'i bar brjod /	39	zhes ba ba rjod 
BO_TZ_PEMA-SANGTHIG-P32:392	de nas bzhi pa rab tu spros med de kho na nyid kyi dbang bskur zhu ba'i slad du bla ma kun tu bzang po ngo bo nyid sku'i spyan sngar bu dang / chung ma /	39	de nas bzhi ba rab tu spros med de kho na nyid kyi dbang skur ju ba slad du bla ma kun tu bzang po ngo bo nyid sku spyan sngar bu dang chung ma 
BO_TZ_PEMA-SANGTHIG-P32:393	rin po che dang / nor la sogs pa gces rgu'i bdog pa 'bul ba'i mos pas man+dal 'bul du gzhug	39	rin po che dang nor la sogs ba gces rgu bdog ba bul ba mos ba man+dal bul du jug 
BO_TZ_PEMA-SANGTHIG-P32:394	/gsol ba 'debs pa 'di'i rjes zlos /	39	ba debs ba di rjes zlos 
BO_TZ_PEMA-SANGTHIG-P32:395	e ma ho :	39	e ma ho 
BO_TZ_PEMA-SANGTHIG-P32:396	kun tu bzang po che ba'i mchog :	39	kun tu bzang po che ba mchog 
BO_TZ_PEMA-SANGTHIG-P32:397	sangs rgyas kun gyi bdag nyid che :	39	sangs rgya kun gyi bdag nyid che 
BO_TZ_PEMA-SANGTHIG-P32:398	dkyil 'khor gtsho bo'i bka' drin gyis :	39	dkyil khor gtsho bo bka drin gyis 
BO_TZ_PEMA-SANGTHIG-P32:399	rab tu spros med dbang bskur stshol :	39	rab tu spros med dbang skur stshol 
BO_TZ_PEMA-SANGTHIG-P32:400	lan gsum / de nas brgyud gsum rig 'dzin bla ma la gsol ba 'debs pa 'di rtshe gcig pa'i yid kyis gnang ba zhu /	40	lan gsum de nas brgyud gsum rig dzin bla ma la gsol ba debs ba di rtshe gcig ba yid kyis gnang ba ju 
BO_TZ_PEMA-SANGTHIG-P32:401	om ahhu~m: ka dag chos dbyings zhing khams na :	40	om ahhu~m: ka dag chos dbyings zhing khams na 
BO_TZ_PEMA-SANGTHIG-P32:402	chos sku kun tu bzang po dang : dbyer med rtsha ba'i bla ma la :	40	chos sku kun tu bzang po dang dbyer med rtsha ba bla ma la 
BO_TZ_PEMA-SANGTHIG-P32:403	dgongs brgyud dag pa'i 'khor gyis bskor :	40	dgongs brgyud dag ba khor gyis skor 
BO_TZ_PEMA-SANGTHIG-P32:404	rnal 'byor gdung bas gsol ba 'debs :	40	rnal byor gdung ba gsol ba debs 
BO_TZ_PEMA-SANGTHIG-P32:405	ka dag gzhi thog phebs pa yi :	40	ka dag gzhi thogs phebs ba yi 
BO_TZ_PEMA-SANGTHIG-P32:406	'od gsal dgongs pas byin gyis rlobs :	40	d gsal dgongs ba byin gyis rlobs 
BO_TZ_PEMA-SANGTHIG-P32:407	yon tan lhun rdzogs zhing khams na :	40	yon tan lhun rdzogs zhing khams na 
BO_TZ_PEMA-SANGTHIG-P32:408	longs sku rigs lnga'i sangs rgyas dang : dbyer med rtsha ba'i bla ma la :	40	longs sku rigs lnga sangs rgya dang dbyer med rtsha ba bla ma la 
BO_TZ_PEMA-SANGTHIG-P32:409	brda brgyud rig pa'i 'khor gyis bskor :	40	brda brgyud rig ba khor gyis skor 
BO_TZ_PEMA-SANGTHIG-P32:410	rnal 'byor gdung bas gsol ba 'debs :	41	rnal byor gdung ba gsol ba debs 
BO_TZ_PEMA-SANGTHIG-P32:411	ka dag gzhi thog phebs pa yi :	41	ka dag gzhi thogs phebs ba yi 
BO_TZ_PEMA-SANGTHIG-P32:412	'od gsal dgongs pas byin gyis rlobs :	41	d gsal dgongs ba byin gyis rlobs 
BO_TZ_PEMA-SANGTHIG-P32:413	gang 'dul rol pa'i zhing khams na :	41	gang dul rol ba zhing khams na 
BO_TZ_PEMA-SANGTHIG-P32:414	sprul sku rigs gsum mgon po dang : dbyer med rtsha ba'i bla ma la :	41	sprul sku rigs gsum mgon po dang dbyer med rtsha ba bla ma la 
BO_TZ_PEMA-SANGTHIG-P32:415	snyan brgyud sprul pa'i 'khor gyis bskor :	41	snyan brgyud sprul ba khor gyis skor 
BO_TZ_PEMA-SANGTHIG-P32:416	rnal 'byor gdung bas gsol ba 'debs :	41	rnal byor gdung ba gsol ba debs 
BO_TZ_PEMA-SANGTHIG-P32:417	ka dag gzhi thog phebs pa yi :	41	ka dag gzhi thogs phebs ba yi 
BO_TZ_PEMA-SANGTHIG-P32:418	'od gsal dgongs pas byin gyis rlobs :	41	d gsal dgongs ba byin gyis rlobs 
BO_TZ_PEMA-SANGTHIG-P32:419	lang ka dpal gyi grong khyer che :	41	lang ka dpal gyi grong khyer che 
BO_TZ_PEMA-SANGTHIG-P32:420	bde chen pad+ma 'od zhing na :	42	bde chen pad+ma d zhing na 
BO_TZ_PEMA-SANGTHIG-P32:421	rtsha gsum kun 'dus pad+ma 'byung :	42	rtsha gsum kun du pad+ma byung 
BO_TZ_PEMA-SANGTHIG-P32:422	dbyer med rtsha ba'i bla ma la :	42	dbyer med rtsha ba bla ma la 
BO_TZ_PEMA-SANGTHIG-P32:423	rig 'dzin grub thob rgya mtshhos bskor :	42	rig dzin grub thob rgya mtshhos skor 
BO_TZ_PEMA-SANGTHIG-P32:424	rnal 'byor gdung bas gsol ba 'debs :	42	rnal byor gdung ba gsol ba debs 
BO_TZ_PEMA-SANGTHIG-P32:425	ka dag gzhi thog phebs pa yi :	42	ka dag gzhi thogs phebs ba yi 
BO_TZ_PEMA-SANGTHIG-P32:426	lus la sku yi byin gyis rlobs :	42	lus la sku yi byin gyis rlobs 
BO_TZ_PEMA-SANGTHIG-P32:427	rdo rje'i sku ru 'grub par mdzod :	42	rdo rje sku ru grub ba mdzod 
BO_TZ_PEMA-SANGTHIG-P32:428	ngag la gsung gi byin gyis rlobs :	42	ngag la gsung gi byin gyis rlobs 
BO_TZ_PEMA-SANGTHIG-P32:429	'gag med na dar 'grub par mdzod :	42	gag med na dar grub ba mdzod 
BO_TZ_PEMA-SANGTHIG-P32:430	yid la thugs kyi byin gyis rlobs :	43	yid la thugs kyi byin gyis rlobs 
BO_TZ_PEMA-SANGTHIG-P32:431	'od gsal thugs su 'grub par mdzod :	43	d gsal thugs su grub ba mdzod 
BO_TZ_PEMA-SANGTHIG-P32:432	om ahhu~m gu ru d+he wa dak+ki ni sarba man+dal badzra sa ma ya dzahsid+d+hi pha la hu~m hu~m a a:	43	om ahhu~m gu ru d+he wa dak+ki ni sarba man+dal badzra sa ma ya dzahsid+d+hi pha la hu~m hu~m a a: 
BO_TZ_PEMA-SANGTHIG-P32:433	zhes pas byin dbab /	43	zhes ba byin bebs 
BO_TZ_PEMA-SANGTHIG-P32:434	de nas slob ma rnam snang gi chos bdun bcas la sems dus gsum spros pa bcad la /	43	de nas slob ma rnam snang gi chos bdun cha la sems dus gsum spros ba gcod la 
BO_TZ_PEMA-SANGTHIG-P32:435	bla mas phatahdrag po zhig brjod rjes /	43	bla mas phatahdrag po jig rjod rjes 
BO_TZ_PEMA-SANGTHIG-P32:436	sems gang yin zhes lan gsum rtab rtab tu dris pas /	43	sems gang yin zhes lan gsum rtab rtab tu dri ba 
BO_TZ_PEMA-SANGTHIG-P32:437	smra bsam yang brjod du med pa'i don mngon du gyur pa la ngo sprad pa ni /	43	smra bsam yang rjod du med ba don mngon du gyur ba la ngo sprod ba ni 
BO_TZ_PEMA-SANGTHIG-P32:438	e ma ho :	43	e ma ho 
BO_TZ_PEMA-SANGTHIG-P32:439	rang byung rig pa'i skyes bu nyon :	43	rang byung rig ba skye bu nyon 
BO_TZ_PEMA-SANGTHIG-P32:440	bzhi cha gsum bral gdod ma'i gshis :	44	bzhi cha gsum bral gdod ma gshis 
BO_TZ_PEMA-SANGTHIG-P32:441	kun la khyab pa nam mkha' bzhin :	44	kun la khyab ba nam mkha bzhin 
BO_TZ_PEMA-SANGTHIG-P32:442	smrar med myong ba'i bdag nyid can :	44	smrar med myong ba bdag nyid can 
BO_TZ_PEMA-SANGTHIG-P32:443	stong dang mi stong blo las 'das :	44	stong dang mi stong blo las da 
BO_TZ_PEMA-SANGTHIG-P32:444	mtha' brgyad grub mthas ma reg pa :	44	mtha brgyad grub mthas ma reg ba 
BO_TZ_PEMA-SANGTHIG-P32:445	yid dpyod 'dzin pa'i 'phrang las grol :	44	yid dpyod dzin ba phrangs las grol 
BO_TZ_PEMA-SANGTHIG-P32:446	'di ni mchog gi rdo rje ste :	44	di ni mchog gi rdo rje ste 
BO_TZ_PEMA-SANGTHIG-P32:447	zab mo'i don 'di sus sgom pa :	44	zab mo don di sus sgom ba 
BO_TZ_PEMA-SANGTHIG-P32:448	sangs rgyas gcer mthong e ma ho :	44	sangs rgya bcer mthong e ma ho 
BO_TZ_PEMA-SANGTHIG-P32:449	lhun grub rig 'dzin go 'phang thob :	44	lhun grub rig dzin go phen thob 
BO_TZ_PEMA-SANGTHIG-P32:450	ye shes bla ma'i sa non gyur :	45	ye shes bla ma sa non gyur 
BO_TZ_PEMA-SANGTHIG-P32:451	de'i rjes 'brel du ka dag rig pa rtshal gyi lam rim ni 'di la gsan pas khyab par gda'/	45	de rjes brel du ka dag rig ba rtshal gyi lam rim ni di la gsan ba khyab ba 
BO_TZ_PEMA-SANGTHIG-P32:452	slar yang 'khor 'das sogs /	45	slar yang khor da sogs 
BO_TZ_PEMA-SANGTHIG-P32:453	lnga pa rdzogs so :	45	lnga ba rdzogs so 
BO_TZ_PEMA-SANGTHIG-P32:454	zhes pa'i bar brjod /	45	zhes ba ba rjod 
BO_TZ_PEMA-SANGTHIG-P32:455	de nas lhun grub kyi dgongs nyams ngo sprad pa ni /	45	de nas lhun grub kyi dgongs nyams ngo sprod ba ni 
BO_TZ_PEMA-SANGTHIG-P32:456	shel dang rma bya'i mdongs sgro bstan te /	45	shel dang rma byed mdongs sgro ston te 
BO_TZ_PEMA-SANGTHIG-P32:457	gzhir gnas kun tu bzang po nyid :	45	gzhir gnas kun tu bzang po nyid 
BO_TZ_PEMA-SANGTHIG-P32:458	bzhugs stangs gsum dang gzigs stangs gsum :	45	bzhugs stangs gsum dang gzigs stangs gsum 
BO_TZ_PEMA-SANGTHIG-P32:459	lhun grub dag pa'i gnad ldan pas :	45	lhun grub dag ba gnad ldan ba 
BO_TZ_PEMA-SANGTHIG-P32:460	tshak+shu'i lam du mngon sum mthong :	46	tshak+shu lam du mngon sum mthong 
BO_TZ_PEMA-SANGTHIG-P32:461	snang ba bzhi po mthar phyin nas :	46	snang ba bzhi po mthar phyin nas 
BO_TZ_PEMA-SANGTHIG-P32:462	zag med 'od lus 'grub par 'gyur :	46	zag med d lus grub ba gyur 
BO_TZ_PEMA-SANGTHIG-P32:463	zhes brjod / de ltar lhun grub kyi lam las snang ba bzhi'i lam mthar phyin pa'i gnad la goms pa'i tshhul yang 'di la gsan pas khyab ste /	46	zhes rjod de ltar lhun grub kyi lam las snang ba bzhi lam mthar phyin ba gnad la goms ba tshhul yang di la gsan ba khyab ste 
BO_TZ_PEMA-SANGTHIG-P32:464	slar yang 'od gsal sogs nas rtsha rgyud mtha' rdzogs pa'i bar bklag	46	slar yang d gsal sogs nas rtsha brgyud mtha rdzogs ba ba klog 
BO_TZ_PEMA-SANGTHIG-P32:465	/de dag gis tshhig las 'das pa don dam gyi dbang thob /	46	dag gis tshhig las da ba don dam gyi dbang thob 
BO_TZ_PEMA-SANGTHIG-P32:466	snyom 'jug gi sgrib pa dag	46	snyom jug gi sgrib ba dag 
BO_TZ_PEMA-SANGTHIG-P32:467	/ka dag dang lhun grub kyi lam sgom pa la dbang /	46	dag dang lhun grub kyi lam sgom ba la dbang 
BO_TZ_PEMA-SANGTHIG-P32:468	lhun grub rig 'dzin gyi sa bon thebs /	46	lhun grub rig dzin gyi sa bon thebs 
BO_TZ_PEMA-SANGTHIG-P32:469	ye shes bla ma'i sa non /	46	ye shes bla ma sa non 
BO_TZ_PEMA-SANGTHIG-P32:470	'bras bu ngo bo nyid sku'i go 'phang rgyud la bzhag par bsam mo //	47	bras bu ngo bo nyid sku go phen brgyud la jog ba bsam mo 
BO_TZ_PEMA-SANGTHIG-P32:471	de ltar dbang bskur yongs su rdzogs pa la nam mkha' gang ba'i rtsha gsum rgyal ba rab 'byams rnams kyis shis pa brjod pas mnga' gsol zhing /	47	de ltar dbang skur yongs su rdzogs ba la nam mkha gang ba rtsha gsum rgyal ba rab byam rnams kyis shis ba rjod ba mnga gsol zhing 
BO_TZ_PEMA-SANGTHIG-P32:472	rdo rje'i bden tshhig gi me tog char du bsnyil bas dbang don gyi ye shes rgyud la brtan par mos shig	47	rdo rje bden tshhig gi me tog char du snyil ba dbang don gyi ye shes brgyud la brtan ba mos shig 
BO_TZ_PEMA-SANGTHIG-P32:473	/ces brjod zhal nas gsungs pa'i bkra shis kyi thog drangs /	47	rjod zhal nas gsungs ba bkra shis kyi thogs drangs 
BO_TZ_PEMA-SANGTHIG-P32:474	om ahhu~m: ngo bo stong zhing sogs las byang ltar brjod do //	47	om ahhu~m: ngo bo stong zhing sogs las byang ltar rjod do 
BO_TZ_PEMA-SANGTHIG-P32:475	gsum pa rjes kyi bya ba ni /	47	gsum ba rjes kyi byed ba ni 
BO_TZ_PEMA-SANGTHIG-P32:476	de dag gi sgo nas bde ba chen po pad+ma sam b+ha wa'i dkyil 'khor du smin byed kyi dbang bskur ba'i rim pa zab mo legs par phul grub pas /	47	de dag gi sgo nas bde ba chen po pad+ma sam b+ha wa dkyil khor du smin byed kyi dbang skur ba rim ba zab mo legs ba bul grub ba 
BO_TZ_PEMA-SANGTHIG-P32:477	skabs su thob pa'i dam tshhig dang sdom pa mi nyams par srung bar zhal gyis bzhes pa 'di'i rjes zlos /	47	skabs su thob ba dam tshhig dang sdom ba mi nyams ba srung ba zhal gyis bzhes ba di rjes zlos 
BO_TZ_PEMA-SANGTHIG-P32:478	gtsho bos ji ltar sogs lan gsum /	47	gtsho bod ji ltar sogs lan gsum 
BO_TZ_PEMA-SANGTHIG-P32:479	dbang bskur legs par thob pa'i bka' drin gtang rag gi slad du man+dal /	47	dbang skur legs ba thob ba bka drin gtong rag gi slad du man+dal 
BO_TZ_PEMA-SANGTHIG-P32:480	lus longs spyod 'bul ba 'di'i rjes zlos /	48	lus longs spyod bul ba di rjes zlos 
BO_TZ_PEMA-SANGTHIG-P32:481	deng nas brtsham ste sogs brjod /	48	deng nas brtsham ste sogs rjod 
BO_TZ_PEMA-SANGTHIG-P32:482	dge bsngo spyi ltar bya /	48	dge sngo spyi ltar byed 
BO_TZ_PEMA-SANGTHIG-P32:483	de nas slob dpon gyis tshhogs la rol ba sogs las byang mthar dbyung bas 'grub bo //	48	de nas slob dpon gyis tshhogs la rol ba sogs las byang mthar byin ba grub bo 
BO_TZ_PEMA-SANGTHIG-P32:484	gsung gi rdo rje pad+ma sam b+ha wa'i //	48	gsung gi rdo rje pad+ma sam b+ha wa 
BO_TZ_PEMA-SANGTHIG-P32:485	gsang gsum nus bcud smin byed bum pa bzang //	48	gsang gsum nus bcud smin byed bum ba bzang 
BO_TZ_PEMA-SANGTHIG-P32:486	mtshhams sbyor rin chen drwa bas mdzes byas pas //	48	mtshhams sbyor rin chen drwa ba mdzes byed ba 
BO_TZ_PEMA-SANGTHIG-P32:487	'gro kun sku bzhi'i go 'phang thob gyur cig	48	gro kun sku bzhi go phen thob gyur cig 
BO_TZ_PEMA-SANGTHIG-P32:488	/ces pa'ang dad shes kyi nor can thub bstan 'jigs med kyis bskul ba dang mtshhungs med mchog gi sprul pa'i sku gang gi thugs kyi bzhed pa skong ba'i slad du bdud 'joms nam mkha'i rdo rjes ngag nas smras rim bzhin blo gsal dge slong grags pa bstan bzang	48	ba dad shes kyi nor can thub ston jigs med kyis skul ba dang mtshhungs med mchog gi sprul ba sku gang gi thugs kyi bzhed ba skong ba slad du bdud joms nam mkha rdo rjes ngag nas smras rim bzhin blo gsal dge slong grags ba ston bzang 
BO_TZ_PEMA-SANGTHIG-P32:489	gis bris pa dge zhing bkra shis par gyur cig //	48	gis bri ba dge zhing bkra shis ba gyur cig 
