segmentnr	original	folio	stemmed
BO_TZ_Terdzo-OM-P19a:0	a+o~m swasti / rgyal kun ye shes gcig bsdus pa //	0	a+o~m swasti rgyal kun ye shes gcig sdud ba 
BO_TZ_Terdzo-OM-P19a:1	'jam pa'i rdo rje drag po'i skur //	0	jam ba rdo rje drag po skur 
BO_TZ_Terdzo-OM-P19a:2	rnam rol de la gus btud nas //	0	rnam rol de la gus dud nas 
BO_TZ_Terdzo-OM-P19a:3	sgrub thabs dbang gi cho ga bshad //	0	sgrub thabs dbang gi cho ga chad 
BO_TZ_Terdzo-OM-P19a:4	'dir 'jam dpal khro bo yang zlog me'i spu gri'i sgrub thabs dang 'brel bar rnon po nang gcod kyi dbang bskur ba la gsum ste /	0	dir jam dpal khro bo yang zlog me spu gri sgrub thabs dang brel ba rnon po nang gcod kyi dbang skur ba la gsum ste 
BO_TZ_Terdzo-OM-P19a:5	sbyor ba yo byad kyi gshom dang / dngos gzhi sgrub pa'i thabs /	0	sbyor ba yo byad kyi gshom dang dngos gzhi sgrub ba thabs 
BO_TZ_Terdzo-OM-P19a:6	dbang gi cho ga'o //	0	dbang gi cho ga 
BO_TZ_Terdzo-OM-P19a:7	dang po yo byad bsham pa ni /	0	dang po yo byad bsham ba ni 
BO_TZ_Terdzo-OM-P19a:8	stegs bu khebs ldan gyi khar 'bru tshhom bkod /	0	stegs bu khebs ldan gyi khar bru tshhom bkod 
BO_TZ_Terdzo-OM-P19a:9	dbus su many+dzi la gtor ma bra gzugs khram ris can 'khor bzhi pa sku gzugs kyi tshakli dang mda' dar nag pos brgyan pa bzhag	0	dbus su many+dzi la thor ma bra gzugs khram ris can khor bzhi ba sku gzugs kyi tshakli dang mda dar nag pos rgyan ba jog 
BO_TZ_Terdzo-OM-P19a:10	/mthar chu gnyis sngon 'gro'i nyer spyod /	1	chu gnyis sngon gro nyer spyod 
BO_TZ_Terdzo-OM-P19a:11	sman rag /gzhi bgegs kyi gtor ma sogs nye bar mkho ba'i yo byad rnams tshhogs par bya'o //	1	sman rag bgegs kyi thor ma sogs nye ba mkho ba yo byad rnams tshhogs ba byed 
BO_TZ_Terdzo-OM-P19a:12	//gnyis pa sgrub pa'i thabs la /	1	ba sgrub ba thabs la 
BO_TZ_Terdzo-OM-P19a:13	sngon gtor skyabs sems mchod rdzas byin gyis brlab pa rnams sngon du 'gro bas /	1	sngon thor skyob sems mchod rdzas byin gyis brlab ba rnams sngon du gro ba 
BO_TZ_Terdzo-OM-P19a:14	a+o~m swa b+ha wa shud+d+hahsarba d+harmahswa b+ha wa shud+d+ho\u0f85 ham/	1	a+o~m swa b+ha wa shud+d+hahsarba d+harmahswa b+ha wa shud+d+ho\u0f85 
BO_TZ_Terdzo-OM-P19a:15	chos thams cad stong nyid du sgom pa de bzhin nyid kyi ting nge 'dzin no //	1	chos thams cad stong nyid du sgom ba de bzhin nyid kyi ting nge dzin no 
BO_TZ_Terdzo-OM-P19a:16	d+harma d+ha tu a /	1	d+harma d+ha tu a 
BO_TZ_Terdzo-OM-P19a:17	snying rje chen po kun tu snang ba'i ting nge 'dzin no //	1	snying rje chen po kun tu snang ba ting nge dzin no 
BO_TZ_Terdzo-OM-P19a:18	bo d+hi tshit+ta hu~m/	1	bo d+hi tshit+ta 
BO_TZ_Terdzo-OM-P19a:19	rang rig hu~m yig mthing nag 'bar ba rgyu'i ting nge 'dzin no //	1	rang rig hu~m yig mthing nag bar ba rgyu ting nge dzin no 
BO_TZ_Terdzo-OM-P19a:20	hu~m las e yam ram bam lam rnams spros pa las nam mkha' rlung me chu sa'i dkyil 'khor gyi steng du b+h+ru~m las byang chub chen po'i mchod rten gyi bum pa'i nang du sna tshhogs rdo rje'i lte bar /	2	hu~m las e yam ram bam lam rnams spros ba las nam mkha rlung me chu sa dkyil khor gyi steng du b+h+ru~m las byang chub chen po mchod rten gyi bum ba nang du sna tshhogs rdo rje lte ba 
BO_TZ_Terdzo-OM-P19a:21	ya ma ti ra bam 'chi bdag gshin rje pho mo dang ma he glang rgod pho mo'i steng du pad nyi zla ba'i gdan la /	2	ya ma ti ra bam chi bdag gshin rje pho mo dang ma he glang rgod pho mo steng du pad nyi zla ba gdan la 
BO_TZ_Terdzo-OM-P19a:22	hu~m las rdo rje hu~m gis mtshhan pa yongs su gyur pa las /	2	hu~m las rdo rje hu~m gis mtshhan ba yongs su gyur ba las 
BO_TZ_Terdzo-OM-P19a:23	a+o~m a kro te ka ya man+ta ka hu~m phat/	2	a+o~m a kro te ka ya man+ta ka hu~m 
BO_TZ_Terdzo-OM-P19a:24	rang nyid 'jam dpal gshin rje'i gshed mthing nag dkar mthing dmar ba'i zhal gsum phyag drug pa /	2	rang nyid jam dpal gshin rje gshed mthing nag dkar mthing dmar ba zhal gsum phyag drug ba 
BO_TZ_Terdzo-OM-P19a:25	a ral+li'i sgra sgrog pa /	2	a ral+li sgra sgrog ba 
BO_TZ_Terdzo-OM-P19a:26	g.yas gsum 'khor lo ral gri rdo rje /	2	g.yas gsum khor lo ral gri rdo rje 
BO_TZ_Terdzo-OM-P19a:27	g.yon gsum lcags kyu gtun shing sdigs mdzub /	2	g.yon gsum lcags kyu gtun shing sdigs mdzub 
BO_TZ_Terdzo-OM-P19a:28	gar gyi nyams dgus rol zhing dur khrod kyi chas brgyad rdzogs pa /	2	gar gyi nyams dgus rol zhing dur khrod kyi cha brgyad rdzogs ba 
BO_TZ_Terdzo-OM-P19a:29	zhabs bzhi g.yon brkyang ba'i stabs kyis ye shes kyi me 'bar ba'i dbus na bzhugs pa /	2	zhabs bzhi g.yon rkyong ba stabs kyis ye shes kyi me bar ba dbus na bzhugs ba 
BO_TZ_Terdzo-OM-P19a:30	de'i thugs kar gser gyi 'khor lo rtshibs bzhi pa'i rtshibs la 'jam dpal zhi ba bzhi zhal nang du gzigs nas srung ba /	3	de thugs kar gser gyi khor lo rtshibs bzhi ba rtshibs la jam dpal zhi ba bzhi zhal nang du gzigs nas srung ba 
BO_TZ_Terdzo-OM-P19a:31	zlog pa'i dus su khro bo dmar nag ral gri dang zhags pa 'dzin pa phyir gzigs te zlog pa'i las mdzad pa /	3	zlog ba dus su khro bo dmar nag ral gri dang zhags ba dzin ba phyir gzigs te zlog ba las mdzad ba 
BO_TZ_Terdzo-OM-P19a:32	'khor lo'i dbus su byang chen mchod rten gyi bum par pad nyi zla ba'i steng du rdo rje rtshe lnga pa'i lte bar nyi zla kha sbyor gyi nang du b+h+ru~m yig gi khog par hu~m mthing nag e ka ya ma'i sngags kyis bskor ba /	3	khor lo dbus su byang chen mchod rten gyi bum ba pad nyi zla ba steng du rdo rje rtshe lnga ba lte ba nyi zla kha sbyor gyi nang du b+h+ru~m yig gi khog ba hu~m mthing nag e ka ya ma sngags kyis skor ba 
BO_TZ_Terdzo-OM-P19a:33	hu~m gi thig ler bla ma slob dpon khog par rang gzhan bsrung bya /	3	hu~m gi thig ler bla ma slob dpon khog ba rang gzhan bsrung byed 
BO_TZ_Terdzo-OM-P19a:34	zhabs kyu'i nang du yul 'khor nor rdzas rnams chud pa /	3	zhabs kyu nang du yul khor nor rdzas rnams chud ba 
BO_TZ_Terdzo-OM-P19a:35	rang gi thugs ka nas b+h+yo dang ya dmar nag g.yon g.yas su 'phros /	3	rang gi thugs ka nas b+h+yo dang ya dmar nag g.yon g.yas su phro 
BO_TZ_Terdzo-OM-P19a:36	g.yon du b+h+yo las yum ma mo khrag mig ma lcags kyu dang thod khrag 'dzin pa khro mo'i chas can /	3	g.yon du b+h+yo las yum ma mo khrag mig ma lcags kyu dang thod khrag dzin ba khro mo cha can 
BO_TZ_Terdzo-OM-P19a:37	g.yas su ya las sras mchog ya ma ra dza bshan gri dang dgra snying 'dzin pa mi lpags kyi gos can /	3	g.yas su ya las sras mchog ya ma ra dza bshan gri dang dgra snying dzin ba mi lpags kyi gos can 
BO_TZ_Terdzo-OM-P19a:38	gnyis ka'ang smug nag khro zhing gtum pa'i nyams can zhal gcig phyag gnyis pa 'khor tshhogs du mas bskor ba /	3	gnyis ka smug nag khro zhing thum ba nyams can zhal gcig phyag gnyis ba khor tshhogs du mas skor ba 
BO_TZ_Terdzo-OM-P19a:39	de dag gi thugs kar nyi ma la b+h+yo dang ya yig he ka dang g+h+ri ma'i sngags kyis bskor ba /	3	de dag gi thugs kar nyi ma la b+h+yo dang ya yig he ka dang g+h+ri ma sngags kyis skor ba 
BO_TZ_Terdzo-OM-P19a:40	rang gi spyi bor bla ma slob dpon /	4	rang gi spyi bor bla ma slob dpon 
BO_TZ_Terdzo-OM-P19a:41	g.yas su pho rgyud khro bo'i rang bzhin /	4	g.yas su pho brgyud khro bo rang bzhin 
BO_TZ_Terdzo-OM-P19a:42	g.yon du mo rgyud khro mo'i rang bzhin /	4	g.yon du mo brgyud khro mo rang bzhin 
BO_TZ_Terdzo-OM-P19a:43	'og tu yul mkhar sa zhing /	4	g tu yul mkhar sa zhing 
BO_TZ_Terdzo-OM-P19a:44	mdun du mi nor 'khor 'bangs rnams gsal ba dang / thugs ka'i hu~m las hu~m b+h+yo ram 'phros pa las khro bo dang khro mo me'i tshhwa tshhwa 'phro bas bgegs dang bar chad srung zhing byad phur thams cad zlog pa'i las mdzad pa /	4	mdun du mi nor khor bang rnams gsal ba dang thugs ka hu~m las hu~m b+h+yo ram phro ba las khro bo dang khro mo me tshhwa tshhwa phro ba bgegs dang ba chad srung zhing byad phur thams cad zlog ba las mdzad ba 
BO_TZ_Terdzo-OM-P19a:45	de'i phyi rol du b+h+ru~m hu~m a+o~m tram hrihahtik+sh+na man+dal yam ram bam lam e hu~m phat/	4	de phyi rol du b+h+ru~m hu~m a+o~m tram hrihahtik+sh+na man+dal yam ram bam lam e hu~m 
BO_TZ_Terdzo-OM-P19a:46	rim bzhin 'phros pa las /	4	rim bzhin phro ba las 
BO_TZ_Terdzo-OM-P19a:47	gser gyi gwa'u kha sbyor dang / rdo rje sngon po /	4	gser gyi gwau kha sbyor dang rdo rje sngon po 
BO_TZ_Terdzo-OM-P19a:48	'khor lo dkar po /	4	khor lo dkar po 
BO_TZ_Terdzo-OM-P19a:49	rin po che ser po /	4	rin po che ser po 
BO_TZ_Terdzo-OM-P19a:50	pad+ma dmar po /	5	pad+ma dmar po 
BO_TZ_Terdzo-OM-P19a:51	sna tshhogs rdo rje /	5	sna tshhogs rdo rje 
BO_TZ_Terdzo-OM-P19a:52	ral gri rlung me chu sa nam mkha' lcags kyi gur khang rnams kyi bar mtshhams so sor rigs dang mthun pa'i khro bo rang rtags kyi phyag rgya 'dzin pas srung zlog gi las mdzad pa /	5	ral gri rlung me chu sa nam mkha lcags kyi gur khang rnams kyi ba mtshhams so sor rigs dang mthun ba khro bo rang rtags kyi phyag rgya dzin ba srung zlog gi las mdzad ba 
BO_TZ_Terdzo-OM-P19a:53	de dag gi phyi rol du ye shes kyi me dpung 'bar ba'i bar snang du a li ka li'i phreng ba 'khrigs shing dgra bgegs rdul du rlogs shig ces pa'i rang sgra 'brug ltar sgrog pa /	5	de dag gi phyi rol du ye shes kyi me dpung bar ba ba snang du a li ka li phreng ba khrig shing dgra bgegs rdul du rlogs shig ces ba rang sgra brug ltar sgrog ba 
BO_TZ_Terdzo-OM-P19a:54	thams cad kyi gnas gsum du yi ge 'bru gsum gyis mtshhan pa las 'od zer 'phros pas rang bzhin gyi gnas nas ye shes pa srung ba'i gur khang dang bcas pa spyan drang par bsam la /	5	thams cad kyi gnas gsum du yi ge bru gsum gyis mtshhan ba las d zer phro ba rang bzhin gyi gnas nas ye shes ba srung ba gur khang dang cha ba spyan dren ba bsam la 
BO_TZ_Terdzo-OM-P19a:55	hu~m/ dad pa dang ni dam tshhig gis //	5	dad ba dang ni dam tshhig gis 
BO_TZ_Terdzo-OM-P19a:56	'jam dpal gshin rje yab yum spyan 'dren no //	5	jam dpal gshin rje yab yum spyan bgrang no 
BO_TZ_Terdzo-OM-P19a:57	'og min chos kyi dbyings kyi pho brang che //	5	g min chos kyi dbyings kyi pho brang che 
BO_TZ_Terdzo-OM-P19a:58	gru gsum mthing nag 'bar ba'i gzhal yas nas //	5	gru gsum mthing nag bar ba jal yas nas 
BO_TZ_Terdzo-OM-P19a:59	'phags pa'i rgyal po khro rgyal gshin rje'i gshed //	5	phag ba rgyal po khro rgyal gshin rje gshed 
BO_TZ_Terdzo-OM-P19a:60	bdag dang mtha' yas sems can don slad du //	6	bdag dang mtha yas sems can don slad du 
BO_TZ_Terdzo-OM-P19a:61	thugs rjes dgongs te gnas 'dir gshegs su gsol //	6	thugs rjes dgongs te gnas dir gshegs su gsol 
BO_TZ_Terdzo-OM-P19a:62	a+o~m many+dzu shri ya man+ta ka ya ma ra dza ma mo e ka tsha ti sa ma ya dzah	6	a+o~m many+dzu shri ya man+ta ka ya ma ra dza ma mo e ka tsha ti sa ma ya dzah 
BO_TZ_Terdzo-OM-P19a:63	zhes spyan drangs /	6	zhes spyan drangs 
BO_TZ_Terdzo-OM-P19a:64	hu~m: gru gsum mthing nag 'bar ba'i gzhal yas su :	6	hu~m: gru gsum mthing nag bar ba jal yas su 
BO_TZ_Terdzo-OM-P19a:65	gshin rje ma he nyi zla pad+ma'i steng :	6	gshin rje ma he nyi zla pad+ma steng 
BO_TZ_Terdzo-OM-P19a:66	khro rgyal gshin rje yab yum 'khor bcas rnams :	6	khro rgyal gshin rje yab yum khor cha rnams 
BO_TZ_Terdzo-OM-P19a:67	brkyang bskum 'gying bag rngam brjid tshhul gyis bzhugs su gsol :	6	rkyong skum gying bag rngam brjid tshhul gyis bzhugs su gsol 
BO_TZ_Terdzo-OM-P19a:68	sa ma ya tish+tha lhan :	6	sa ma ya tish+tha lhan 
BO_TZ_Terdzo-OM-P19a:69	zhes bzhugs su gsol /	6	zhes bzhugs su gsol 
BO_TZ_Terdzo-OM-P19a:70	hu~m: dgra bgegs ma lus thal bar rlog byed pa :	7	hu~m: dgra bgegs ma lus thal ba rlog byed ba 
BO_TZ_Terdzo-OM-P19a:71	khro rgyal gshin rje'i gshed la phyag 'tshhal lo :	7	khro rgyal gshin rje gshed la phyag tshhal lo 
BO_TZ_Terdzo-OM-P19a:72	ma mo khrag mig ma la phyag 'tshhal lo :	7	ma mo khrag mig ma la phyag tshhal lo 
BO_TZ_Terdzo-OM-P19a:73	sras mchog ya ma ra dza 'khor dang bcas la phyag 'tshhal lo :	7	sras mchog ya ma ra dza khor dang cha la phyag tshhal lo 
BO_TZ_Terdzo-OM-P19a:74	a ti pu ho :	7	a ti pu ho 
BO_TZ_Terdzo-OM-P19a:75	pra titsh+tshha ho :	7	pra titsh+tshha ho 
BO_TZ_Terdzo-OM-P19a:76	zhes phyag bya /	7	zhes phyag byed 
BO_TZ_Terdzo-OM-P19a:77	hu~m: 'phags pa'i rgyal po khro rgyal gshin rje'i gshed :	7	hu~m: phag ba rgyal po khro rgyal gshin rje gshed 
BO_TZ_Terdzo-OM-P19a:78	yab yum sras 'khor sprul pa'i tshhogs bcas la :	7	yab yum sras khor sprul ba tshhogs cha la 
BO_TZ_Terdzo-OM-P19a:79	dngos 'byor yid kyis sprul pa'i mchod tshhogs 'bul :	7	dngos byor yid kyis sprul ba mchod tshhogs bul 
BO_TZ_Terdzo-OM-P19a:80	me tog bdug spos mar me dri chab zhal zas dang : sil snyan la sogs mchod pa 'bul lo bzhes su gsol :	8	me tog bdug spros mar me dri chab zhal zas dang sil snyan la sogs mchod ba bul lo bzhes su gsol 
BO_TZ_Terdzo-OM-P19a:81	bdud rtshi sman gyi mchod pa 'bul lo bzhes su gsol //	8	bdud rtshi sman gyi mchod ba bul lo bzhes su gsol 
BO_TZ_Terdzo-OM-P19a:82	dam rdzas gtor ma'i mchod pa 'bul lo bzhes su gsol //	8	dam rdzas thor ma mchod ba bul lo bzhes su gsol 
BO_TZ_Terdzo-OM-P19a:83	rak+ta 'dod chags dug lnga'i mchod pa 'bul lo bzhes su gsol //	8	rak+ta dod chags dug lnga mchod ba bul lo bzhes su gsol 
BO_TZ_Terdzo-OM-P19a:84	sbyor sgrol rnams kyi mchod pa 'bul lo bzhes su gsol //	8	sbyor sgrol rnams kyi mchod ba bul lo bzhes su gsol 
BO_TZ_Terdzo-OM-P19a:85	ar+g+ham pa d+yam push+pe d+hu pe a lo ke gan+d+he nai bid+ya shab+da ahhu~m swa ha/	8	ar+g+ham ba d+yam push+pe d+hu pe a lo ke gan+d+he nai bid+ya shab+da ahhu~m swa 
BO_TZ_Terdzo-OM-P19a:86	zhes dang / khyad par du gtor ma ram yam kham gis bsregs gtor bkrus /	8	zhes dang khyad ba du thor ma ram yam kham gis bsregs thor khrud 
BO_TZ_Terdzo-OM-P19a:87	a+o~m ahhu~m/ dgra bgegs kyi sha khrag bdud rtshi'i rang bzhin du gyur /	8	a+o~m dgra bgegs kyi sha khrag bdud rtshi rang bzhin du gyur 
BO_TZ_Terdzo-OM-P19a:88	a+o~m sarba pany+tsha a mr-ita kha ram kha hi /	8	a+o~m sarba pany+tsha a mr-ita kha ram kha hi 
BO_TZ_Terdzo-OM-P19a:89	ma ha ba lin+ta kha\u0f8e	8	ma ha ba lin+ta kha\u0f8e 
BO_TZ_Terdzo-OM-P19a:90	ma ha rak+ta kha\u0f8e	9	ma ha rak+ta kha\u0f8e 
BO_TZ_Terdzo-OM-P19a:91	ma ha mam sa kha\u0f8e	9	ma ha mam sa kha\u0f8e 
BO_TZ_Terdzo-OM-P19a:92	ma ha kim ni ri ti kha\u0f8e	9	ma ha kim ni ri ti kha\u0f8e 
BO_TZ_Terdzo-OM-P19a:93	ma ha go ro tsha na kha\u0f8e	9	ma ha go ro tsha na kha\u0f8e 
BO_TZ_Terdzo-OM-P19a:94	ma ha tshit+ta kha\u0f8e	9	ma ha tshit+ta kha\u0f8e 
BO_TZ_Terdzo-OM-P19a:95	ma ha ba su ta kha ram kha hi /	9	ma ha ba su ta kha ram kha hi 
BO_TZ_Terdzo-OM-P19a:96	bo d+hi tshit+ta ma tram ru dra pra be sha ya phat/	9	bo d+hi tshit+ta ma tram ru dra pra be sha ya 
BO_TZ_Terdzo-OM-P19a:97	ces mchod / a+yai :	9	ces mchod a+yai 
BO_TZ_Terdzo-OM-P19a:98	chos sku skye ba med pa las :	9	chos sku skye ba med ba las 
BO_TZ_Terdzo-OM-P19a:99	spros bral bde chen dag pa'i sku :	9	spros bral bde chen dag ba sku 
BO_TZ_Terdzo-OM-P19a:100	rang bzhin gnyis su med pa'i gsung :	10	rang bzhin gnyis su med ba gsung 
BO_TZ_Terdzo-OM-P19a:101	ma bsgribs don dam rdzogs pa'i thugs :	10	ma sgrib don dam rdzogs ba thugs 
BO_TZ_Terdzo-OM-P19a:102	'gran zla kun bral yon tan ldan :	10	gran zla kun bral yon tan ldan 
BO_TZ_Terdzo-OM-P19a:103	'gro kun 'dul mdzad phrin las rdzogs :	10	gro kun dul mdzad phrin las rdzogs 
BO_TZ_Terdzo-OM-P19a:104	sku gsung thugs dang yon tan phrin las kyis :	10	sku gsung thugs dang yon tan phrin las kyis 
BO_TZ_Terdzo-OM-P19a:105	sems can don mdzad khro rgyal gshin rje'i gshed :	10	sems can don mdzad khro rgyal gshin rje gshed 
BO_TZ_Terdzo-OM-P19a:106	yab yum sras 'khor bcas la phyag 'tshhal bstod :	10	yab yum sras khor cha la phyag tshhal bstod 
BO_TZ_Terdzo-OM-P19a:107	ces bstod / bdag gis tshhe rabs thog ma med pa tshhun chad nas :	10	ces bstod bdag gis tshhe rabs thogs ma med ba tshhun chad nas 
BO_TZ_Terdzo-OM-P19a:108	da lta'i lus 'di blangs pa yan chad du :	10	da lta lus di blangs ba yan chad du 
BO_TZ_Terdzo-OM-P19a:109	lus kyis sdig byas spyod pa ngan du spyad :	10	lus kyis sdig byed spyod ba ngan du spyod 
BO_TZ_Terdzo-OM-P19a:110	ngag gis tshhig 'khyal smra ba ngan du brjod :	11	ngag gis tshhig khyal smra ba ngan du rjod 
BO_TZ_Terdzo-OM-P19a:111	yid kyis blo nor log par sems la sogs :	11	yid kyis blo nor log ba sems la sogs 
BO_TZ_Terdzo-OM-P19a:112	'dod khro gti mug dbang gis ci spyad pa :	11	dod khro gti mug dbang gis ci spyod ba 
BO_TZ_Terdzo-OM-P19a:113	bkram pa'i lha tshhogs khyed la bzod par gsol :	11	grem ba lha tshhogs khyed la bzod ba gsol 
BO_TZ_Terdzo-OM-P19a:114	zhes dang om ya ma ra dza sa ma ya ma nu pa la ya /	11	zhes dang om ya ma ra dza sa ma ya ma nu ba la ya 
BO_TZ_Terdzo-OM-P19a:115	ya ma ra dza te no pa tish+tha /	11	ya ma ra dza te no ba tish+tha 
BO_TZ_Terdzo-OM-P19a:116	dr-i d+ho me b+ha wa /	11	dr-i d+ho me b+ha wa 
BO_TZ_Terdzo-OM-P19a:117	su to sh+yo me b+ha wa /	11	su to sh+yo me b+ha wa 
BO_TZ_Terdzo-OM-P19a:118	a nu rak+to me b+ha wa /	11	a nu rak+to me b+ha wa 
BO_TZ_Terdzo-OM-P19a:119	su po sh+yo me b+ha wa /	11	su po sh+yo me b+ha wa 
BO_TZ_Terdzo-OM-P19a:120	sarba sid+d+hi m+me pra yatsh+tshha /	12	sarba sid+d+hi m+me pra yatsh+tshha 
BO_TZ_Terdzo-OM-P19a:121	sarba karma su tsha me tshit+tam/	12	sarba karma su tsha me 
BO_TZ_Terdzo-OM-P19a:122	shre yamhku ru hu~m/	12	shre yamhku ru 
BO_TZ_Terdzo-OM-P19a:123	ha ha ha ha ho /	12	ha ha ha ha ho 
BO_TZ_Terdzo-OM-P19a:124	b+ha ga wana?/ sarba ta tha ga ta /	12	b+ha ga sarba ta tha ga ta 
BO_TZ_Terdzo-OM-P19a:125	ya ma ra dza ma me muny+tsha /	12	ya ma ra dza ma me muny+tsha 
BO_TZ_Terdzo-OM-P19a:126	ya ma ra dzo b+ha ba ma ha sa ma ya satwa ah	12	ya ma ra dzo b+ha ba ma ha sa ma ya satwa ah 
BO_TZ_Terdzo-OM-P19a:127	zhes ya ma ra dza'i yig brgyas tshhangs par gsol te lha dang bdag dbyer med mthu nus dang ldan par bsam mo //	12	zhes ya ma ra dza yig brgyas tshhangs ba gsol te lha dang bdag dbyer med mthu nus dang ldan ba bsam mo 
BO_TZ_Terdzo-OM-P19a:128	de nas bdag gi thugs ka'i hu~m las 'od zer sprul pa'i khro tshhogs dang bcas pa 'phros /	12	de nas bdag gi thugs ka hu~m las d zer sprul ba khro tshhogs dang cha ba phro 
BO_TZ_Terdzo-OM-P19a:129	rang gzhan bsrung bya thams cad kyi tshhe srog nr-i yig gi rnam pa gnod byed kyis sbas bskung byas pa thams cad phrogs /	12	rang gzhan bsrung byed thams cad kyi tshhe srog nr-i yig gi rnam ba gnod byed kyis sbed skung byed ba thams cad phrog 
BO_TZ_Terdzo-OM-P19a:130	gnod byed thams cad tshhar bcad /	13	gnod byed thams cad tshhar gcod 
BO_TZ_Terdzo-OM-P19a:131	tshhe srog hu~m gi rnam pas bsrung bya'i snying gar thim pas bkrag mdangs gzi brjid dang ldan par gyur /	13	tshhe srog hu~m gi rnam ba bsrung byed snying gar thim ba bkrag mdangs gzi brjid dang ldan ba gyur 
BO_TZ_Terdzo-OM-P19a:132	slar yang 'od zer 'phros bla ma yi dam rgyal ba sras dang bcas pa thams cad kyi thugs rje'i byin rlabs brtan g.yo snod bcud kyi yon tan thams cad bsdus /	13	slar yang d zer phro bla ma yi dam rgyal ba sras dang cha ba thams cad kyi thugs rje byin rlabs brtan g.yo snod bcud kyi yon tan thams cad sdud 
BO_TZ_Terdzo-OM-P19a:133	sngar bzhin thim pas bkrag mdangs gzi brjid nus stobs dang ldan par bsam la /	13	sngar bzhin thim ba bkrag mdangs gzi brjid nus stobs dang ldan ba bsam la 
BO_TZ_Terdzo-OM-P19a:134	a+o~m a kro te ka ya man+ta ka hu~m phat:	13	a+o~m a kro te ka ya man+ta ka hu~m phat: 
BO_TZ_Terdzo-OM-P19a:135	ces a kro bcu gcig pa dang / a+o~m a kro te ka ya man+ta ka ha na ma tha b+hany+dza hu~m phat:	13	ces a kro chu gcig ba dang a+o~m a kro te ka ya man+ta ka ha na ma tha b+hany+dza hu~m phat: 
BO_TZ_Terdzo-OM-P19a:136	ces bcu bdun pa ci rigs bzlas pa'i rjes su /	13	ces chu bdun ba ci rigs bzlas ba rjes su 
BO_TZ_Terdzo-OM-P19a:137	a+o~m e ka ya ma du ru tshakras srungs :	13	a+o~m e ka ya ma du ru tshakras srungs 
BO_TZ_Terdzo-OM-P19a:138	he ka ya ma du ru tshakras srungs :	13	he ka ya ma du ru tshakras srungs 
BO_TZ_Terdzo-OM-P19a:139	g+h+ri ma ya ma du ru tshakras srungs :	13	g+h+ri ma ya ma du ru tshakras srungs 
BO_TZ_Terdzo-OM-P19a:140	sarba tshit+ta gzer thum b+hig nan trig nan rbad ya zlog ya :	14	sarba tshit+ta gzer thum b+hig nan trig nan rbod ya zlog ya 
BO_TZ_Terdzo-OM-P19a:141	sam g+h+r-i wa ri nr-i b+h+ru~m hu~m dza :	14	sam g+h+r-i wa ri nr-i b+h+ru~m hu~m dza 
BO_TZ_Terdzo-OM-P19a:142	bdag mi nor 'khor dang bcas pa la rak+sha rak+sha :	14	bdag mi nor khor dang cha ba la rak+sha rak+sha 
BO_TZ_Terdzo-OM-P19a:143	zhes ci 'grub bzla ste srung ba'o //	14	zhes ci grub bzla ste srung ba 
BO_TZ_Terdzo-OM-P19a:144	zlog pa ni /	14	zlog ba ni 
BO_TZ_Terdzo-OM-P19a:145	thugs ka dang ba spu'i khung bu nas sprul pa'i khro tshhogs nam mkha' gang ba spros /	14	thugs ka dang ba spu khung bu nas sprul ba khro tshhogs nam mkha gang ba spros 
BO_TZ_Terdzo-OM-P19a:146	gnod byed thams cad bsregs gtor sbyangs /	14	gnod byed thams cad bsregs thor sbyong 
BO_TZ_Terdzo-OM-P19a:147	lhag ma rnams kyang mtshhon cha'i 'khor los bcad nas rdul phran bzhin brlags par bsam la /	14	lhag ma rnams kyang mtshhon cha khor los gcod nas rdul phran bzhin brlags ba bsam la 
BO_TZ_Terdzo-OM-P19a:148	a+o~m e ka ya ma du ru tshakras zlog :	14	a+o~m e ka ya ma du ru tshakras zlog 
BO_TZ_Terdzo-OM-P19a:149	he ka ya ma du ru tshakras zlog :	14	he ka ya ma du ru tshakras zlog 
BO_TZ_Terdzo-OM-P19a:150	g+h+ri ma ya ma du ru tshakras zlog :	15	g+h+ri ma ya ma du ru tshakras zlog 
BO_TZ_Terdzo-OM-P19a:151	sarba tshit+ta gzer thum b+hig nan trig nan rbad ya zlog ya :	15	sarba tshit+ta gzer thum b+hig nan trig nan rbod ya zlog ya 
BO_TZ_Terdzo-OM-P19a:152	dgra bo byad ma lha srung dang bcas pa'i sha la rgyug :	15	dgra bo byad ma lha srung dang cha ba sha la rgyug 
BO_TZ_Terdzo-OM-P19a:153	snying la ma ra ya rgyug :	15	snying la ma ra ya rgyug 
BO_TZ_Terdzo-OM-P19a:154	dbugs la rgyug :	15	dbugs la rgyug 
BO_TZ_Terdzo-OM-P19a:155	srog la ma ra ya rgyug :	15	srog la ma ra ya rgyug 
BO_TZ_Terdzo-OM-P19a:156	khrag la rgyug :	15	khrag la rgyug 
BO_TZ_Terdzo-OM-P19a:157	rtsha la ma ra ya rgyug :	15	rtsha la ma ra ya rgyug 
BO_TZ_Terdzo-OM-P19a:158	hu~m phat: byad ma lha srung dang bcas pa ma ra ya zlog ya :	15	hu~m phat: byad ma lha srung dang cha ba ma ra ya zlog ya 
BO_TZ_Terdzo-OM-P19a:159	zhes bzla / phyag dang po gnyis zla nyir bsam pa'i bar du dgra bgegs thams cad rdul du brlags par bsam zhing thal rdeb bya ste zlog pa'o //	15	zhes bzla phyag dang po gnyis zla nyir bsam ba ba du dgra bgegs thams cad rdul du brlags ba bsam zhing thal rdeb byed ste zlog ba 
BO_TZ_Terdzo-OM-P19a:160	thun mtshhams su gtor ma la dmigs bya dgug bstim bya /	16	thun mtshhams su thor ma la dmigs byed gugs stim byed 
BO_TZ_Terdzo-OM-P19a:161	a+o~m ahhu~m lan gsum gyis dgra bgegs kyi sha khrag bdud rtshi'i rang bzhin du spel /	16	a+o~m ahhu~m lan gsum gyis dgra bgegs kyi sha khrag bdud rtshi rang bzhin du spel 
BO_TZ_Terdzo-OM-P19a:162	rtsha sngags la gtor sngags btags pa gsum mam bdun gyis phul la /	16	rtsha sngags la thor sngags dogs ba gsum mam bdun gyis bul la 
BO_TZ_Terdzo-OM-P19a:163	e : gzhan yang khro rgyal chen po khyod rnams la :	16	e gzhan yang khro rgyal chen po khyod rnams la 
BO_TZ_Terdzo-OM-P19a:164	phrin las bcol ba 'di rnams da mdzod cig :	16	phrin las chol ba di rnams da mdzod cig 
BO_TZ_Terdzo-OM-P19a:165	rdo rje slob dpon sku la smod pa dang : yi dam smod cing brnyas par byed pa dang : dkon mchog gsum la smod cing chos skyong smod :	16	rdo rje slob dpon sku la smod ba dang yi dam smod cing brnyas ba byed ba dang dkon(d) mchog gsum la smod cing chos skyong smod 
BO_TZ_Terdzo-OM-P19a:166	bsnyen sgrub zab mo'i bar chad byed pa dang : mched la 'khu zhing dam las ldog pa dang : dam tshhig can la gnod pa byed pa yi :	16	snyen sgrub zab mo ba chad byed ba dang mched la khu zhing dam las ldog ba dang dam tshhig can la gnod ba byed ba yi 
BO_TZ_Terdzo-OM-P19a:167	sdang ba'i dgra dang gnod par byed pa'i bgegs :	16	sdang ba dgra dang gnod ba byed ba bgegs 
BO_TZ_Terdzo-OM-P19a:168	rings par khug la srog dang da phrol cig :	16	dring ba khug la srog dang da phrol cig 
BO_TZ_Terdzo-OM-P19a:169	dbang du sdus la rdul du da rlogs shig :	16	dbang du thu la rdul du da rlogs shig 
BO_TZ_Terdzo-OM-P19a:170	bcol pa'i phrin las myur du grub par mdzod :	17	chol ba phrin las myur du grub ba mdzod 
BO_TZ_Terdzo-OM-P19a:171	ces 'dod don gsol /	17	ces dod don gsol 
BO_TZ_Terdzo-OM-P19a:172	bstod bskul gzhung gsal ci rigs pa byas la srung zlog gi skabs phyed par bya /	17	bstod skul gzhung gsal ci rigs ba byed la srung zlog gi skabs phyed ba byed 
BO_TZ_Terdzo-OM-P19a:173	mthar srung 'khor nas ting 'dzin sems dpa' hu~m yig gi bar rim gyis bsdus nas 'od gsal du 'jug	17	mthar srung khor nas ting dzin sems dpa hu~m yig gi ba rim gyis sdud nas d gsal du jug 
BO_TZ_Terdzo-OM-P19a:174	/slar yang tshhe bdag nag po zhal gcig phyag gnyis kyis 'khor lo dang lcags kyu 'dzin pa'i skur langs te gnas gsum du 'bru gsum 'god /	17	yang tshhe bdag nag po zhal gcig phyag gnyis kyis khor lo dang lcags kyu dzin ba skur ldang te gnas gsum du bru gsum god 
BO_TZ_Terdzo-OM-P19a:175	a kro bcu gcig pa bzlas nas smon lam shis brjod sogs bya'o //	17	a kro chu gcig ba bzlas nas smon lam shis rjod sogs byed 
BO_TZ_Terdzo-OM-P19a:176	! //gsum pa dbang gi cho ga ni /	17	ba dbang gi cho ga ni 
BO_TZ_Terdzo-OM-P19a:177	sngar bshad pa'i yo byad kyi bsham dang ldan pas /	17	sngar chad ba yo byad kyi bsham dang ldan ba 
BO_TZ_Terdzo-OM-P19a:178	bdag mdun dbyer med kyi sgrub mchod bzlas pa yan chad sngar ltar byas /	17	bdag mdun dbyer med kyi sgrub mchod bzlas ba yan chad sngar ltar byed 
BO_TZ_Terdzo-OM-P19a:179	las bum la dmigs te /	17	las bum la dmigs te 
BO_TZ_Terdzo-OM-P19a:180	a+o~m ka la ru pa ya ma ra tsha hu~m phat/	18	a+o~m ka la ru ba ya ma ra tsha hu~m 
BO_TZ_Terdzo-OM-P19a:181	ces pa'ang ci rigs pa bzla zhing lha bskyed pa med kyang chog	18	ces ba ci rigs ba bzla zhing lha skyed ba med kyang chog 
BO_TZ_Terdzo-OM-P19a:182	/ting nge 'dzin gyis dbang blangs la /	18	nge dzin gyis dbang blangs la 
BO_TZ_Terdzo-OM-P19a:183	slob ma'i bya ba khrus byas /	18	slob ma byed ba khru byed 
BO_TZ_Terdzo-OM-P19a:184	gral du 'khod la bgegs bskrad /	18	gral du khod la bgegs skrod 
BO_TZ_Terdzo-OM-P19a:185	mtshhams sbyor ci rigs pa las /	18	mtshhams sbyor ci rigs ba las 
BO_TZ_Terdzo-OM-P19a:186	'dir phyogs bcu dus gsum gyi de bzhin gshegs pa thams cad kyi ye shes gcig tu bsdus pa'i bdag nyid bcom ldan 'das 'phags pa 'jam dpal dbyangs khro bo'i skur bzhengs pa ni gshin rje gshed yin zhing /	18	dir phyogs chu dus gsum gyi de bzhin gshegs ba thams cad kyi ye shes gcig tu sdud ba bdag nyid joms ldan da phag ba jam dpal dbyangs khro bo skur bzhengs ba ni gshin rje gshed yin zhing 
BO_TZ_Terdzo-OM-P19a:187	de la rdo rje theg pa'i lam 'dir sgrub pa'i bka' srol ji snyed cig mchis pa las /	18	de la rdo rje theg ba lam dir sgrub ba bka srol ji snyed cig mchis ba las 
BO_TZ_Terdzo-OM-P19a:188	khyad par du gyur pa'i gdams pa 'di'i dbang du byas na /	18	khyad ba du gyur ba doms ba di dbang du byed na 
BO_TZ_Terdzo-OM-P19a:189	grub pa brnyes pa'i slob dpon chen po gtshug lag dpal dges tshhe bdag nag po'i rgyud kyi snying po'i bcud phyung ste man ngag tu dril nas o rgyan chen po la gtad /	18	grub ba brnyes ba slob dpon chen po gtshug lag dpal dges tshhe bdag nag po brgyud kyi snying po bcud byin ste man ngag tu dril nas o rgyan chen po la gtod 
BO_TZ_Terdzo-OM-P19a:190	des bal po ba su d+ha ra la gnang /	19	des bal po ba su d+ha ra la gnang 
BO_TZ_Terdzo-OM-P19a:191	de nyid kyi drung du rig sngags 'chang ba'i dbang phyug gnubs sangs rgyas ye shes kyis lan bdun byon pa'i tha ma la gdams pa 'di gzhan la mi spel ba'i bka' rgya dang bcas nas gnang /	19	de nyid kyi drung du rig sngags chang ba dbang phyug gnubs sangs rgya ye shes kyis lan bdun byon ba tha ma la doms ba di gzhan la mi spel ba bka rgya dang cha nas gnang 
BO_TZ_Terdzo-OM-P19a:192	de lta bu'i gnubs ban chen po de ni spyir mdo rgyud thams cad dang khyad par bskyed rdzogs gsum gyi don la mkhas shing grub pa thob /	19	de lta bu gnubs ban chen po de ni spyir mdo brgyud thams cad dang khyad ba skyed rdzogs gsum gyi don la mkhas shing grub ba thob 
BO_TZ_Terdzo-OM-P19a:193	sa bzhi pa'i rtogs pa mngon du gyur /	19	sa bzhi ba rtogs ba mngon du gyur 
BO_TZ_Terdzo-OM-P19a:194	bye brag yi dam gshin rje'i gshed dang mi lab pa bzhin du gyur /	19	bye brag yi dam gshin rje gshed dang mi lab ba bzhin du gyur 
BO_TZ_Terdzo-OM-P19a:195	chos tshhul 'di nyid kyi sgo nas 'gro phan rgya cher mdzad /	19	chos tshhul di nyid kyi sgo nas gro phan rgya cher mdzad 
BO_TZ_Terdzo-OM-P19a:196	sde brgyad dregs pa can thams cad bran du khol ba sogs bod yul du byon pa'i sngags 'chang chen po 'gran gyi do zla med pa yin no //	19	sde brgyad dregs ba can thams cad bran du khol ba sogs bod yul du byon ba sngags chang chen po gran gyi do zla med ba yin no 
BO_TZ_Terdzo-OM-P19a:197	des snyigs dus sngags pa nang rgyas byed pa'i dus su sangs rgyas kyi bstan pa srung ba'i btshas su dgongs nas phung po ri bo che dang mkho mthing gnyis su smon lam gyi gtad rgya dang bcas nas gter du sbas pa las /	19	des snyigs dus sngags ba nang rgya byed ba dus su sangs rgya kyi ston ba srung ba btshas su dgongs nas phung po ri bo che dang mkho mthing gnyis su smon lam gyi gtod rgya dang cha nas gter du sbed ba las 
BO_TZ_Terdzo-OM-P19a:198	ri bo che'i gter rnams rgya zhang khrom gyis spyan drangs /	19	ri bo che gter rnams rgya zhang khrom gyis spyan drangs 
BO_TZ_Terdzo-OM-P19a:199	de la lha rje gnubs chung du grags pa ye shes gzung gis zhus shing mkho mthing gi gter yang thon pas gter kha snga phyi gnyis ka'i bka' babs /	19	de la lha rje gnubs chung du grags ba ye shes gzung gis zhus shing mkho mthing gi gter yang thon ba gter kha snga phyi gnyis ka bka bab 
BO_TZ_Terdzo-OM-P19a:200	rje btshun mi las mthu nus kyi grags pa thon pa yang bla ma 'di'i drin las byung ba yin /	20	rje btshun mi las mthu nus kyi grags ba thon ba yang bla ma di drin las byung ba yin 
BO_TZ_Terdzo-OM-P19a:201	de la mtshhur ston rin chen rdo rjes zhus te khong gis dbon gzhon ston la mthu byas pas /	20	de la mtshhur ston rin chen rdo rjes zhus te khong gis dbon gzhon ston la mthu byed ba 
BO_TZ_Terdzo-OM-P19a:202	de'i zlog pa'i rim gro mes ston gyis byas pas mthu log ste cho 'phrul chen po byung ba las /	20	de zlog ba rim gro mes ston gyis byed ba mthu log ste cho phrul chen po byung ba las 
BO_TZ_Terdzo-OM-P19a:203	mtshhur ston gyis kha rag tu rang gi bla ma bal po dbang phyug rdo rje'i drung du lo rgyus zhus pas /	20	mtshhur ston gyis kha rag tu rang gi bla ma bal po dbang phyug rdo rje drung du lo rgyus zhus ba 
BO_TZ_Terdzo-OM-P19a:204	rol po mes ston las zlog pa mkhas pa gtshang gi rgyal khams na med /	20	rol po mes ston las zlog ba mkhas ba gtshang gi rgyal khams na med 
BO_TZ_Terdzo-OM-P19a:205	nga'i zlog pa yang zhun la sogs pa dang khyed rang phyag cha urmo la mkhas te des kyang mi bzlog	20	nga zlog ba yang zhun la sogs ba dang khyed rang phyag cha urmo la mkhas te des kyang mi bzlog 
BO_TZ_Terdzo-OM-P19a:206	/yang zlog zab pa gcig dgos pas gtshang rong gi lha rje gnubs chung la zhus shig pa'i lung bstan pa ltar snam bu tshhos ma bdun gyi phyag rten dang bcas te zhus /	20	zlog zab ba gcig dgos ba gtshang rong gi lha rje gnubs chung la zhus shig ba lung ston ba ltar snam bu tshhos ma bdun gyi phyag rten dang cha te zhus 
BO_TZ_Terdzo-OM-P19a:207	rang yul du log nas bsgrubs pas cho 'phrul cher song /	20	rang yul du log nas sgrub ba cho phrul cher gro 
BO_TZ_Terdzo-OM-P19a:208	slar yang rta pho ngang zhur gcig dang gser srang 'ga'i phyag rten dang bcas te zhus pas gdams pa lhag ma med pa'i dbu snyung dang bcas rdzogs par gnang /	20	slar yang rta pho ngang zhur gcig dang gser srang ga phyag rten dang cha te zhus ba doms ba lhag ma med ba dbu snyung dang cha rdzogs ba gnang 
BO_TZ_Terdzo-OM-P19a:209	mtshhur ston gyis kyang rang gi bu rgyud min pa gzhan la mi spel ba'i gtshigs bzung /	20	mtshhur ston gyis kyang rang gi bu brgyud min ba gzhan la mi spel ba gtshigs bzung 
BO_TZ_Terdzo-OM-P19a:210	de nas mtshhur ston gyi sras 'jam dpal lo bco brgyad lon pa dang dbang nge lo bcu gnyis lon pa ste yab sras gsum gyis sgrub pa'i sngags rgyun byas pas /	21	de nas mtshhur ston gyi sras jam dpal lo chos brgyad lon ba dang dbang nge lo chu gnyis lon ba ste yab sras gsum gyis sgrub ba sngags rgyun byed ba 
BO_TZ_Terdzo-OM-P19a:211	mes ston dpon g.yog bzhi khrag skyugs nas shi	21	mes ston dpon g.yog bzhi khrag skyug nas chi 
BO_TZ_Terdzo-OM-P19a:212	/de nas dbon gzhon par mthu zug ste lo gsum gyi khongs su pho ngo drug cu 'jig rten pha rol du bsgral /	21	nas dbon gzhon ba mthu zug ste lo gsum gyi khongs su pho ngo drug cu jig rten pha rol du bsgral 
BO_TZ_Terdzo-OM-P19a:213	de nas rim bzhin grub brnyes sngags 'chang chen po du ma las brgyud pa 'jam dpal gshin rje'i gshed yang zlog me'i spu gri zhes bya ba /	21	de nas rim bzhin grub brnyes sngags chang chen po du ma las brgyud ba jam dpal gshin rje gshed yang zlog me spu gri zhes byed ba 
BO_TZ_Terdzo-OM-P19a:214	skor gsum mtshhan bzhi gnad gsum ste don tshhan bcu'i bdag nyid can gyi gdams pa zab mo de nyid dang 'brel ba'i rnon po nang gcod kyi byin rlabs zab mo sgrub pa la slob dpon gyi bya ba rnams sngon du grub /	21	skor gsum mtshhan bzhi gnad gsum ste don tshhan chu bdag nyid can gyi doms ba zab mo de nyid dang brel ba rnon po nang gcod kyi byin rlabs zab mo sgrub ba la slob dpon gyi byed ba rnams sngon du grub 
BO_TZ_Terdzo-OM-P19a:215	slob ma'i bya ba man+dal phul /	21	slob ma byed ba man+dal bul 
BO_TZ_Terdzo-OM-P19a:216	hoh yang gsang gshed po'i dkyil 'khor du //	21	hoh yang gsang gshed po dkyil khor du 
BO_TZ_Terdzo-OM-P19a:217	bdag ni 'jug par 'tshhal lags kyi //	21	bdag ni jug ba tshhal lags kyi 
BO_TZ_Terdzo-OM-P19a:218	rdo rje slob dpon dkyil 'khor gtsho //	21	rdo rje slob dpon dkyil khor gtsho 
BO_TZ_Terdzo-OM-P19a:219	dpa' bos bdag la bka' drin stshol //	21	dpa bod bdag la bka drin stshol 
BO_TZ_Terdzo-OM-P19a:220	ces lan gsum gyis gsol ba btab /	22	ces lan gsum gyis gsol ba debs 
BO_TZ_Terdzo-OM-P19a:221	rdo rje slob dpon sangs rgyas dpal //	22	rdo rje slob dpon sangs rgya dpal 
BO_TZ_Terdzo-OM-P19a:222	sogs kyis rgyun bshags bya /	22	sogs kyis rgyun chags byed 
BO_TZ_Terdzo-OM-P19a:223	mdun gyi gtor ma dang slob dpon dbyer ma mchis pa dregs pa chu glang pad nyi zla ba'i gdan la 'jam dpal gshin rje'i gshed mthing nag dkar mthing sogs mngon rtogs bzhin 'bru gsum gyis mtshhan pa /	22	mdun gyi thor ma dang slob dpon dbyer ma mchis ba dregs ba chu glang pad nyi zla ba gdan la jam dpal gshin rje gshed mthing nag dkar mthing sogs mngon rtogs bzhin bru gsum gyis mtshhan ba 
BO_TZ_Terdzo-OM-P19a:224	zhes pa'i bar gyis gsal 'debs su 'jug	22	zhes ba ba gyis gsal debs su jug 
BO_TZ_Terdzo-OM-P19a:225	/de'i thugs ka nas 'od zer 'phros pas slob bu'i sdig sgrib nyon mongs bag chags dang bcas pa sbyang /	22	thugs ka nas d zer phro ba slob bu sdig sgrib nyon mongs bag chags dang cha ba sbyong 
BO_TZ_Terdzo-OM-P19a:226	swa b+ha ba brjod /	22	swa b+ha ba rjod 
BO_TZ_Terdzo-OM-P19a:227	stong pa'i ngang las pad+ma dang zla ba'i dkyil 'khor gyi steng du d+hihyig ser po yongs su gyur pa las 'phags pa 'jam dpal gur gum gzhon nu'i mdog can zhal gcig phyag gnyis pa /	22	stong ba ngang las pad+ma dang zla ba dkyil khor gyi steng du d+hihyig ser po yongs su gyur ba las phag ba jam dpal gur gum gzhon nu mdog can zhal gcig phyag gnyis ba 
BO_TZ_Terdzo-OM-P19a:228	g.yas shes rab kyi ral gri dpung pa'i thad sor phyar zhing /	22	g.yas shes rab kyi ral gri dpung ba thad sor phyar zhing 
BO_TZ_Terdzo-OM-P19a:229	g.yon ut+pala'i sdong bu thugs kar gzung ba'i 'dab ma snyan gyi thad kar bye ba'i steng na sher phyin gyi glegs bam bsnams pa /	22	g.yon ut+pala sdong bu thugs kar gzung ba dab ma snyan gyi thad kar bye ba steng na sher phyin gyi glegs bam snom ba 
BO_TZ_Terdzo-OM-P19a:230	zhi zhing 'dzum pa'i nyams can dar dang rin po che'i rgyan thams cad kyis brgyan pa /	23	zhi zhing dzum ba nyams can dar dang rin po che rgyan thams cad kyis rgyan ba 
BO_TZ_Terdzo-OM-P19a:231	de'i spyi bor a+o~m/	23	de spyi bor 
BO_TZ_Terdzo-OM-P19a:232	mgrin par ah thugs kar hu~m/	23	mgrin ba ah thugs kar 
BO_TZ_Terdzo-OM-P19a:233	hu~m las 'od zer 'phros pas 'jam dpal gshin rje'i gshed yab yum sras 'khor dang bcas pa kha char bu yug 'tshhubs pa ltar spyan drangs te slob ma la thim par bsam zhing /	23	hu~m las d zer phro ba jam dpal gshin rje gshed yab yum sras khor dang cha ba kha char bu yug tshhubs ba ltar spyan drangs te slob ma la thim ba bsam zhing 
BO_TZ_Terdzo-OM-P19a:234	rtsha ba'i sngags kyi mthar tish+tha ma ha kro d+ha a be sha ya a be sha ya dz+nya na man+dal a be sha ya a ah	23	rtsha ba sngags kyi mthar tish+tha ma ha kro d+ha a be sha ya a be sha ya dz+nya na man+dal a be sha ya a ah 
BO_TZ_Terdzo-OM-P19a:235	zhes bzla zhing spos dang rol mor bcas pas byin dbab /	23	zhes bzla zhing spros dang rol mor cha ba byin bebs 
BO_TZ_Terdzo-OM-P19a:236	tish+tha badzra zhes spyi bor rdo rje bzhag ste brtan par bya /	23	tish+tha badzra zhes spyi bor rdo rje jog ste brtan ba byed 
BO_TZ_Terdzo-OM-P19a:237	de ltar byin dbab pa'i rkyen gyis rgyu 'jam dpal 'bras bu gshin rje'i gshed kyi sku mthing nag dkar sogs nas /	23	de ltar byin bebs ba rkyen gyis rgyu jam dpal bras bu gshin rje gshed kyi sku mthing nag dkar sogs nas 
BO_TZ_Terdzo-OM-P19a:238	'bar ba'i dbus na bzhugs pa /	23	bar ba dbus na bzhugs ba 
BO_TZ_Terdzo-OM-P19a:239	bar gyis gsal btab /	23	ba gyis gsal debs 
BO_TZ_Terdzo-OM-P19a:240	dbang dngos la dang po sku'i byin rlabs dbang bzhi'i tshhul du bskur ba ni /	24	dbang dngos la dang po sku byin rlabs dbang bzhi tshhul du skur ba ni 
BO_TZ_Terdzo-OM-P19a:241	slob dpon dang gtor ma'i lha'i gnas gsum du 'bru gsum sgom du bcug la /	24	slob dpon dang thor ma lha gnas gsum du bru gsum sgom du jug la 
BO_TZ_Terdzo-OM-P19a:242	slob dpon dang gtor ma gtsho bo'i lha'i dpral ba'i a+o~m las 'od zer dkar po dpag med 'phros /	24	slob dpon dang thor ma gtsho bo lha dpral ba a+o~m las d zer dkar po dpog med phro 
BO_TZ_Terdzo-OM-P19a:243	khyed rang gi dpral bar thim pas bum pa'i dbang thob /	24	khyed rang gi dpral ba thim ba bum ba dbang thob 
BO_TZ_Terdzo-OM-P19a:244	lus kyi dri ma dag	24	lus kyi dri ma dag 
BO_TZ_Terdzo-OM-P19a:245	/lus 'jam dpal gshin rje'i gshed kyi sku dang gnyis su med pa'i mthu can du byas par mos shig byas la /	24	jam dpal gshin rje gshed kyi sku dang gnyis su med ba mthu can du byed ba mos shig byed la 
BO_TZ_Terdzo-OM-P19a:246	gtor ma spyi bor bzhag ste /	24	thor ma spyi bor jog ste 
BO_TZ_Terdzo-OM-P19a:247	dpal ldan rdo rje sku 'chang ba //	24	dpal ldan rdo rje sku chang ba 
BO_TZ_Terdzo-OM-P19a:248	rdo rje mi phyed sku dang ldan //	24	rdo rje mi phyed sku dang ldan 
BO_TZ_Terdzo-OM-P19a:249	deng bdag sangs rgyas sku 'dzin pa //	24	deng bdag sangs rgya sku dzin ba 
BO_TZ_Terdzo-OM-P19a:250	sku yi rdo rjer dbang bskur ro //	25	sku yi rdo rjer dbang skur ro 
BO_TZ_Terdzo-OM-P19a:251	a kro dang / a+o~m e ka ya ma du ru tshakra ka ya a b+hi shiny+tsha a+o~m/	25	a kro dang a+o~m e ka ya ma du ru tshakra ka ya a b+hi shiny+tsha 
BO_TZ_Terdzo-OM-P19a:252	zhes dbang bskur /	25	zhes dbang skur 
BO_TZ_Terdzo-OM-P19a:253	de bzhin du slob dpon dang gtor ma gtsho bo'i lha /	25	de bzhin du slob dpon dang thor ma gtsho bo lha 
BO_TZ_Terdzo-OM-P19a:254	khyad par ma mo khrag mig ma rnams kyi mgrin pa'i ahlas 'od zer dmar po 'phros /	25	khyad ba ma mo khrag mig ma rnams kyi mgrin ba ahlas d zer dmar po phro 
BO_TZ_Terdzo-OM-P19a:255	khyed rang gi mgrin par thim pas gsang ba'i dbang thob /	25	khyed rang gi mgrin ba thim ba gsang ba dbang thob 
BO_TZ_Terdzo-OM-P19a:256	ngag gi dri ma dag	25	ngag gi dri ma dag 
BO_TZ_Terdzo-OM-P19a:257	/ngag 'jam dpal gshin rje'i gshed kyi gsung dang gnyis su med pa'i mthu can du byas par mos shig	25	jam dpal gshin rje gshed kyi gsung dang gnyis su med ba mthu can du byed ba mos shig 
BO_TZ_Terdzo-OM-P19a:258	/ces mgrin par bzhag ste /	25	mgrin ba jog ste 
BO_TZ_Terdzo-OM-P19a:259	dpal ldan rdo rje gsung 'chang ba //	25	dpal ldan rdo rje gsung chang ba 
BO_TZ_Terdzo-OM-P19a:260	rdo rje mi phyed gsung dang ldan //	26	rdo rje mi phyed gsung dang ldan 
BO_TZ_Terdzo-OM-P19a:261	deng bdag sangs rgyas gsung 'dzin pa //	26	deng bdag sangs rgya gsung dzin ba 
BO_TZ_Terdzo-OM-P19a:262	gsung gi rdo rjer dbang bskur ro //	26	gsung gi rdo rjer dbang skur ro 
BO_TZ_Terdzo-OM-P19a:263	a kro dang / he ka ya ma du ru tshakra wa ka a b+hi shiny+tsha ah	26	a kro dang he ka ya ma du ru tshakra wa ka a b+hi shiny+tsha ah 
BO_TZ_Terdzo-OM-P19a:264	yang slob dpon dang gtor ma gtsho bo'i lha /	26	yang slob dpon dang thor ma gtsho bo lha 
BO_TZ_Terdzo-OM-P19a:265	khyad par sras mchog ya ma ra dza rnams kyi thugs ka'i hu~m las 'od zer sngon po 'phros /	26	khyad ba sras mchog ya ma ra dza rnams kyi thugs ka hu~m las d zer sngon po phro 
BO_TZ_Terdzo-OM-P19a:266	khyed rang gi snying gar thim pas shes rab ye shes kyi dbang thob /	26	khyed rang gi snying gar thim ba shes rab ye shes kyi dbang thob 
BO_TZ_Terdzo-OM-P19a:267	yid kyi dri ma dag	26	yid kyi dri ma dag 
BO_TZ_Terdzo-OM-P19a:268	/yid 'jam dpal gshin rje'i gshed kyi thugs dang gnyis su med pa'i mthu can du byas par mos shig	26	jam dpal gshin rje gshed kyi thugs dang gnyis su med ba mthu can du byed ba mos shig 
BO_TZ_Terdzo-OM-P19a:269	/ces snying gar bzhag ste /	26	snying gar jog ste 
BO_TZ_Terdzo-OM-P19a:270	dpal ldan rdo rje thugs 'chang ba //	27	dpal ldan rdo rje thugs chang ba 
BO_TZ_Terdzo-OM-P19a:271	rdo rje mi phyed thugs dang ldan //	27	rdo rje mi phyed thugs dang ldan 
BO_TZ_Terdzo-OM-P19a:272	deng bdag sangs rgyas thugs 'dzin pa //	27	deng bdag sangs rgya thugs dzin ba 
BO_TZ_Terdzo-OM-P19a:273	thugs kyi rdo rjer dbang bskur ro //	27	thugs kyi rdo rjer dbang skur ro 
BO_TZ_Terdzo-OM-P19a:274	a kro dang g+h+ri ma ya ma du ru tshakra tshit+ta a b+hi shiny+tsha hu~m/	27	a kro dang g+h+ri ma ya ma du ru tshakra tshit+ta a b+hi shiny+tsha 
BO_TZ_Terdzo-OM-P19a:275	yang slob dpon dang gtor ma'i lha gtsho 'khor thams cad kyi gnas gsum gyi yig 'bru gsum las 'od zer dkar dmar mthing gsum dpag med 'phros /	27	yang slob dpon dang thor ma lha gtsho khor thams cad kyi gnas gsum gyi yig bru gsum las d zer dkar dmar mthing gsum dpog med phro 
BO_TZ_Terdzo-OM-P19a:276	khyed rang gi gnas gsum du thim pas dbang bzhi pa thob /	27	khyed rang gi gnas gsum du thim ba dbang bzhi ba thob 
BO_TZ_Terdzo-OM-P19a:277	sgo gsum gyi dri ma bag chags dang bcas pa dag	27	sgo gsum gyi dri ma bag chags dang cha ba dag 
BO_TZ_Terdzo-OM-P19a:278	/'jam dpal gshin rje gshed kyi sku gsung thugs dang gnyis su med pa'i mthu can du byas par mos shig byas la /	27	dpal gshin rje gshed kyi sku gsung thugs dang gnyis su med ba mthu can du byed ba mos shig byed la 
BO_TZ_Terdzo-OM-P19a:279	gtor ma lag tu gtad la /	27	thor ma lag tu gtod la 
BO_TZ_Terdzo-OM-P19a:280	dpal ldan rdo rje gsum 'chang ba //	28	dpal ldan rdo rje gsum chang ba 
BO_TZ_Terdzo-OM-P19a:281	rdo rje mi phyed gsum dang ldan //	28	rdo rje mi phyed gsum dang ldan 
BO_TZ_Terdzo-OM-P19a:282	deng bdag sku gsung thugs 'dzin pa //	28	deng bdag sku gsung thugs dzin ba 
BO_TZ_Terdzo-OM-P19a:283	rdo rje gsum du dbang bskur ro //	28	rdo rje gsum du dbang skur ro 
BO_TZ_Terdzo-OM-P19a:284	a kro dang / sarba tshit+ta gzer thum b+hig nan trig nan rbad ya zlog ya :	28	a kro dang sarba tshit+ta gzer thum b+hig nan trig nan rbod ya zlog ya 
BO_TZ_Terdzo-OM-P19a:285	sarba sid+d+hi a b+hi shiny+tsha hrih	28	sarba sid+d+hi a b+hi shiny+tsha hrih 
BO_TZ_Terdzo-OM-P19a:286	zhes pa ste /	28	zhes ba ste 
BO_TZ_Terdzo-OM-P19a:287	de dag ni sku'i byin rlabs dbang bzhi'i tshhul du bskur ba'o //	28	de dag ni sku byin rlabs dbang bzhi tshhul du skur ba 
BO_TZ_Terdzo-OM-P19a:288	gnyis pa gsung bzlas pa'i lung sbyin pa ni /	28	gnyis ba gsung bzlas ba lung sbyin ba ni 
BO_TZ_Terdzo-OM-P19a:289	dpon slob gnyis ka'i thugs kar nyi ma'i steng du hu~m yig mthing nag sngags phreng gis g.yas su bskor ba /	28	dpon slob gnyis ka thugs kar nyi ma steng du hu~m yig mthing nag sngags phreng gis g.yas su skor ba 
BO_TZ_Terdzo-OM-P19a:290	slob dpon gyi sngags phreng las sngags kyi 'od zer shangs bug g.yas nas thon /	29	slob dpon gyi sngags phreng las sngags kyi d zer shangs bug g.yas nas thon 
BO_TZ_Terdzo-OM-P19a:291	slob ma'i sna bug g.yon nas zhugs /	29	slob ma sna bug g.yon nas jug 
BO_TZ_Terdzo-OM-P19a:292	snying ga'i sngags phreng la thim par bsam zhing /	29	snying ga sngags phreng la thim ba bsam zhing 
BO_TZ_Terdzo-OM-P19a:293	slob dpon gyi phreng ba la 'jus te a kro bcu gcig pa dang bcu bdun pa /	29	slob dpon gyi phreng ba la ju te a kro chu gcig ba dang chu bdun ba 
BO_TZ_Terdzo-OM-P19a:294	srung sngags rnams kyi rjes zlos lan gsum /	29	srung sngags rnams kyi rjes zlos lan gsum 
BO_TZ_Terdzo-OM-P19a:295	sngags phreng kha phyir bltar g.yon skor du dmigs nas zlog sngags kyi rjes zlos lan gsum gyi mthar phreng ba mgrin par bzhag ste /	29	sngags phreng kha phyir bltar g.yon skor du dmigs nas zlog sngags kyi rjes zlos lan gsum gyi mthar phreng ba mgrin ba jog ste 
BO_TZ_Terdzo-OM-P19a:296	bcom ldan 'das 'jam dpal gshin rje'i gshed po'i gsung sngags kyi nus pa thams cad slob ma'i rgyud la 'jug par gyur cig	29	joms ldan da jam dpal gshin rje gshed po gsung sngags kyi nus ba thams cad slob ma brgyud la jug ba gyur cig 
BO_TZ_Terdzo-OM-P19a:297	/dzahhu~m bam hoh zhes byin gyis brlab /	29	bam hoh zhes byin gyis brlab 
BO_TZ_Terdzo-OM-P19a:298	de ni gsung sngags kyi dbang bskur ba'o //	29	de ni gsung sngags kyi dbang skur ba 
BO_TZ_Terdzo-OM-P19a:299	gsum pa thugs kyi dbang ni /	29	gsum ba thugs kyi dbang ni 
BO_TZ_Terdzo-OM-P19a:300	de ltar bskyed rim dang bzlas brjod kyi rnam pa thams cad kyang ngo bo spros med rang bzhin rnam par mi rtog pa chos dbyings ka dag chen por ngo sprod pa ni thugs kyi dbang bskur ba'o //	30	de ltar skyed rim dang bzlas rjod kyi rnam ba thams cad kyang ngo bo spros med rang bzhin rnam ba mi rtogs ba chos dbyings ka dag chen por ngo sprod ba ni thugs kyi dbang skur ba 
BO_TZ_Terdzo-OM-P19a:301	rjes dam tshhig khas blang ba dang / man+dal /	30	rjes dam tshhig khas blang ba dang man+dal 
BO_TZ_Terdzo-OM-P19a:302	yon 'bul sogs dang / cho ga'i rjes chog gtang rag mchod bstod /	30	yon bul sogs dang cho ga rjes chog gtong rag mchod bstod 
BO_TZ_Terdzo-OM-P19a:303	bzod gsol gshegs bsdu bsngo smon shis brjod rnams spyi ltar bya'o //	30	bzod gsol gshegs sdud sngo smon shis rjod rnams spyi ltar byed 
BO_TZ_Terdzo-OM-P19a:304	'di'i sku'i byin rlabs dbang bzhi'i skabs dmigs pa'i rnam pa sngar bzhin la /	30	di sku byin rlabs dbang bzhi skabs dmigs ba rnam ba sngar bzhin la 
BO_TZ_Terdzo-OM-P19a:305	dang po gsum po so so'i bstod ring gi mthar khro rgyal gshin rje'i gshed kyi dbang bskur ro //	30	dang po gsum po so so bstod ring gi mthar khro rgyal gshin rje gshed kyi dbang skur ro 
BO_TZ_Terdzo-OM-P19a:306	zhes sogs sbyar ba dang / bzhi pa la /	30	zhes sogs sbyor ba dang bzhi ba la 
BO_TZ_Terdzo-OM-P19a:307	gzhan yang khro rgyal chen po khyed rnams la :	30	gzhan yang khro rgyal chen po khyed rnams la 
BO_TZ_Terdzo-OM-P19a:308	sogs phrin bcol gyi tshhig brjod par snang ba spro na de bzhin du bya zhing /	30	sogs phrin chol gyi tshhig rjod ba snang ba spro na de bzhin du byed zhing 
BO_TZ_Terdzo-OM-P19a:309	dkyus su smros pa nyid kyis kyang don tshhang zhing legs pa'ang yin no //	30	dkyu su smros ba nyid kyis kyang don tshhang zhing legs ba yin no 
BO_TZ_Terdzo-OM-P19a:310	rnam 'a~xgyur 'gag me~xd khro bo'i rgyal //	31	rnam a~xgyur gag me~xd khro bo rgyal 
BO_TZ_Terdzo-OM-P19a:311	sgrub thabs dbang tshhig rdo~x rje~x 'dzin //	31	sgrub thabs dbang tshhig rdo~x rje~x dzin 
BO_TZ_Terdzo-OM-P19a:312	sngon byon rnams kyis rgyas bshad mod //	31	sngon byon rnams kyis rgya chad mod 
BO_TZ_Terdzo-OM-P19a:313	'dir ni 'jug bde snying por dril //	31	dir ni jug bde snying por dril 
BO_TZ_Terdzo-OM-P19a:314	'jam dpal gshin rje'i gshed yang zlog me'i spu gri'i sgrub thabs rnon po nang gcod kyi dbang dang bcas pa'i le tshhan no ///	31	jam dpal gshin rje gshed yang zlog me spu gri sgrub thabs rnon po nang gcod kyi dbang dang cha ba le tshhan no 
