segmentnr	original	folio	stemmed
BO_TZ_PEMA-SANGTHIG-P19:0	\u0f88 pad+ma gsang ba'i thig le las :	0	\u0f88 pad+ma gsang ba thig le las 
BO_TZ_PEMA-SANGTHIG-P19:1	'chi med tshhe yi phrin las bzhugs :	0	chi med tshhe yi phrin las bzhugs 
BO_TZ_PEMA-SANGTHIG-P19:2	\u0f88\u0f88\u0f88 skye 'chi mi mnga' rtag pa'i sku :	0	\u0f88\u0f88\u0f88 skye chi mi mnga rtag ba sku 
BO_TZ_PEMA-SANGTHIG-P19:3	'pho 'gyur mtshhan mas mi phyed cing :	0	pho gyur mtshhan mas mi phyed cing 
BO_TZ_PEMA-SANGTHIG-P19:4	rig stong 'od gsal rdo rje'i srog :	0	rig stong d gsal rdo rje srog 
BO_TZ_PEMA-SANGTHIG-P19:5	dgongs pa'i thig ler yang dag sgrub :sngon 'gro'i chos la rnam grangs bdun :	0	dgongs ba thig ler yang dag sgrub :sngon gro chos la rnam grangs bdun 
BO_TZ_PEMA-SANGTHIG-P19:6	dang po skyabs yul gsal gdab par :	0	dang po skyob yul gsal gdab ba 
BO_TZ_PEMA-SANGTHIG-P19:7	na mo : gdod nas dag pa gnyug ma'i bab :	0	na mo gdod nas dag ba gnyug ma bab 
BO_TZ_PEMA-SANGTHIG-P19:8	'od gsal 'dus ma byas pa'i gdangs :	0	d gsal du ma byed ba gdang 
BO_TZ_PEMA-SANGTHIG-P19:9	'pho 'gyur med pa don gyi lhar :	0	pho gyur med ba don gyi lhar 
BO_TZ_PEMA-SANGTHIG-P19:10	gnyis med ngang nas skyabs su mchi :	1	gnyis med ngang nas skyob su mchi 
BO_TZ_PEMA-SANGTHIG-P19:11	gnyis pa don dam byang sems bskyed :	1	gnyis ba don dam byang sems skyed 
BO_TZ_PEMA-SANGTHIG-P19:12	ho : med bzhin snang ba 'khrul pa'i 'gro :	1	ho med bzhin snang ba khrul ba gro 
BO_TZ_PEMA-SANGTHIG-P19:13	rang rig chen por ro mnyam yang :	1	rang rig chen por ro mnyam yang 
BO_TZ_PEMA-SANGTHIG-P19:14	gsang chen thabs kyis chod pa rnams :	1	gsang chen thabs kyis chod ba rnams 
BO_TZ_PEMA-SANGTHIG-P19:15	ye shes dbyings su 'god par bya :	1	ye shes dbyings su god ba byed 
BO_TZ_PEMA-SANGTHIG-P19:16	gsum pa tshhogs gsag rnal 'byor ni :	1	gsum ba tshhogs gsag rnal byor ni 
BO_TZ_PEMA-SANGTHIG-P19:17	'chi med tshhe yi lha tshhogs la :	1	chi med tshhe yi lha tshhogs la 
BO_TZ_PEMA-SANGTHIG-P19:18	dag mnyam chen por gus phyag 'tshhal :	1	dag mnyam chen por gus phyag tshhal 
BO_TZ_PEMA-SANGTHIG-P19:19	yul dbang mnyam sbyor mchod sprin 'bul :	1	yul dbang mnyam sbyor mchod sprin bul 
BO_TZ_PEMA-SANGTHIG-P19:20	kun brtags 'khrul pa dbyings su bshags :	2	kun rtog khrul ba dbyings su chags 
BO_TZ_PEMA-SANGTHIG-P19:21	blo bral zab mor rjes yi rangs :	2	blo bral zab mor rjes yi rangs 
BO_TZ_PEMA-SANGTHIG-P19:22	bde chen brda yi chos 'khor skor :	2	bde chen brda yi chos khor skor 
BO_TZ_PEMA-SANGTHIG-P19:23	'pho bral chen por bzhugs gsol 'debs :	2	pho bral chen por bzhugs gsol debs 
BO_TZ_PEMA-SANGTHIG-P19:24	dge tshhogs gzhon nu bum skur bsngo :	2	dge tshhogs gzhon nu bum skur sngo 
BO_TZ_PEMA-SANGTHIG-P19:25	bzhi pa srung mtshhams rnal 'byor ni :	2	bzhi ba srung mtshhams rnal byor ni 
BO_TZ_PEMA-SANGTHIG-P19:26	hu~m: nga ni ye nas ngang gis khro :	2	hu~m: nga ni ye nas ngang gis khro 
BO_TZ_PEMA-SANGTHIG-P19:27	khro la khros pas zhi mdzad pa'i :	2	khro la khro ba zhi mdzad ba 
BO_TZ_PEMA-SANGTHIG-P19:28	thugs rje khros dpal rta yi rgyal :	2	thugs rje khro dpal rta yi rgyal 
BO_TZ_PEMA-SANGTHIG-P19:29	rig rtshal 'phro 'du 'bar ba'i sprin :	2	rig rtshal phro du bar ba sprin 
BO_TZ_PEMA-SANGTHIG-P19:30	ye shes rol pa'i rgyan du shar :	3	ye shes rol ba rgyan du char 
BO_TZ_PEMA-SANGTHIG-P19:31	nyon cig ma rig bdud dgra'i dpung :	3	nyon cig ma rig bdud dgra dpung 
BO_TZ_PEMA-SANGTHIG-P19:32	kun tu brtags pa'i gdon tshhogs kun :	3	kun tu rtog ba don tshhogs kun 
BO_TZ_PEMA-SANGTHIG-P19:33	ye shes rgyan gyi gtor ma longs :	3	ye shes rgyan gyi thor ma longs 
BO_TZ_PEMA-SANGTHIG-P19:34	yongs grub chos sku'i klong du dengs :	3	yongs grub chos sku klong du dengs 
BO_TZ_PEMA-SANGTHIG-P19:35	'pho 'gyur med par mtshhams bcad do :	3	pho gyur med ba mtshhams gcod do 
BO_TZ_PEMA-SANGTHIG-P19:36	om hrihbadzra kro d+ha rak+sha rak+sha hu~m phat:	3	om hrihbadzra kro d+ha rak+sha rak+sha hu~m phat: 
BO_TZ_PEMA-SANGTHIG-P19:37	lnga pa rdo rje'i byin chen dbab :	3	lnga ba rdo rje byin chen bebs 
BO_TZ_PEMA-SANGTHIG-P19:38	hu~m: rang bzhin gdod nas rnam dag pa :	3	hu~m: rang bzhin gdod nas rnam dag ba 
BO_TZ_PEMA-SANGTHIG-P19:39	zhi ba chen po'i byin phob cig :	3	zhi ba chen po byin phob cig 
BO_TZ_PEMA-SANGTHIG-P19:40	longs spyod yongs rdzogs rol pa'i sprin :	4	longs spyod yongs rdzogs rol ba sprin 
BO_TZ_PEMA-SANGTHIG-P19:41	bde ba chen po'i byin phob cig :	4	bde ba chen po byin phob cig 
BO_TZ_PEMA-SANGTHIG-P19:42	sna tshhogs 'gro 'dul sprul pa'i gar :	4	sna tshhogs gro dul sprul ba gar 
BO_TZ_PEMA-SANGTHIG-P19:43	bsam mi khyab pa'i byin phob cig :	4	bsam mi khyab ba byin phob cig 
BO_TZ_PEMA-SANGTHIG-P19:44	hu~m: lho nub rnga yab sprul pa'i zhing :	4	hu~m: lho nub rnga yab sprul ba zhing 
BO_TZ_PEMA-SANGTHIG-P19:45	'chi med dag pa'i grong khyer nas :	4	chi med dag ba grong khyer nas 
BO_TZ_PEMA-SANGTHIG-P19:46	bde chen chos sku pad+ma 'byung :	4	bde chen chos sku pad+ma byung 
BO_TZ_PEMA-SANGTHIG-P19:47	rab 'byams tshhe lha'i tshhogs dang bcas :	4	rab byam tshhe lha tshhogs dang cha 
BO_TZ_PEMA-SANGTHIG-P19:48	mi mngon dbyings nas skur bzhengs shig :	4	mi mngon dbyings nas skur bzhengs shig 
BO_TZ_PEMA-SANGTHIG-P19:49	gsang ba'i gnas 'dir byin chen phobs :	4	gsang ba gnas dir byin chen phobs 
BO_TZ_PEMA-SANGTHIG-P19:50	tshhe mda' 'di la tshhad cig ston :	5	tshhe mda di la tshhad cig ston 
BO_TZ_PEMA-SANGTHIG-P19:51	sgrub rdzas 'di la zhag cig skyil :	5	sgrub rdzas di la zhag cig skyil 
BO_TZ_PEMA-SANGTHIG-P19:52	'chi med tshhe yi dngos grub stshol :	5	chi med tshhe yi dngos grub stshol 
BO_TZ_PEMA-SANGTHIG-P19:53	om ahhu~m badzra gu ru pad+ma da+e wa d+ha ki ni dz+nya na sa ma ya a be sha ya a a a:	5	om ahhu~m badzra gu ru pad+ma da+e wa d+ha ki ni dz+nya na sa ma ya a be sha ya a a a: 
BO_TZ_PEMA-SANGTHIG-P19:54	drug pa phyi nang mchod pa brlab :	5	drug ba phyi nang mchod ba brlab 
BO_TZ_PEMA-SANGTHIG-P19:55	om ahhu~m: snang ba rnam dag mchod pa'i sprin :	5	om ahhu~m: snang ba rnam dag mchod ba sprin 
BO_TZ_PEMA-SANGTHIG-P19:56	stong pa 'od gsal bdud rtshi che :	5	stong ba d gsal bdud rtshi che 
BO_TZ_PEMA-SANGTHIG-P19:57	bde chen rang byung dmar chen po :	5	bde chen rang byung dmar chen po 
BO_TZ_PEMA-SANGTHIG-P19:58	'dod yon dam rdzas rmad du byung :	5	dod yon dam rdzas rmad du byung 
BO_TZ_PEMA-SANGTHIG-P19:59	om ahhu~m ma ha sarba pu dza a mr-ita rak+ta ba ling+ta gu h+ya sa ma ya hu~m hrihtha :	5	om ahhu~m ma ha sarba pu dza a mr-ita rak+ta ba ling+ta gu h+ya sa ma ya hu~m hrihtha 
BO_TZ_PEMA-SANGTHIG-P19:60	bdun pa rang rig gsal gdab pa :	6	bdun ba rang rig gsal gdab ba 
BO_TZ_PEMA-SANGTHIG-P19:61	hu~m: gdod nas ma skyes spros dang bral :	6	hu~m: gdod nas ma skye spros dang bral 
BO_TZ_PEMA-SANGTHIG-P19:62	rdo rje phung po'i yan lag rnams :	6	rdo rje phung po yan lag rnams 
BO_TZ_PEMA-SANGTHIG-P19:63	bden don 'od gsal chen po'i ngang :	6	bden don d gsal chen po ngang 
BO_TZ_PEMA-SANGTHIG-P19:64	rang rig dbyings su rang gsal gdab :	6	rang rig dbyings su rang gsal gdab 
BO_TZ_PEMA-SANGTHIG-P19:65	om ahhu~m: gsang gsum rdo rje'i ngo bor byas :	6	om ahhu~m: gsang gsum rdo rje ngo bor byed 
BO_TZ_PEMA-SANGTHIG-P19:66	rab 'byams sgrub pa'i phrin las kyi :	6	rab byam sgrub ba phrin las kyi 
BO_TZ_PEMA-SANGTHIG-P19:67	sngon 'gro'i rim pa zab mo 'o :bde chen chos sku'i grong khyer ba :	6	sngon gro rim ba zab mo mang :bde chen chos sku grong khyer ba 
BO_TZ_PEMA-SANGTHIG-P19:68	mngon sum lam du khyer ba'i thabs :	6	mngon sum lam du khyer ba thabs 
BO_TZ_PEMA-SANGTHIG-P19:69	phrin las dngos gzhi'i rim pa la :	6	phrin las dngos gzhi rim ba la 
BO_TZ_PEMA-SANGTHIG-P19:70	rdo rje'i gnas mchog brgyad kyis bstan :	7	rdo rje gnas mchog brgyad kyis ston 
BO_TZ_PEMA-SANGTHIG-P19:71	dang po bskyed pa'i rnal 'byor ni :	7	dang po skyed ba rnal byor ni 
BO_TZ_PEMA-SANGTHIG-P19:72	a : chos sku skye ba med pa las :	7	a chos sku skye ba med ba las 
BO_TZ_PEMA-SANGTHIG-P19:73	'gags med rang byung snying rje'i sprin :	7	gag med rang byung snying rje sprin 
BO_TZ_PEMA-SANGTHIG-P19:74	thugs rje chen po'i rol pa las :	7	thugs rje chen po rol ba las 
BO_TZ_PEMA-SANGTHIG-P19:75	rgyu yi hrihyig 'od du 'bar :	7	rgyu yi hrihyig d du bar 
BO_TZ_PEMA-SANGTHIG-P19:76	'od 'phros snod bcud dngos 'dzin sbyangs :	7	d phro snod bcud dngos dzin sbyong 
BO_TZ_PEMA-SANGTHIG-P19:77	tshhur 'dus 'byung ba'i dwangs bcud steng :	7	tshhur du byung ba dwangs bcud steng 
BO_TZ_PEMA-SANGTHIG-P19:78	nor bu chu shel las grub pa'i :	7	nor bu chu shel las grub ba 
BO_TZ_PEMA-SANGTHIG-P19:79	bde chen dag pa'i grong khyer che :	7	bde chen dag ba grong khyer che 
BO_TZ_PEMA-SANGTHIG-P19:80	tshhad dang mtshhan nyid yongs rdzogs pa'i :	8	tshhad dang mtshhan nyid yongs rdzogs ba 
BO_TZ_PEMA-SANGTHIG-P19:81	dbus mkhar sna tshhogs pad+ma ni :	8	dbus mkhar sna tshhogs pad+ma ni 
BO_TZ_PEMA-SANGTHIG-P19:82	'dab brgyad gyes pa'i lte ba ru :	8	dab brgyad gyes ba lte ba ru 
BO_TZ_PEMA-SANGTHIG-P19:83	thabs shes nyi zla pad+ma'i steng :	8	thabs shes nyi zla pad+ma steng 
BO_TZ_PEMA-SANGTHIG-P19:84	rang rig hrihyig yongs gyur las :	8	rang rig hrihyig yongs gyur las 
BO_TZ_PEMA-SANGTHIG-P19:85	'chi med mtshho skyes pad+ma 'byung :	8	chi med mtshho skye pad+ma byung 
BO_TZ_PEMA-SANGTHIG-P19:86	zag med dkar dmar lang tshhos gang :	8	zag med dkar dmar lang tshhos gang 
BO_TZ_PEMA-SANGTHIG-P19:87	bde chen thig ler 'khyil ba'i zhal :	8	bde chen thig ler khyil ba zhal 
BO_TZ_PEMA-SANGTHIG-P19:88	rjes chags spyan zung 'dzum pa'i mdangs :	8	rjes chags spyan zung dzum ba mdangs 
BO_TZ_PEMA-SANGTHIG-P19:89	snang stong zung 'jug phyag gnyis kyis :	8	snang stong zung jug phyag gnyis kyis 
BO_TZ_PEMA-SANGTHIG-P19:90	rdo rje tshhe yi bum pa 'dzin :	9	rdo rje tshhe yi bum ba dzin 
BO_TZ_PEMA-SANGTHIG-P19:91	pang du rang 'od las skyes pa'i :	9	pang du rang d las skye ba 
BO_TZ_PEMA-SANGTHIG-P19:92	'chi med ye shes man+da ra :	9	chi med ye shes man+da ra 
BO_TZ_PEMA-SANGTHIG-P19:93	mda' dar tshhe bum bsnams pas 'khril :	9	mda dar tshhe bum snom ba khril 
BO_TZ_PEMA-SANGTHIG-P19:94	zhabs zung rdo rje'i skyil krung gis :	9	zhabs zung rdo rje skyil krung gis 
BO_TZ_PEMA-SANGTHIG-P19:95	dgyes mnyam chen po'i dbyings su sbyor :	9	dgyes mnyam chen po dbyings su sbyor 
BO_TZ_PEMA-SANGTHIG-P19:96	longs spyod rdzogs sku zhi ba'i chas :	9	longs spyod rdzogs sku zhi ba cha 
BO_TZ_PEMA-SANGTHIG-P19:97	'od zer drug phrag bsam yas 'phro :	9	d zer drug phrag bsam yas phro 
BO_TZ_PEMA-SANGTHIG-P19:98	phyogs mtshhams pad+ma'i 'dab ma la :	9	phyogs mtshhams pad+ma dab ma la 
BO_TZ_PEMA-SANGTHIG-P19:99	shar phyogs kun tu dga' ba'i bdag :	9	char phyogs kun tu dga ba bdag 
BO_TZ_PEMA-SANGTHIG-P19:100	rdo rje la s+yai sku mdog dkar :	10	rdo rje la s+yai sku mdog dkar 
BO_TZ_PEMA-SANGTHIG-P19:101	phyag g.yas snang stong me long 'dzin :	10	phyag g.yas snang stong me long dzin 
BO_TZ_PEMA-SANGTHIG-P19:102	lho phyogs mchog tu dga' ba'i bdag :	10	lho phyogs mchog tu dga ba bdag 
BO_TZ_PEMA-SANGTHIG-P19:103	rdo rje ma l+ye sku mdog ser :	10	rdo rje ma l+ye sku mdog ser 
BO_TZ_PEMA-SANGTHIG-P19:104	rdo rje dkur brten sgeg pa'i nyams :	10	rdo rje dkur rten sgeg ba nyams 
BO_TZ_PEMA-SANGTHIG-P19:105	nub phyogs khyad par dga' ba'i bdag :	10	nub phyogs khyad ba dga ba bdag 
BO_TZ_PEMA-SANGTHIG-P19:106	rdo rje girti sku mdog dmar :	10	rdo rje girti sku mdog dmar 
BO_TZ_PEMA-SANGTHIG-P19:107	phyag gnyis skye med gling bu sgyur :	10	phyag gnyis skye med gling bu sgyur 
BO_TZ_PEMA-SANGTHIG-P19:108	byang phyogs dga' bral ngo bo nyid :	10	byang phyogs dga bral ngo bo nyid 
BO_TZ_PEMA-SANGTHIG-P19:109	rdo rje nirti sku mdog ljang :	10	rdo rje nirti sku mdog ljang 
BO_TZ_PEMA-SANGTHIG-P19:110	bde chen brda' yi gar la brtshon :	11	bde chen brda yi gar la brtshon 
BO_TZ_PEMA-SANGTHIG-P19:111	shar lho snang stong push+pe dkar :	11	char lho snang stong push+pe dkar 
BO_TZ_PEMA-SANGTHIG-P19:112	lho nub tshhor stong d+hu pe ser :	11	lho nub tshhor stong d+hu pe ser 
BO_TZ_PEMA-SANGTHIG-P19:113	nub byang bde stong mar me dmar //	11	nub byang bde stong mar me dmar 
BO_TZ_PEMA-SANGTHIG-P19:114	byang shar rig stong dri chab mthing :	11	byang char rig stong dri chab mthing 
BO_TZ_PEMA-SANGTHIG-P19:115	sgo bzhir las bzhi'i mgyogs ma ni :	11	sgo bzhir las bzhi mgyog ma ni 
BO_TZ_PEMA-SANGTHIG-P19:116	dkar ser dmar ljang mda' dar dang : tshhe bum bsnams shing gar stabs sgyur :	11	dkar ser dmar ljang mda dar dang tshhe bum snom shing gar stabs sgyur 
BO_TZ_PEMA-SANGTHIG-P19:117	gzhan yang phyogs mtshhams steng 'og kun :	11	gzhan yang phyogs mtshhams steng g kun 
BO_TZ_PEMA-SANGTHIG-P19:118	'ja' zer dwangs mar 'khyil ba'i klong :	11	ja zer dwangs mar khyil ba klong 
BO_TZ_PEMA-SANGTHIG-P19:119	phung khams skye mched las dbang yul :	11	phung khams skye mched las dbang yul 
BO_TZ_PEMA-SANGTHIG-P19:120	'od gsal dbyings su rnam dag pa'i :	12	d gsal dbyings su rnam dag ba 
BO_TZ_PEMA-SANGTHIG-P19:121	lha yi 'khor lo yongs rdzogs pa :	12	lha yi khor lo yongs rdzogs ba 
BO_TZ_PEMA-SANGTHIG-P19:122	ma bskyed ye nas rang shar ba'i :	12	ma skyed ye nas rang char ba 
BO_TZ_PEMA-SANGTHIG-P19:123	dkyil 'khor chen por lhun grub gyur :	12	dkyil khor chen por lhun grub gyur 
BO_TZ_PEMA-SANGTHIG-P19:124	gnyis pa ye shes lnga'i dbang skur :	12	gnyis ba ye shes lnga dbang skur 
BO_TZ_PEMA-SANGTHIG-P19:125	gdod nas dag pa'i ye shes pa :	12	gdod nas dag ba ye shes ba 
BO_TZ_PEMA-SANGTHIG-P19:126	rigs mchog rnam pa lnga yi bdag :	12	rigs mchog rnam ba lnga yi bdag 
BO_TZ_PEMA-SANGTHIG-P19:127	'od gsal chen po'i thig le ru :	12	d gsal chen po thig le ru 
BO_TZ_PEMA-SANGTHIG-P19:128	rang bzhin ngo bor dbang bskur ro :	12	rang bzhin ngo bor dbang skur ro 
BO_TZ_PEMA-SANGTHIG-P19:129	om ahhu~m: om hu~m tram hriha:	12	om ahhu~m: om hu~m tram hriha: 
BO_TZ_PEMA-SANGTHIG-P19:130	gsum pa ye shes spyan drang bstim :	13	gsum ba ye shes spyan dren stim 
BO_TZ_PEMA-SANGTHIG-P19:131	hu~m: o rgyan yul gyi nub byang mtshhams :	13	hu~m: o rgyan yul gyi nub byang mtshhams 
BO_TZ_PEMA-SANGTHIG-P19:132	pad+ma ge sar sdong po la :	13	pad+ma ge sar sdong po la 
BO_TZ_PEMA-SANGTHIG-P19:133	ya mtshhan mchog gi dngos grub brnyes :	13	ya mtshhan mchog gi dngos grub brnyes 
BO_TZ_PEMA-SANGTHIG-P19:134	pad+ma 'byung gnas zhes su grags :	13	pad+ma byung gnas zhes su grags 
BO_TZ_PEMA-SANGTHIG-P19:135	'khor du mkha' 'gro mang pos bskor :	13	khor du mkha gro mang pos skor 
BO_TZ_PEMA-SANGTHIG-P19:136	khyed kyi rjes su bdag bsgrub kyis :	13	khyed kyi rjes su bdag sgrub kyis 
BO_TZ_PEMA-SANGTHIG-P19:137	byin gyis brlab phyir gshegs su gsol :	13	byin gyis brlab phyir gshegs su gsol 
BO_TZ_PEMA-SANGTHIG-P19:138	tshhogs brgyad gnas dag srin po'i grong :	13	tshhogs brgyad gnas dag srin po grong 
BO_TZ_PEMA-SANGTHIG-P19:139	phyi nang ro mnyam ye shes zhing :	13	phyi nang ro mnyam ye shes zhing 
BO_TZ_PEMA-SANGTHIG-P19:140	bde chen rnga yab pad+ma 'od :	14	bde chen rnga yab pad+ma d 
BO_TZ_PEMA-SANGTHIG-P19:141	sku gsum dbyings kyi zhing khams nas :	14	sku gsum dbyings kyi zhing khams nas 
BO_TZ_PEMA-SANGTHIG-P19:142	'chi med mtshho skyes pad+ma 'byung :	14	chi med mtshho skye pad+ma byung 
BO_TZ_PEMA-SANGTHIG-P19:143	mkha' 'gro rgya mtshho'i tshhogs dang bcas :	14	mkha gro rgya mtshho tshhogs dang cha 
BO_TZ_PEMA-SANGTHIG-P19:144	dag pa dbyings kyi zer thag las :	14	dag ba dbyings kyi zer thag las 
BO_TZ_PEMA-SANGTHIG-P19:145	rig gdangs tshhom bu'i snang char bzhengs :	14	rig gdang tshhom bu snang char bzhengs 
BO_TZ_PEMA-SANGTHIG-P19:146	'pho bcas las rlung rtshad nas chod :	14	pho cha las rlung rtshad nas chod 
BO_TZ_PEMA-SANGTHIG-P19:147	gnyis 'dzin bdud dpung gzhom pa'i phyir :	14	gnyis dzin bdud dpung joms ba phyir 
BO_TZ_PEMA-SANGTHIG-P19:148	rang rig rang gsal ngang nas gshegs :	14	rang rig rang gsal ngang nas gshegs 
BO_TZ_PEMA-SANGTHIG-P19:149	ye shes snang cha gong du spor :	14	ye shes snang cha gong du spor 
BO_TZ_PEMA-SANGTHIG-P19:150	blo 'das chos zad dngos grub stshol :	15	blo da chos zad dngos grub stshol 
BO_TZ_PEMA-SANGTHIG-P19:151	badzra sa ma ya a bai sha ya a a a:	15	badzra sa ma ya a bai sha ya a a a: 
BO_TZ_PEMA-SANGTHIG-P19:152	dbyings nas spyan drangs ye shes lha :	15	dbyings nas spyan drangs ye shes lha 
BO_TZ_PEMA-SANGTHIG-P19:153	dam tshhig dkyil 'khor phyag rgya dang : dbyer med dgyes mnyam chen po'i ngang :	15	dam tshhig dkyil khor phyag rgya dang dbyer med dgyes mnyam chen po ngang 
BO_TZ_PEMA-SANGTHIG-P19:154	rdo rje'i ye shes brtan par bsam :	15	rdo rje ye shes brtan ba bsam 
BO_TZ_PEMA-SANGTHIG-P19:155	badzra sa ma ya tish+tha lhan :	15	badzra sa ma ya tish+tha lhan 
BO_TZ_PEMA-SANGTHIG-P19:156	bzhi pa phyag dang mchod pas mnyes :	15	bzhi ba phyag dang mchod ba mnyes 
BO_TZ_PEMA-SANGTHIG-P19:157	na mo : ye nas ma bcos chos kyi sku :	15	na mo ye nas ma chos chos kyi sku 
BO_TZ_PEMA-SANGTHIG-P19:158	rang snang ye shes dpal gyi lha :	15	rang snang ye shes dpal gyi lha 
BO_TZ_PEMA-SANGTHIG-P19:159	gang la gang 'dul sprul pa'i tshhul :	15	gang la gang dul sprul ba tshhul 
BO_TZ_PEMA-SANGTHIG-P19:160	dkyil 'khor lha la gus phyag 'tshhal :	16	dkyil khor lha la gus phyag tshhal 
BO_TZ_PEMA-SANGTHIG-P19:161	a ti pu ho :	16	a ti pu ho 
BO_TZ_PEMA-SANGTHIG-P19:162	pra titsh+tshha ho :	16	pra titsh+tshha ho 
BO_TZ_PEMA-SANGTHIG-P19:163	phyi nang gsang ba'i mchod pas mchod :	16	phyi nang gsang ba mchod ba mchod 
BO_TZ_PEMA-SANGTHIG-P19:164	hu~m: yi ge yid bzhin rin chen sprin :	16	hu~m: yi ge yid bzhin rin chen sprin 
BO_TZ_PEMA-SANGTHIG-P19:165	dbyangs gsal sna tshhogs 'du 'phro 'bar :	16	dbyangs gsal sna tshhogs du phro bar 
BO_TZ_PEMA-SANGTHIG-P19:166	mkha' khyab mchod pa'i phyag rgyar shar :	16	mkha khyab mchod ba phyag rgyar char 
BO_TZ_PEMA-SANGTHIG-P19:167	dgyes mnyam rol pa'i zhing du gyur :	16	dgyes mnyam rol ba zhing du gyur 
BO_TZ_PEMA-SANGTHIG-P19:168	sarba pu dza ho :	16	sarba pu dza ho 
BO_TZ_PEMA-SANGTHIG-P19:169	zhes pas mchod sprin rgyas par spel :	16	zhes ba mchod sprin rgya ba spel 
BO_TZ_PEMA-SANGTHIG-P19:170	om: mchod pa'i phyag rgya chen po ni :	17	om: mchod ba phyag rgya chen po ni 
BO_TZ_PEMA-SANGTHIG-P19:171	sems kyis yid bzhin sprin tshhogs spro :	17	sems kyis yid bzhin sprin tshhogs spro 
BO_TZ_PEMA-SANGTHIG-P19:172	nyer spyod 'dod yon bsam yas pa :	17	nyer spyod dod yon bsam yas ba 
BO_TZ_PEMA-SANGTHIG-P19:173	bde ba chen po'i rgyan du rol :	17	bde ba chen po rgyan du rol 
BO_TZ_PEMA-SANGTHIG-P19:174	om shri badzra ra ga d+hu pe d+hu:	17	om shri badzra ra ga d+hu pe d+hu: 
BO_TZ_PEMA-SANGTHIG-P19:175	push+pe pu : a lo ke hri:	17	push+pe pu a lo ke hri: 
BO_TZ_PEMA-SANGTHIG-P19:176	g+han+d+he g+han : om:	17	g+han+d+he g+han om: 
BO_TZ_PEMA-SANGTHIG-P19:177	sha lnga bdud rtshi'i dam tshhig rdzas :	17	sha lnga bdud rtshi dam tshhig rdzas 
BO_TZ_PEMA-SANGTHIG-P19:178	ye shes rigs lnga zhu ba'i bcud :	17	ye shes rigs lnga ju ba bcud 
BO_TZ_PEMA-SANGTHIG-P19:179	rgyu drug sems can kun sgrol ba :	17	rgyu drug sems can kun sgrol ba 
BO_TZ_PEMA-SANGTHIG-P19:180	bla na med pa'i mchod pas mchod :	18	bla na med ba mchod ba mchod 
BO_TZ_PEMA-SANGTHIG-P19:181	om sarba pany+tsha a mr-ita kha hi:	18	om sarba pany+tsha a mr-ita kha hi: 
BO_TZ_PEMA-SANGTHIG-P19:182	om: stong pa dbyings kyi gtor gzhong du :	18	om: stong ba dbyings kyi thor gzhong du 
BO_TZ_PEMA-SANGTHIG-P19:183	snang ba rnam dag mchod gtor bshams :	18	snang ba rnam dag mchod thor bshams 
BO_TZ_PEMA-SANGTHIG-P19:184	zhen med rang grol 'dod yon 'phro :	18	zhen med rang grol dod yon phro 
BO_TZ_PEMA-SANGTHIG-P19:185	rgyal ba dgyes pa'i sprin du 'bul :	18	rgyal ba dgyes ba sprin du bul 
BO_TZ_PEMA-SANGTHIG-P19:186	ma ha ba lim ta kha hi :	18	ma ha ba lim ta kha hi 
BO_TZ_PEMA-SANGTHIG-P19:187	hu~m: srid gsum chags pa bsgral pa'i khrag :	18	hu~m: srid gsum chags ba bsgral ba khrag 
BO_TZ_PEMA-SANGTHIG-P19:188	bde ba chen po'i rba rlabs 'phyo :	18	bde ba chen po rba rlabs phyo 
BO_TZ_PEMA-SANGTHIG-P19:189	'dod yon lha mos nam mkha' gang :	18	dod yon lha mos nam mkha gang 
BO_TZ_PEMA-SANGTHIG-P19:190	bde chen gsang ba'i rdzas su bzhes :	19	bde chen gsang ba rdzas su bzhes 
BO_TZ_PEMA-SANGTHIG-P19:191	ma ha rak+ta kha hi :	19	ma ha rak+ta kha hi 
BO_TZ_PEMA-SANGTHIG-P19:192	ho : sgyu 'phrul chen mo chags pa che :	19	ho sgyu phrul chen mo chags ba che 
BO_TZ_PEMA-SANGTHIG-P19:193	gzugs mdzes 'khril ldem kun tu skyod :	19	gzugs mdzes khril ldem kun tu skyod 
BO_TZ_PEMA-SANGTHIG-P19:194	mi mo rnams kyi reg bya'i dngos :	19	mi mo rnams kyi reg byed dngos 
BO_TZ_PEMA-SANGTHIG-P19:195	byin rlabs thim pa'i mchod par bzhes :	19	byin rlabs thim ba mchod ba bzhes 
BO_TZ_PEMA-SANGTHIG-P19:196	ma ha yo gi pu dza ho :	19	ma ha yo gi pu dza ho 
BO_TZ_PEMA-SANGTHIG-P19:197	a : bde ba chen po stong pa che :	19	a bde ba chen po stong ba che 
BO_TZ_PEMA-SANGTHIG-P19:198	'od gsal chen po zung 'jug che :	19	d gsal chen po zung jug che 
BO_TZ_PEMA-SANGTHIG-P19:199	gnyis med chen po mnyam pa che :	19	gnyis med chen po mnyam ba che 
BO_TZ_PEMA-SANGTHIG-P19:200	dgyes pa chen po'i dbyings che ho :	20	dgyes ba chen po dbyings che ho 
BO_TZ_PEMA-SANGTHIG-P19:201	lnga pa rdo rje'i glu yis bstod :	20	lnga ba rdo rje glu yis bstod 
BO_TZ_PEMA-SANGTHIG-P19:202	hu~m: ma bcos spros bral chos kyi sku :	20	hu~m: ma chos spros bral chos kyi sku 
BO_TZ_PEMA-SANGTHIG-P19:203	bde chen lhun grub longs spyod rdzogs :	20	bde chen lhun grub longs spyod rdzogs 
BO_TZ_PEMA-SANGTHIG-P19:204	skye 'chi spangs pa sprul pa'i sku :	20	skye chi spong ba sprul ba sku 
BO_TZ_PEMA-SANGTHIG-P19:205	dbyer med mtshho skyes rgyal bar bstod :	20	dbyer med mtshho skye rgyal ba bstod 
BO_TZ_PEMA-SANGTHIG-P19:206	mtshhan dpe'i lus ldan rdo rje'i sku :	20	mtshhan dpe lus ldan rdo rje sku 
BO_TZ_PEMA-SANGTHIG-P19:207	snang stong gnyis med yum dang sbyor :	20	snang stong gnyis med yum dang sbyor 
BO_TZ_PEMA-SANGTHIG-P19:208	thabs shes rdo rje bum pa 'dzin :	20	thabs shes rdo rje bum ba dzin 
BO_TZ_PEMA-SANGTHIG-P19:209	rig 'dzin rgyal ba'i gtsho la bstod :	20	rig dzin rgyal ba gtsho la bstod 
BO_TZ_PEMA-SANGTHIG-P19:210	brjod du med kyang brjod pa'i gzhi :	21	rjod du med kyang rjod ba gzhi 
BO_TZ_PEMA-SANGTHIG-P19:211	yi ge 'khor lo sprul pa'i sprin :	21	yi ge khor lo sprul ba sprin 
BO_TZ_PEMA-SANGTHIG-P19:212	gsang chen gsang ba'i 'du 'phro che :	21	gsang chen gsang ba du phro che 
BO_TZ_PEMA-SANGTHIG-P19:213	skye 'gag med pa'i gsung la bstod :	21	skye gag med ba gsung la bstod 
BO_TZ_PEMA-SANGTHIG-P19:214	snang srid gdod nas mnyam pa che :	21	snang srid gdod nas mnyam ba che 
BO_TZ_PEMA-SANGTHIG-P19:215	yid dpyod tshhig gis mtshhon min pa :	21	yid dpyod tshhig gis mtshhon min ba 
BO_TZ_PEMA-SANGTHIG-P19:216	mi 'gyur 'od gsal bde ba che :	21	mi gyur d gsal bde ba che 
BO_TZ_PEMA-SANGTHIG-P19:217	rig stong rdo rje'i thugs la bstod :	21	rig stong rdo rje thugs la bstod 
BO_TZ_PEMA-SANGTHIG-P19:218	sangs rgyas kho na'i ma 'dres chos :	21	sangs rgya kho na ma dre chos 
BO_TZ_PEMA-SANGTHIG-P19:219	yon tan nyer lnga lhun gyis grub :	21	yon tan nyer lnga lhun gyis grub 
BO_TZ_PEMA-SANGTHIG-P19:220	dag pa rab 'byams dbyings kyi rgyan :	22	dag ba rab byam dbyings kyi rgyan 
BO_TZ_PEMA-SANGTHIG-P19:221	yon tan bsam mi khyab la bstod :	22	yon tan bsam mi khyab la bstod 
BO_TZ_PEMA-SANGTHIG-P19:222	nyi ma dang ni 'od zer bzhin :	22	nyi ma dang ni d zer bzhin 
BO_TZ_PEMA-SANGTHIG-P19:223	'dus ma byas pa'i phrin las ni :	22	du ma byed ba phrin las ni 
BO_TZ_PEMA-SANGTHIG-P19:224	rtshol med 'gro ba'i khams la 'jug :	22	rtshol med gro ba khams la jug 
BO_TZ_PEMA-SANGTHIG-P19:225	phrin las pha mtha' yas la bstod :	22	phrin las pha mtha yas la bstod 
BO_TZ_PEMA-SANGTHIG-P19:226	dga' ba bzhi dang stong bzhi'i bdag :	22	dga ba bzhi dang stong bzhi bdag 
BO_TZ_PEMA-SANGTHIG-P19:227	rnam shes tshhogs brgyad gnas dag cing :	22	rnam shes tshhogs brgyad gnas dag cing 
BO_TZ_PEMA-SANGTHIG-P19:228	mchog thun phrin las myur stshol ba'i :	22	mchog thun phrin las myur stshol ba 
BO_TZ_PEMA-SANGTHIG-P19:229	lha mo mgyogs ma'i tshhogs la bstod :	22	lha mo mgyog ma tshhogs la bstod 
BO_TZ_PEMA-SANGTHIG-P19:230	tshhad med bzhi ldan sgo ma bzhi :	23	tshhad med bzhi ldan sgo ma bzhi 
BO_TZ_PEMA-SANGTHIG-P19:231	ye shes rab 'byams gzhal yas khang :	23	ye shes rab byam jal yas khang 
BO_TZ_PEMA-SANGTHIG-P19:232	dag mnyam dbyer med lha'i 'khor lo :	23	dag mnyam dbyer med lha khor lo 
BO_TZ_PEMA-SANGTHIG-P19:233	pha mtha' yas la gus pas bstod :	23	pha mtha yas la gus ba bstod 
BO_TZ_PEMA-SANGTHIG-P19:234	rdo rje'i glu yis bstod pa yis :	23	rdo rje glu yis bstod ba yis 
BO_TZ_PEMA-SANGTHIG-P19:235	srid lam dub pa'i sems can rnams :	23	srid lam dub ba sems can rnams 
BO_TZ_PEMA-SANGTHIG-P19:236	ma rtogs gsang ba'i sgo phyes te :	23	ma rtogs gsang ba sgo phyes te 
BO_TZ_PEMA-SANGTHIG-P19:237	brjod med gzhi don rig par shog :	23	rjod med gzhi don rig ba shog 
BO_TZ_PEMA-SANGTHIG-P19:238	drug pa thugs dam gnad nas bskul :	23	drug ba thugs dam gnad nas skul 
BO_TZ_PEMA-SANGTHIG-P19:239	hu~m: ma bcos rig pa 'dus ma byas :	23	hu~m: ma chos rig ba du ma byed 
BO_TZ_PEMA-SANGTHIG-P19:240	bde chen brda yi grong khyer nas :	24	bde chen brda yi grong khyer nas 
BO_TZ_PEMA-SANGTHIG-P19:241	'chi med chos sku snang mtha' yas :	24	chi med chos sku snang mtha yas 
BO_TZ_PEMA-SANGTHIG-P19:242	sgrub la 'chi med mchog stshol phyir :	24	sgrub la chi med mchog stshol phyir 
BO_TZ_PEMA-SANGTHIG-P19:243	thugs dam bskul lo dngos grub stshol :	24	thugs dam skul lo dngos grub stshol 
BO_TZ_PEMA-SANGTHIG-P19:244	dag pa rab 'byams dbyings kyi rgyan :	24	dag ba rab byam dbyings kyi rgyan 
BO_TZ_PEMA-SANGTHIG-P19:245	nges pa lnga ldan zhing khams nas :	24	nges ba lnga ldan zhing khams nas 
BO_TZ_PEMA-SANGTHIG-P19:246	longs spyod rdzogs sku spyan ras gzigs :	24	longs spyod rdzogs sku spyan ras gzigs 
BO_TZ_PEMA-SANGTHIG-P19:247	sgrub la 'chi med mchog stshol phyir :	24	sgrub la chi med mchog stshol phyir 
BO_TZ_PEMA-SANGTHIG-P19:248	thugs dam bskul lo dngos grub stshol :	24	thugs dam skul lo dngos grub stshol 
BO_TZ_PEMA-SANGTHIG-P19:249	'chi med grong khyer pad+ma 'od :	24	chi med grong khyer pad+ma d 
BO_TZ_PEMA-SANGTHIG-P19:250	rnga yab sprul pa'i zhing khams nas :	25	rnga yab sprul ba zhing khams nas 
BO_TZ_PEMA-SANGTHIG-P19:251	pad+ma 'byung gnas sprul pa'i sku :	25	pad+ma byung gnas sprul ba sku 
BO_TZ_PEMA-SANGTHIG-P19:252	sgrub la 'chi med mchog stshol phyir :	25	sgrub la chi med mchog stshol phyir 
BO_TZ_PEMA-SANGTHIG-P19:253	thugs dam bskul lo dngos grub stshol :	25	thugs dam skul lo dngos grub stshol 
BO_TZ_PEMA-SANGTHIG-P19:254	sgron drug dwangs ma'i zhing khams nas :	25	sgron drug dwangs ma zhing khams nas 
BO_TZ_PEMA-SANGTHIG-P19:255	'chi med tshhe yi mnga' bdag mo :	25	chi med tshhe yi mnga bdag mo 
BO_TZ_PEMA-SANGTHIG-P19:256	bde chen ye shes mtshho rgyal ma :	25	bde chen ye shes mtshho rgyal ma 
BO_TZ_PEMA-SANGTHIG-P19:257	sgrub la 'chi med mchog stshol phyir :	25	sgrub la chi med mchog stshol phyir 
BO_TZ_PEMA-SANGTHIG-P19:258	thugs dam bskul lo dngos grub stshol :	25	thugs dam skul lo dngos grub stshol 
BO_TZ_PEMA-SANGTHIG-P19:259	snang srid dag pa rab 'byams zhing :	25	snang srid dag ba rab byam zhing 
BO_TZ_PEMA-SANGTHIG-P19:260	phrin las pha mtha' yas pa nas :	26	phrin las pha mtha yas ba nas 
BO_TZ_PEMA-SANGTHIG-P19:261	zab gter sgo 'byed sprul pa'i sku :	26	zab gter sgo byed sprul ba sku 
BO_TZ_PEMA-SANGTHIG-P19:262	sgrub la 'chi med mchog stshol phyir :	26	sgrub la chi med mchog stshol phyir 
BO_TZ_PEMA-SANGTHIG-P19:263	thugs dam bskul lo dngos grub stshol :	26	thugs dam skul lo dngos grub stshol 
BO_TZ_PEMA-SANGTHIG-P19:264	'chi med phyag rgya'i dkyil 'khor pa :	26	chi med phyag rgya dkyil khor ba 
BO_TZ_PEMA-SANGTHIG-P19:265	ye shes pha mtha' yas pa'i bdag :	26	ye shes pha mtha yas ba bdag 
BO_TZ_PEMA-SANGTHIG-P19:266	phrin las bsam mi khyab pa rnams :	26	phrin las bsam mi khyab ba rnams 
BO_TZ_PEMA-SANGTHIG-P19:267	sgrub la 'chi med mchog stshol phyir :	26	sgrub la chi med mchog stshol phyir 
BO_TZ_PEMA-SANGTHIG-P19:268	thugs dam bskul lo dngos grub stshol :	26	thugs dam skul lo dngos grub stshol 
BO_TZ_PEMA-SANGTHIG-P19:269	badzra sa ma ya sid+d+hi pha la hu~m a :	26	badzra sa ma ya sid+d+hi pha la hu~m a 
BO_TZ_PEMA-SANGTHIG-P19:270	bdun pa dzapa? kyi rnal 'byor ni :	27	bdun ba dzapa? kyi rnal byor ni 
BO_TZ_PEMA-SANGTHIG-P19:271	rang nyid lha yi skur gsal ba'i :	27	rang nyid lha yi skur gsal ba 
BO_TZ_PEMA-SANGTHIG-P19:272	snying dbus dag pa'i thig le ru :	27	snying dbus dag ba thig le ru 
BO_TZ_PEMA-SANGTHIG-P19:273	bde chen chos sku tshhe dpag med :	27	bde chen chos sku tshhe dpog med 
BO_TZ_PEMA-SANGTHIG-P19:274	dmar gsal mnyam gzhag tshhe bum 'dzin :	27	dmar gsal mnyam jog tshhe bum dzin 
BO_TZ_PEMA-SANGTHIG-P19:275	de yi thugs kar nyi zla yi :	27	de yi thugs kar nyi zla yi 
BO_TZ_PEMA-SANGTHIG-P19:276	thabs shes gwa 'u 'bar ba'i dbus :	27	thabs shes gwa u bar ba dbus 
BO_TZ_PEMA-SANGTHIG-P19:277	mi 'gyur thugs srog hrihyig mthar :	27	mi gyur thugs srog hrihyig mthar 
BO_TZ_PEMA-SANGTHIG-P19:278	rdo rje'i sngags kyis bskor ba las :	27	rdo rje sngags kyis skor ba las 
BO_TZ_PEMA-SANGTHIG-P19:279	gsal zhing 'bar ba'i 'od zer gyis :	27	gsal zhing bar ba d zer gyis 
BO_TZ_PEMA-SANGTHIG-P19:280	snod bcud skye 'gro'i rgud pa sbyangs :	28	snod bcud skye gro rgud ba sbyong 
BO_TZ_PEMA-SANGTHIG-P19:281	'khor 'das dwangs bcud tshhur 'dus pas :	28	khor da dwangs bcud tshhur du ba 
BO_TZ_PEMA-SANGTHIG-P19:282	bde chen rdo rje'i sku ru bsam :	28	bde chen rdo rje sku ru bsam 
BO_TZ_PEMA-SANGTHIG-P19:283	om ahhu~m badzra gu ru pad+ma sid+d+hi dz+nya na a yu she hu~m b+h+ru~m nr-i dza :	28	om ahhu~m badzra gu ru pad+ma sid+d+hi dz+nya na a yu she hu~m b+h+ru~m nr-i dza 
BO_TZ_PEMA-SANGTHIG-P19:284	zhes pa khong pa'i dbugs bzhin bzla :	28	zhes ba khong ba dbugs bzhin bzla 
BO_TZ_PEMA-SANGTHIG-P19:285	ting 'dzin ldan pa'i rnal 'byor gyis :	28	ting dzin ldan ba rnal byor gyis 
BO_TZ_PEMA-SANGTHIG-P19:286	rtshe gcig zla ba bdun bsgoms na :	28	rtshe gcig zla ba bdun sgom na 
BO_TZ_PEMA-SANGTHIG-P19:287	'chi med rig 'dzin nges par 'grub :	28	chi med rig dzin nges ba grub 
BO_TZ_PEMA-SANGTHIG-P19:288	brgyad pa grub pa'i rtags mthong nas :	28	brgyad ba grub ba rtags mthong nas 
BO_TZ_PEMA-SANGTHIG-P19:289	rdo rje'i dngos grub yang dag blang :	28	rdo rje dngos grub yang dag blang 
BO_TZ_PEMA-SANGTHIG-P19:290	hu~m: bde chen chos sku'i lha tshhogs pa :	29	hu~m: bde chen chos sku lha tshhogs ba 
BO_TZ_PEMA-SANGTHIG-P19:291	dang po bsnyen cing bar du bsgrubs :	29	dang po snyen cing ba du sgrub 
BO_TZ_PEMA-SANGTHIG-P19:292	da lta bdag dang gnyis su med :	29	da lta bdag dang gnyis su med 
BO_TZ_PEMA-SANGTHIG-P19:293	gnyis med rol pa'i dkyil 'khor pa'i :	29	gnyis med rol ba dkyil khor ba 
BO_TZ_PEMA-SANGTHIG-P19:294	mi 'gyur sku yi gsang ba nas :	29	mi gyur sku yi gsang ba nas 
BO_TZ_PEMA-SANGTHIG-P19:295	rnal 'byor lus la byin gyis rlobs :	29	rnal byor lus la byin gyis rlobs 
BO_TZ_PEMA-SANGTHIG-P19:296	'gag med gsung gi gsang ba nas :	29	gag med gsung gi gsang ba nas 
BO_TZ_PEMA-SANGTHIG-P19:297	rnal 'byor ngag la byin gyis rlobs :	29	rnal byor ngag la byin gyis rlobs 
BO_TZ_PEMA-SANGTHIG-P19:298	'khrul med thugs kyi dkyil 'khor nas :	29	khrul med thugs kyi dkyil khor nas 
BO_TZ_PEMA-SANGTHIG-P19:299	rnal 'byor yid la byin gyis rlobs :	29	rnal byor yid la byin gyis rlobs 
BO_TZ_PEMA-SANGTHIG-P19:300	thun mong tshhe yi dngos grub stshol :	30	thun mong tshhe yi dngos grub stshol 
BO_TZ_PEMA-SANGTHIG-P19:301	khyad par dbang bcu'i ye shes spel :	30	khyad ba dbang chu ye shes spel 
BO_TZ_PEMA-SANGTHIG-P19:302	mchog tu chos nyid zad sar skyol :	30	mchog tu chos nyid zad sar skyol 
BO_TZ_PEMA-SANGTHIG-P19:303	'od gsal 'pho chen dngos grub stshol :	30	d gsal pho chen dngos grub stshol 
BO_TZ_PEMA-SANGTHIG-P19:304	ces brjod dngos grub rdzas la rol :	30	ces rjod dngos grub rdzas la rol 
BO_TZ_PEMA-SANGTHIG-P19:305	'chi med 'dus pa rtsha ba'i rgyud :	30	chi med du ba rtsha ba brgyud 
BO_TZ_PEMA-SANGTHIG-P19:306	bye ba'i yang bcud gnad du dril :	30	bye ba yang bcud gnad du dril 
BO_TZ_PEMA-SANGTHIG-P19:307	ma 'ongs dbang chen dkyil 'khor las :	30	ma ngs dbang chen dkyil khor las 
BO_TZ_PEMA-SANGTHIG-P19:308	grags pa'i ming gis gter du blangs :	30	grags ba ming gis gter du blangs 
BO_TZ_PEMA-SANGTHIG-P19:309	rang gzhan skal ldan don byas te :	30	rang gzhan skal ldan don byed te 
BO_TZ_PEMA-SANGTHIG-P19:310	badzra ka shi nyid la gtad :	31	badzra ka chi nyid la gtod 
BO_TZ_PEMA-SANGTHIG-P19:311	slar yang ma 'ongs rtshub 'gyur dus :	31	slar yang ma ngs rtshub gyur dus 
BO_TZ_PEMA-SANGTHIG-P19:312	bod khams kla klo'i skabs tshhol zhing :	31	bod khams kla klo skabs tshhol zhing 
BO_TZ_PEMA-SANGTHIG-P19:313	bstan pa'i lhag ma sdud nye'i skabs :	31	ston ba lhag ma sdud nye skabs 
BO_TZ_PEMA-SANGTHIG-P19:314	'jam dpal chos kyi bshes gnyen gyis :	31	jam dpal chos kyi bshes gnyen gyis 
BO_TZ_PEMA-SANGTHIG-P19:315	rjes bzung sngags kyi rnal 'byor pa :	31	rjes bzung sngags kyi rnal byor ba 
BO_TZ_PEMA-SANGTHIG-P19:316	badzra ming can rig rtshal can :	31	badzra ming can rig rtshal can 
BO_TZ_PEMA-SANGTHIG-P19:317	de'i spyod yul du gyur te :	31	de spyod yul du gyur te 
BO_TZ_PEMA-SANGTHIG-P19:318	mnyam gnyis zung sogs bcu phrag la :	31	mnyam gnyis zung sogs chu phrag la 
BO_TZ_PEMA-SANGTHIG-P19:319	phan pa bla na med par 'gyur :ye shes gsang ba bsam mi khyab :	31	phan ba bla na med ba gyur :ye shes gsang ba bsam mi khyab 
BO_TZ_PEMA-SANGTHIG-P19:320	rang rig ngo bor ro mnyam kyang :	32	rang rig ngo bor ro mnyam kyang 
BO_TZ_PEMA-SANGTHIG-P19:321	rnam pa'i tshhul du lha'i 'khor lo :	32	rnam ba tshhul du lha khor lo 
BO_TZ_PEMA-SANGTHIG-P19:322	yan lag bzhi ldan bsnyen cing sgrub :	32	yan lag bzhi ldan snyen cing sgrub 
BO_TZ_PEMA-SANGTHIG-P19:323	mjug tu bsod nams ye shes kyi :	32	mjug tu bsod nams ye shes kyi 
BO_TZ_PEMA-SANGTHIG-P19:324	tshhogs gnyis yongs su rdzogs pa'i phyir :	32	tshhogs gnyis yongs su rdzogs ba phyir 
BO_TZ_PEMA-SANGTHIG-P19:325	phyi nang gsang ba'i tshhogs 'khor ni :	32	phyi nang gsang ba tshhogs khor ni 
BO_TZ_PEMA-SANGTHIG-P19:326	rdo rje'i gnas mchog bcu ru bstan :	32	rdo rje gnas mchog chu ru ston 
BO_TZ_PEMA-SANGTHIG-P19:327	dang po byin rlabs ye shes 'gugs :	32	dang po byin rlabs ye shes gugs 
BO_TZ_PEMA-SANGTHIG-P19:328	thabs shes dam tshhig rdzas rnams bsags :	32	thabs shes dam tshhig rdzas rnams bsags 
BO_TZ_PEMA-SANGTHIG-P19:329	'du bar 'os rnams gral du 'khod :	32	du ba s rnams gral du khod 
BO_TZ_PEMA-SANGTHIG-P19:330	ram yam kham: bdag nyid lha yi thugs ka nas :	33	ram yam kham: bdag nyid lha yi thugs ka nas 
BO_TZ_PEMA-SANGTHIG-P19:331	yi ge ram yam kham gsum 'phros :	33	yi ge ram yam kham gsum phro 
BO_TZ_PEMA-SANGTHIG-P19:332	dngos 'dzin bag chags bsregs gtor sbyangs :	33	dngos dzin bag chags bsregs thor sbyong 
BO_TZ_PEMA-SANGTHIG-P19:333	slar yang snying po 'bru gsum 'phros :	33	slar yang snying po bru gsum phro 
BO_TZ_PEMA-SANGTHIG-P19:334	ye shes bdud rtshi'i phung por gyur :	33	ye shes bdud rtshi phung por gyur 
BO_TZ_PEMA-SANGTHIG-P19:335	om ahhu~m: hu~m: bzhengs shig chos kyi dbyings nas bzhengs :	33	om ahhu~m: hu~m: bzhengs shig chos kyi dbyings nas bzhengs 
BO_TZ_PEMA-SANGTHIG-P19:336	rtsha gsum kun 'dus pad+ma 'byung :	33	rtsha gsum kun du pad+ma byung 
BO_TZ_PEMA-SANGTHIG-P19:337	rab 'byams tshhe lha'i tshhogs dang bcas :	33	rab byam tshhe lha tshhogs dang cha 
BO_TZ_PEMA-SANGTHIG-P19:338	gzhon nu bum sku'i gzhal yas nas :	33	gzhon nu bum sku jal yas nas 
BO_TZ_PEMA-SANGTHIG-P19:339	gzhi snang ye shes chen por bzhengs :	33	gzhi snang ye shes chen por bzhengs 
BO_TZ_PEMA-SANGTHIG-P19:340	'ja' zer 'od phung 'khrigs pa'i dbus :	34	ja zer d phung khrig ba dbus 
BO_TZ_PEMA-SANGTHIG-P19:341	dag pa lha yi snang char gshegs :	34	dag ba lha yi snang char gshegs 
BO_TZ_PEMA-SANGTHIG-P19:342	ye shes tshhogs kyi 'du bar spyon :	34	ye shes tshhogs kyi du ba spyon 
BO_TZ_PEMA-SANGTHIG-P19:343	dbu skra zur phud ldems se ldem :	34	dbu skra zur bud ldems se ldem 
BO_TZ_PEMA-SANGTHIG-P19:344	lcang lo'i zar bu ta la la :	34	lcang lo zar bu ta la la 
BO_TZ_PEMA-SANGTHIG-P19:345	skye med hu~m glu di ri ri :	34	skye med hu~m glu di ri ri 
BO_TZ_PEMA-SANGTHIG-P19:346	phat kyi brda skad sangs se sang :	34	phat kyi brda skad sangs se sang 
BO_TZ_PEMA-SANGTHIG-P19:347	glu len gar stabs khyugs se khyug :	34	glu len gar stabs khyugs se khyug 
BO_TZ_PEMA-SANGTHIG-P19:348	rab 'byams nam mkha'i khams bkang ste :	34	rab byam nam mkha khams geng ste 
BO_TZ_PEMA-SANGTHIG-P19:349	mchod pa'i gnas 'dir gshegs su gsol :	34	mchod ba gnas dir gshegs su gsol 
BO_TZ_PEMA-SANGTHIG-P19:350	e a ral+li hring hring phaim phaim dza dza :	35	e a ral+li hring hring phaim phaim dza dza 
BO_TZ_PEMA-SANGTHIG-P19:351	gnyis pa tshhogs kyi mchod pa 'bul :	35	gnyis ba tshhogs kyi mchod ba bul 
BO_TZ_PEMA-SANGTHIG-P19:352	om ahhu~m: snang ba snod kyi ka pa lar :	35	om ahhu~m: snang ba snod kyi ka ba lar 
BO_TZ_PEMA-SANGTHIG-P19:353	srid pa bcud kyi tshhogs gtor bshams :	35	srid ba bcud kyi tshhogs thor bshams 
BO_TZ_PEMA-SANGTHIG-P19:354	rten 'byung sgyu ma'i 'od zer 'phro :	35	rten byung sgyu ma d zer phro 
BO_TZ_PEMA-SANGTHIG-P19:355	bla ma sprul pa'i sku la 'bul :	35	bla ma sprul ba sku la bul 
BO_TZ_PEMA-SANGTHIG-P19:356	rdo rje phung po'i ka pa lar :	35	rdo rje phung po ka ba lar 
BO_TZ_PEMA-SANGTHIG-P19:357	rtsha rlung thig le'i tshhogs gtor bshams :	35	rtsha rlung thig le tshhogs thor bshams 
BO_TZ_PEMA-SANGTHIG-P19:358	dag pa lha yi 'du 'phro 'bar :	35	dag ba lha yi du phro bar 
BO_TZ_PEMA-SANGTHIG-P19:359	bla ma longs spyod rdzogs skur 'bul :	35	bla ma longs spyod rdzogs skur bul 
BO_TZ_PEMA-SANGTHIG-P19:360	mi 'gyur dbyings kyi ka pa lar :	36	mi gyur dbyings kyi ka ba lar 
BO_TZ_PEMA-SANGTHIG-P19:361	ye shes rab 'byams tshhogs gtor bshams :	36	ye shes rab byam tshhogs thor bshams 
BO_TZ_PEMA-SANGTHIG-P19:362	gnyis med mnyam pa'i 'od zer 'phro :	36	gnyis med mnyam ba d zer phro 
BO_TZ_PEMA-SANGTHIG-P19:363	bla ma chos kyi sku la 'bul :	36	bla ma chos kyi sku la bul 
BO_TZ_PEMA-SANGTHIG-P19:364	sgron drug thig le'i ka pa lar :	36	sgron drug thig le ka ba lar 
BO_TZ_PEMA-SANGTHIG-P19:365	'od gsal snang bzhi'i tshhogs gtor bshams :	36	d gsal snang bzhi tshhogs thor bshams 
BO_TZ_PEMA-SANGTHIG-P19:366	bde ba chen po'i 'od zer 'phro :	36	bde ba chen po d zer phro 
BO_TZ_PEMA-SANGTHIG-P19:367	bla ma ngo bo nyid skur 'bul :	36	bla ma ngo bo nyid skur bul 
BO_TZ_PEMA-SANGTHIG-P19:368	pad+ma b+hany+dza'i bzed khong du :	36	pad+ma b+hany+dza bzed khong du 
BO_TZ_PEMA-SANGTHIG-P19:369	sha lnga bdud rtshi'i dam tshhig rdzas :	36	sha lnga bdud rtshi dam tshhig rdzas 
BO_TZ_PEMA-SANGTHIG-P19:370	ye shes rab 'byams 'od zer 'phro :	37	ye shes rab byam d zer phro 
BO_TZ_PEMA-SANGTHIG-P19:371	'dod yon lha mos nam mkha' gang :	37	dod yon lha mos nam mkha gang 
BO_TZ_PEMA-SANGTHIG-P19:372	dkyil 'khor lha tshhogs rnams la 'bul :	37	dkyil khor lha tshhogs rnams la bul 
BO_TZ_PEMA-SANGTHIG-P19:373	sarba ga na tshakra pu dza ho :	37	sarba ga na tshakra pu dza ho 
BO_TZ_PEMA-SANGTHIG-P19:374	gsum pa thugs dam bskang zhing bshags pa ni :	37	gsum ba thugs dam skong zhing chags ba ni 
BO_TZ_PEMA-SANGTHIG-P19:375	ho : dkyil 'khor lha tshhogs dgongs su gsol :	37	ho dkyil khor lha tshhogs dgongs su gsol 
BO_TZ_PEMA-SANGTHIG-P19:376	bdag cag ma rig gti mug pas :	37	bdag cag ma rig gti mug ba 
BO_TZ_PEMA-SANGTHIG-P19:377	thun mong dang ni khyad par gyi :	37	thun mong dang ni khyad ba gyi 
BO_TZ_PEMA-SANGTHIG-P19:378	rtsha ba yan lag dam tshhig las :	37	rtsha ba yan lag dam tshhig las 
BO_TZ_PEMA-SANGTHIG-P19:379	'gal zhing nyams par gyur pa kun :	37	gal zhing nyams ba gyur ba kun 
BO_TZ_PEMA-SANGTHIG-P19:380	'dod yon tshhogs kyi mchod pas bshags :	38	dod yon tshhogs kyi mchod ba chags 
BO_TZ_PEMA-SANGTHIG-P19:381	phyi nang gsang ba'i dam tshhig gis :	38	phyi nang gsang ba dam tshhig gis 
BO_TZ_PEMA-SANGTHIG-P19:382	thugs dam chos kyi dbyings su bskang :	38	thugs dam chos kyi dbyings su skong 
BO_TZ_PEMA-SANGTHIG-P19:383	sa ma ya shud+d+he a :	38	sa ma ya shud+d+he a 
BO_TZ_PEMA-SANGTHIG-P19:384	bzhi pa nyams pa 'gugs shing bsgral :	38	bzhi ba nyams ba gugs shing bsgral 
BO_TZ_PEMA-SANGTHIG-P19:385	hu~m: e yi tshhogs kyi dkyil 'khor du :	38	hu~m: e yi tshhogs kyi dkyil khor du 
BO_TZ_PEMA-SANGTHIG-P19:386	gtum chen rngams pa khros pa'i lha :	38	thum chen rngams ba khro ba lha 
BO_TZ_PEMA-SANGTHIG-P19:387	'bar ba chen po'i skur bzhengs la :	38	bar ba chen po skur bzhengs la 
BO_TZ_PEMA-SANGTHIG-P19:388	bdag lta gnyis 'dzin bdud sde'i dpung :	38	bdag lta gnyis dzin bdud sde dpung 
BO_TZ_PEMA-SANGTHIG-P19:389	mtshhan ma rdzas kyi rten la khug :	38	mtshhan ma rdzas kyi rten la khug 
BO_TZ_PEMA-SANGTHIG-P19:390	shes rab rdo rje'i mtshhon chen gyis :	39	shes rab rdo rje mtshhon chen gyis 
BO_TZ_PEMA-SANGTHIG-P19:391	log rtog 'khor ba rdul du rlogs :	39	log rtogs khor ba rdul du rlogs 
BO_TZ_PEMA-SANGTHIG-P19:392	dug lnga'i rang bzhin sha khrag rus :	39	dug lnga rang bzhin sha khrag rus 
BO_TZ_PEMA-SANGTHIG-P19:393	dkyil 'khor lha tshhogs zhal du bstab :	39	dkyil khor lha tshhogs zhal du stob 
BO_TZ_PEMA-SANGTHIG-P19:394	a li u li ta li ta pa li g+ha na rau di kha ram yo gi kha hi ho :	39	a li u li ta li ta ba li g+ha na rau di kha ram yo gi kha hi ho 
BO_TZ_PEMA-SANGTHIG-P19:395	lnga pa dam tshhig rdo rje'i rdzas :	39	lnga ba dam tshhig rdo rje rdzas 
BO_TZ_PEMA-SANGTHIG-P19:396	brda dang brda yis 'bul len gyis :	39	brda dang brda yis bul len gyis 
BO_TZ_PEMA-SANGTHIG-P19:397	nang gi bsreg blug mchog tu rol :	39	nang gi bsreg blug mchog tu rol 
BO_TZ_PEMA-SANGTHIG-P19:398	drug pa gsang ba bde chen gyi :	39	drug ba gsang ba bde chen gyi 
BO_TZ_PEMA-SANGTHIG-P19:399	tshhogs 'khor rgyud las 'byung bzhin bya :	39	tshhogs khor brgyud las byung bzhin byed 
BO_TZ_PEMA-SANGTHIG-P19:400	de dag kun tu zab pa'i rgyud :	40	de dag kun tu zab ba brgyud 
BO_TZ_PEMA-SANGTHIG-P19:401	bklag dang khyad par ngo mtshhar ba'i :	40	klog dang khyad ba ngo mtshhar ba 
BO_TZ_PEMA-SANGTHIG-P19:402	tshhig chen brgyad dang rdo rje yi :	40	tshhig chen brgyad dang rdo rje yi 
BO_TZ_PEMA-SANGTHIG-P19:403	gad mo bcu gnyis la sogs pa :	40	gad mo chu gnyis la sogs ba 
BO_TZ_PEMA-SANGTHIG-P19:404	glur blangs nyams rtogs gong du spar :	40	glur blangs nyams rtogs gong du spor 
BO_TZ_PEMA-SANGTHIG-P19:405	bdun pa gsog 'jog spangs pa yi :	40	bdun ba gsog jog spong ba yi 
BO_TZ_PEMA-SANGTHIG-P19:406	lhag gtor zhing gi lpags par bkram :	40	lhag thor zhing gi lpags ba grem 
BO_TZ_PEMA-SANGTHIG-P19:407	rkang gling bshug pa'i brdas mtshhon te :	40	rkang gling bshug ba brda mtshhon te 
BO_TZ_PEMA-SANGTHIG-P19:408	hrim phaim: mkha' 'gro ging dang lang+ka dang : 'bar ma dbang phyug gnas nyul kun :	40	hrim phaim: mkha gro ging dang lang+ka dang bar ma dbang phyug gnas nyul kun 
BO_TZ_PEMA-SANGTHIG-P19:409	dam tshhig gsang ba'i gnas su byon :	40	dam tshhig gsang ba gnas su byon 
BO_TZ_PEMA-SANGTHIG-P19:410	sngon tshhe khrag 'thung spyan snga ru :	41	sngon tshhe khrag thung spyan snga ru 
BO_TZ_PEMA-SANGTHIG-P19:411	zhal bzhes tha tshhig ji bzhin du :	41	zhal bzhes tha tshhig ji bzhin du 
BO_TZ_PEMA-SANGTHIG-P19:412	lhag gtor bdud rtshi'i mchod pa bzhes :	41	lhag thor bdud rtshi mchod ba bzhes 
BO_TZ_PEMA-SANGTHIG-P19:413	bar chad kun sol phrin las sgrubs :	41	ba chad kun sol phrin las sgrubs 
BO_TZ_PEMA-SANGTHIG-P19:414	ma ma hrim hrim ba lim ta kha hi :	41	ma ma hrim hrim ba lim ta kha hi 
BO_TZ_PEMA-SANGTHIG-P19:415	brgyad pa tha tshhig bsgrag pa ni :	41	brgyad ba tha tshhig sgrog ba ni 
BO_TZ_PEMA-SANGTHIG-P19:416	hu~m: chos dbyings zhi ba chen po ru :	41	hu~m: chos dbyings zhi ba chen po ru 
BO_TZ_PEMA-SANGTHIG-P19:417	rang byung chos sku'i ston pa yis :	41	rang byung chos sku ston ba yis 
BO_TZ_PEMA-SANGTHIG-P19:418	rang snang 'khor la chos bstan tshhe :	41	rang snang khor la chos ston tshhe 
BO_TZ_PEMA-SANGTHIG-P19:419	dbyings las shar pa'i mkha' 'gro yis :	41	dbyings las char ba mkha gro yis 
BO_TZ_PEMA-SANGTHIG-P19:420	rtog tshhogs sgrol bar ma chad dam :	42	rtogs tshhogs sgrol ba ma chad dam 
BO_TZ_PEMA-SANGTHIG-P19:421	de 'og longs spyod yongs rdzogs par :	42	de g longs spyod yongs rdzogs ba 
BO_TZ_PEMA-SANGTHIG-P19:422	bde chen tshhe dpag med mgon gyis :	42	bde chen tshhe dpog med mgon gyis 
BO_TZ_PEMA-SANGTHIG-P19:423	'od gsal brda yi chos bstan tshhe :	42	d gsal brda yi chos ston tshhe 
BO_TZ_PEMA-SANGTHIG-P19:424	rang rtshal rol pa'i mkha' 'gro mas :	42	rang rtshal rol ba mkha gro mas 
BO_TZ_PEMA-SANGTHIG-P19:425	gnyis 'dzin sgrol bar ma chad dam :	42	gnyis dzin sgrol ba ma chad dam 
BO_TZ_PEMA-SANGTHIG-P19:426	de 'og sprul pa'i zhing khams su :	42	de g sprul ba zhing khams su 
BO_TZ_PEMA-SANGTHIG-P19:427	'chi med mtshho skyes rgyal ba yis :	42	chi med mtshho skye rgyal ba yis 
BO_TZ_PEMA-SANGTHIG-P19:428	zab don chos 'khor bskor pa'i tshhe :	42	zab don chos khor skor ba tshhe 
BO_TZ_PEMA-SANGTHIG-P19:429	dpa' bo mkha' 'gro'i tshhogs rnams kyis :	42	dpa bo mkha gro tshhogs rnams kyis 
BO_TZ_PEMA-SANGTHIG-P19:430	bdag lta'i dgra bo sgrol ba dang : ye shes gong du spor ba yi :	43	bdag lta dgra bo sgrol ba dang ye shes gong du spor ba yi 
BO_TZ_PEMA-SANGTHIG-P19:431	zhal bzhes tha tshhig rjes dgongs la :	43	zhal bzhes tha tshhig rjes dgongs la 
BO_TZ_PEMA-SANGTHIG-P19:432	rang snang rol pa'i mchod gtor bzhes :	43	rang snang rol ba mchod thor bzhes 
BO_TZ_PEMA-SANGTHIG-P19:433	bcol ba'i phrin las grub par mdzod :	43	chol ba phrin las grub ba mdzod 
BO_TZ_PEMA-SANGTHIG-P19:434	badzra sa ma ya rak+shan+tu :	43	badzra sa ma ya rak+shan+tu 
BO_TZ_PEMA-SANGTHIG-P19:435	dgu pa brtan ma'i tshhogs rnams la :	43	dgu ba brtan ma tshhogs rnams la 
BO_TZ_PEMA-SANGTHIG-P19:436	bshal chu'i bdud rtshis yang dag mchod :	43	bshal chu bdud rtshis yang dag mchod 
BO_TZ_PEMA-SANGTHIG-P19:437	hu~m: 'pho ba bcu gnyis gnas dag cing :	43	hu~m: pho ba chu gnyis gnas dag cing 
BO_TZ_PEMA-SANGTHIG-P19:438	bden don yan lag chen po'i klong :	43	bden don yan lag chen po klong 
BO_TZ_PEMA-SANGTHIG-P19:439	dpal gnas ma dang yang dag shes :	43	dpal gnas ma dang yang dag shes 
BO_TZ_PEMA-SANGTHIG-P19:440	khyung btshun kong lha g.yu bun ma :	44	khyung btshun kong lha g.yu bun ma 
BO_TZ_PEMA-SANGTHIG-P19:441	me tog zla 'od byang gi rgyal :	44	me tog zla d byang gi rgyal 
BO_TZ_PEMA-SANGTHIG-P19:442	gser thang kun bzang shan+tim sogs :	44	gser thang kun bzang shan+tim sogs 
BO_TZ_PEMA-SANGTHIG-P19:443	brtan ma bcu gnyis 'khor dang bcas :	44	brtan ma chu gnyis khor dang cha 
BO_TZ_PEMA-SANGTHIG-P19:444	bshal chu'i bdud rtshi 'di bzhes la :	44	bshal chu bdud rtshi di bzhes la 
BO_TZ_PEMA-SANGTHIG-P19:445	phyi ru 'jig rten bde ba dang : nang du rnal 'byor bar chad sol :	44	phyi ru jig rten bde ba dang nang du rnal byor ba chad sol 
BO_TZ_PEMA-SANGTHIG-P19:446	gsang ba rtsha rlung thig le bde :	44	gsang ba rtsha rlung thig le bde 
BO_TZ_PEMA-SANGTHIG-P19:447	don dam lhan skyes ye shes spor :	44	don dam lhan skye ye shes spor 
BO_TZ_PEMA-SANGTHIG-P19:448	om ma ma la la le le tam tam te te kha rag ma ma sring 'gro ma hu~m b+h+yo hu~m:	44	om ma ma la la le le tam tam te te kha rag ma ma sring gro ma hu~m b+h+yo hu~m: 
BO_TZ_PEMA-SANGTHIG-P19:449	bcu pa rdo rje'i bro brdung ba :	44	chu ba rdo rje bro rdung ba 
BO_TZ_PEMA-SANGTHIG-P19:450	rnam thar gsum gyi e klong du :	45	rnam thar gsum gyi e klong du 
BO_TZ_PEMA-SANGTHIG-P19:451	nyon mongs bdag lta'i dgra tshhogs rnams :	45	nyon mongs bdag lta dgra tshhogs rnams 
BO_TZ_PEMA-SANGTHIG-P19:452	ye shes rol pa'i rtshal gyis mnan :	45	ye shes rol ba rtshal gyis gnon 
BO_TZ_PEMA-SANGTHIG-P19:453	nam yang ldang bar ma byed cig :	45	nam yang ldang ba ma byed cig 
BO_TZ_PEMA-SANGTHIG-P19:454	om lam hu~m lam satwam b+ha ya nan :	45	om lam hu~m lam satwam b+ha ya nan 
BO_TZ_PEMA-SANGTHIG-P19:455	zhes pas thar med e ru gnan :gsum pa rjes kyi rim pa la :	45	zhes ba thar med e ru gnon :gsum ba rjes kyi rim ba la 
BO_TZ_PEMA-SANGTHIG-P19:456	mchod cing bstod pa bya ba dang : nongs pa bshags pa sngon 'gro bas :	45	mchod cing bstod ba byed ba dang nongs ba chags ba sngon gro ba 
BO_TZ_PEMA-SANGTHIG-P19:457	dngos grub sgrub pa'i rdzas rnams dang : thabs shes bde chen gsang ba nas :	45	dngos grub sgrub ba rdzas rnams dang thabs shes bde chen gsang ba nas 
BO_TZ_PEMA-SANGTHIG-P19:458	ye shes grub pa'i dbyig chen po :	45	ye shes grub ba dbyig chen po 
BO_TZ_PEMA-SANGTHIG-P19:459	'bad rtshol med pa'i ngang las blang :	45	bad rtshol med ba ngang las blang 
BO_TZ_PEMA-SANGTHIG-P19:460	rig gdangs rdo rje lu gu rgyud :	46	rig gdang rdo rje lu gu brgyud 
BO_TZ_PEMA-SANGTHIG-P19:461	sgron drug dbyings kyi zer thag las :	46	sgron drug dbyings kyi zer thag las 
BO_TZ_PEMA-SANGTHIG-P19:462	'ja' lus chos skur dengs pa'i rtshal :	46	ja lus chos skur dengs ba rtshal 
BO_TZ_PEMA-SANGTHIG-P19:463	lhun grub theg pa'i lam mchog nas :	46	lhun grub theg ba lam mchog nas 
BO_TZ_PEMA-SANGTHIG-P19:464	rnal 'byor ldan pas yang dag blang :	46	rnal byor ldan ba yang dag blang 
BO_TZ_PEMA-SANGTHIG-P19:465	ho : ma bskyed ye nas rdzogs pa'i lha :	46	ho ma skyed ye nas rdzogs ba lha 
BO_TZ_PEMA-SANGTHIG-P19:466	cho 'phrul chen po'i dkyil 'khor pa :	46	cho phrul chen po dkyil khor ba 
BO_TZ_PEMA-SANGTHIG-P19:467	mkha' la 'ja' tshhon yal ba ltar :	46	mkha la ja tshhon yal ba ltar 
BO_TZ_PEMA-SANGTHIG-P19:468	'od gsal chos sku'i klong du thim :	46	d gsal chos sku klong du thim 
BO_TZ_PEMA-SANGTHIG-P19:469	a a a :	46	a a a 
BO_TZ_PEMA-SANGTHIG-P19:470	slar yang rang dang snang ba kun :	47	slar yang rang dang snang ba kun 
BO_TZ_PEMA-SANGTHIG-P19:471	chu las chu bur rdol pa ltar :	47	chu las chu bur rdol ba ltar 
BO_TZ_PEMA-SANGTHIG-P19:472	ye shes chen po'i phyag rgyar shar :	47	ye shes chen po phyag rgyar char 
BO_TZ_PEMA-SANGTHIG-P19:473	rdo rje gsum gyi ngo bor gyur :	47	rdo rje gsum gyi ngo bor gyur 
BO_TZ_PEMA-SANGTHIG-P19:474	om ahhu~m: dge ba 'di dang dge ba gzhan :	47	om ahhu~m: dge ba di dang dge ba gzhan 
BO_TZ_PEMA-SANGTHIG-P19:475	thams cad gcig tu bsdoms byas nas :	47	thams cad gcig tu sdom byed nas 
BO_TZ_PEMA-SANGTHIG-P19:476	zag med chos sku'i dbyings su bsngo :	47	zag med chos sku dbyings su sngo 
BO_TZ_PEMA-SANGTHIG-P19:477	'du 'bral med par sangs rgyas shog :	47	du bral med ba sangs rgya shog 
BO_TZ_PEMA-SANGTHIG-P19:478	om ahhu~m: ngo bo stong zhing rang bzhin gsal :	47	om ahhu~m: ngo bo stong zhing rang bzhin gsal 
BO_TZ_PEMA-SANGTHIG-P19:479	thugs rje sna tshhogs snang ba'i rtshal :	47	thugs rje sna tshhogs snang ba rtshal 
BO_TZ_PEMA-SANGTHIG-P19:480	'gags pa med par rol pa'i sprin :	48	gag ba med ba rol ba sprin 
BO_TZ_PEMA-SANGTHIG-P19:481	bde ba chen po'i bkra shis shog :	48	bde ba chen po bkra shis shog 
BO_TZ_PEMA-SANGTHIG-P19:482	gzhi grol rig pa ka nas dag :	48	gzhi grol rig ba ka nas dag 
BO_TZ_PEMA-SANGTHIG-P19:483	gzhi snang ye shes phyag rgya che :	48	gzhi snang ye shes phyag rgya che 
BO_TZ_PEMA-SANGTHIG-P19:484	lhun grub thig le chen po'i sbubs :	48	lhun grub thig le chen po sbub 
BO_TZ_PEMA-SANGTHIG-P19:485	chos zad blo 'das bkra shis shog :sa ma ya :	48	chos zad blo da bkra shis shog :sa ma ya 
BO_TZ_PEMA-SANGTHIG-P19:486	gter rgya : sbas rgya :	48	gter rgya sbed rgya 
BO_TZ_PEMA-SANGTHIG-P19:487	zab rgya : gnyan rgya :	48	zab rgya gnyan rgya 
BO_TZ_PEMA-SANGTHIG-P19:488	brda thim : kho bo rdo rje'i ming can la khams kyi gla ba rkang gcig ye rgyal nam mkha' mdzod nas dngos grub tu thob pa las /	48	brda thim kho bo rdo rje ming can la khams kyi gla ba rkang gcig ye rgyal nam mkha mdzod nas dngos grub tu thob ba las 
BO_TZ_PEMA-SANGTHIG-P19:489	las byang rnams khrigs su bsdebs te bkod pa 'di la 'brel tshhad rnams gdod ma'i dbyings su grol bar shog	48	las byang rnams khrigs su sdeb te bkod ba di la brel tshhad rnams gdod ma dbyings su grol ba shog 
BO_TZ_PEMA-SANGTHIG-P19:490	/sa ma ya :	49	ma ya 
BO_TZ_PEMA-SANGTHIG-P19:491	rgya rgya rgya :	49	rgya rgya rgya 
