segmentnr	original	folio	stemmed
BO_TZ_LAMRIM-YISHE-NYINGPO-P2:6000	zhes gsungs te /	600	zhes gsungs te 
BO_TZ_LAMRIM-YISHE-NYINGPO-P2:6001	phyi nang gsang ba thun mong du nyams grib kyi rkyen las byung ba'i gegs kyis bla mar mos gus dang sems can la snying rje dang / zab mo rtogs pa'i shes rab dang / sogs khong nas rim gnyis kyi ting 'dzin gyis mtshhon rgyud la bskyed par bya ba gang yang rung /	600	phyi nang gsang ba thun mong du nyams grib kyi rkyen las byung ba gegs kyis bla mar mos gus dang sems can la snying rje dang zab mo rtogs ba shes rab dang sogs khong nas rim gnyis kyi ting dzin gyis mtshhon brgyud la skyed ba byed ba gang yang rung 
BO_TZ_LAMRIM-YISHE-NYINGPO-P2:6002	brtshon 'grus chen pos ji ltar bsgoms kyang yar bskyed thon pa'i bogs med cing le lo snyom las kyi dbang du shor ba dang / mos gus kyi 'gal zla nga rgyal /	600	brtshon grus chen pos ji ltar sgom kyang yar skyed thon ba bogs med cing le lo snyom las kyi dbang du chor ba dang mos gus kyi gal zla nga rgyal 
BO_TZ_LAMRIM-YISHE-NYINGPO-P2:6003	snying rje'i 'gal zla phrag dog	600	snying rje gal zla phrag dog 
BO_TZ_LAMRIM-YISHE-NYINGPO-P2:6004	/shes rab 'gal zla gti mug mun pa shugs kyis gtibs te bsgom bya'i snang ba bsgri+ib par byed pa na /	600	rab gal zla gti mug mun ba shugs kyis gtibs te bsgom byed snang ba bsgri+ib ba byed ba na 
BO_TZ_LAMRIM-YISHE-NYINGPO-P2:6005	sel ba'i thabs ni spyir gnas mal zas gos dam nyams rme yug shan pa sogs grib can dang 'grogs shing bsten pa las byung bas de dag spang zhing khrus dang grib sel sogs kyis zhi bar bya dgos kyang /	600	sel ba thabs ni spyir gnas mal zas gos dam nyams rme yug shan ba sogs grib can dang grogs shing sten ba las byung ba de dag spong zhing khru dang grib sel sogs kyis zhi ba byed dgos kyang 
BO_TZ_LAMRIM-YISHE-NYINGPO-P2:6006	phal cher sgrub po rang nyid rtog pa rtshing pa'i skyon gyis dam tshhig nyams chag tu gyur pa las byung ba'i phyir de bshags pa'i thabs la 'bad do //	600	phal cher sgrub po rang nyid rtogs ba rtshing ba skyon gyis dam tshhig nyams chag tu gyur ba las byung ba phyir de chags ba thabs la bad do 
BO_TZ_LAMRIM-YISHE-NYINGPO-P2:6007	gnyis pa la gnyis /	600	gnyis ba la gnyis 
BO_TZ_LAMRIM-YISHE-NYINGPO-P2:6008	spyi dang khyad par gyi bshags thabs so //	600	spyi dang khyad ba gyi chags thabs so 
BO_TZ_LAMRIM-YISHE-NYINGPO-P2:6009	dang po ni /	600	dang po ni 
BO_TZ_LAMRIM-YISHE-NYINGPO-P2:6010	nyams pa nas rnal du dbab :	601	nyams ba nas rnal du bebs 
BO_TZ_LAMRIM-YISHE-NYINGPO-P2:6011	ces gsungs te /	601	ces gsungs te 
BO_TZ_LAMRIM-YISHE-NYINGPO-P2:6012	de'ang gsang sngags kyi dam tshhig nyams pas tshhe 'dir mi 'dod pa du ma bskyed /	601	de gsang sngags kyi dam tshhig nyams ba tshhe dir mi dod ba du ma skyed 
BO_TZ_LAMRIM-YISHE-NYINGPO-P2:6013	lam la bar du bcad de rdo rje'i dmyal bar zang thal du 'gro bar gsungs pas khe nyen shin tu che ba'i phyir nyams pa'i nyes pa phra mo tsham byung yang de ma thag tu bshags yul bla ma dngos sam rtsha gsum rgyal ba rab 'byams yid la	601	lam la ba du gcod de rdo rje dmyal ba zang thal du gro ba gsungs ba khe nyen shin tu che ba phyir nyams ba nyes ba phra mo tsham byung yang de ma thag tu chags yul bla ma dngos sam rtsha gsum rgyal ba rab byam yid la 
BO_TZ_LAMRIM-YISHE-NYINGPO-P2:6014	byas te gsang por smra bas mthol zhing 'gyod pa drag pos bshags te slan chad de lta bu mi bgyid pa snying thag pa nas bsdam /	601	byed te gsang por smra ba mthol zhing gyod ba drag pos chags te slan chad de lta bu mi bgyid ba snying thag ba nas sdom 
BO_TZ_LAMRIM-YISHE-NYINGPO-P2:6015	de'ang nyes pa gsang na sdig pa'i sa bon dang g.yo sgyu'i chu lud 'dzom pas je 'phel du 'gro zhing ma sbas par bsgrags na mi 'phel zhing stobs bri ba dang / snying nas gnong 'gyod kyis bshags na las la rang bzhin ma grub pas 'dags par mi 'gyur ba med la /	601	de nyes ba gsang na sdig ba sa bon dang g.yo sgyu chu lud dzom ba je phel du gro zhing ma sbed ba sgrog na mi phel zhing stobs bri ba dang snying nas gnong gyod kyis chags na las la rang bzhin ma grub ba dags ba mi gyur ba med la 
BO_TZ_LAMRIM-YISHE-NYINGPO-P2:6016	bshags pa'i tshhul stobs bzhi dang ldan pas bshags tshhig rgyud lung rnams nas 'byung ba gang rung brjod la 'phral 'phral bshags bsdoms bya /	601	chags ba tshhul stobs bzhi dang ldan ba chags tshhig brgyud lung rnams nas byung ba gang rung rjod la phral phral chags sdom byed 
BO_TZ_LAMRIM-YISHE-NYINGPO-P2:6017	sngags kyi dam tshhig gnyan drags pas gzhan gyi nyams grib rang la 'go ba'i gnas yod pa'i phyir dam tshhig nyams pa'i mi dang lu+ung pa gcig gi chu la btung mi rung bar gsungs pas dam nyams dang gnas gcig tu sdod pa sogs bshes 'dris su mi 'grogs	601	sngags kyi dam tshhig gnyan drag ba gzhan gyi nyams grib rang la go ba gnas yod ba phyir dam tshhig nyams ba mi dang lu+ung ba gcig gi chu la thung mi rung ba gsungs ba dam nyams dang gnas gcig tu sdod ba sogs bshes dris su mi grogs 
BO_TZ_LAMRIM-YISHE-NYINGPO-P2:6018	shing nyams pa'i rgyu las byung ba dang lag gis ster ba'i zas kham gang yang mi za /	601	shing nyams ba rgyu las byung ba dang lag gis ster ba zas kham gang yang mi za 
BO_TZ_LAMRIM-YISHE-NYINGPO-P2:6019	dam nyams dngos su yod pa'i gnas su lta ci smos sdod pa'i rjes shul du 'ang mi sdod cing mdor na sgo gsum bag yod pa dang dran shes kyi bya ra btang la rnal du dbab par bya'o //	601	dam nyams dngos su yod ba gnas su lta ci smos sdod ba rjes shul du mang mi sdod cing mdor na sgo gsum bag yod ba dang dran shes kyi byed ra gtong la rnal du bebs ba byed 
BO_TZ_LAMRIM-YISHE-NYINGPO-P2:6020	gnyis pa la gsum /	602	gnyis ba la gsum 
BO_TZ_LAMRIM-YISHE-NYINGPO-P2:6021	ru bzhi'i bshags pa /	602	ru bzhi chags ba 
BO_TZ_LAMRIM-YISHE-NYINGPO-P2:6022	zung bzhi'i skong ba /	602	zung bzhi skong ba 
BO_TZ_LAMRIM-YISHE-NYINGPO-P2:6023	bshags pa'i 'bras bu'o //	602	chags ba bras bu 
BO_TZ_LAMRIM-YISHE-NYINGPO-P2:6024	dang po ni /	602	dang po ni 
BO_TZ_LAMRIM-YISHE-NYINGPO-P2:6025	lhag par nas nyes pa mthol :	602	lhag ba nas nyes ba mthol 
BO_TZ_LAMRIM-YISHE-NYINGPO-P2:6026	zhes gsungs te /	602	zhes gsungs te 
BO_TZ_LAMRIM-YISHE-NYINGPO-P2:6027	spyi mdo dgongs pa 'dus pa las las dang rdzas dang 'dun pa ting nge 'dzin de kho na nyid kyi skong ba lngar gsungs pas mtshhon snga 'gyur gyi rgyud lung man ngag rnams las lhag par bsngags pa'i nyams chag bshags shing skong ba'i cho ga zab cing rgya	602	spyi mdo dgongs ba du ba las las dang rdzas dang dun ba ting nge dzin de kho na nyid kyi skong ba lngar gsungs ba mtshhon snga gyur gyi brgyud lung man ngag rnams las lhag ba bsngags ba nyams chag chags shing skong ba cho ga zab cing rgya 
BO_TZ_LAMRIM-YISHE-NYINGPO-P2:6028	che bar gsungs pa rnams kyi yang bcud nying khur dril ba ni /	602	che ba gsungs ba rnams kyi yang bcud nying khur dril ba ni 
BO_TZ_LAMRIM-YISHE-NYINGPO-P2:6029	bla ma yi dam mkha' 'gro rtsha ba gsum gcig tu 'dus pa'am so so ba gang rung dag gi sgrub pa'i dkyil 'khor gzhung ltar bsham zhing phyi nang gi mchod pa brgya rtsha dang tshhogs kyi yo byad gang 'byor gtshang dang mdzes par bkram la /	602	bla ma yi dam mkha gro rtsha ba gsum gcig tu du ba so so ba gang rung dag gi sgrub ba dkyil khor gzhung ltar bsham zhing phyi nang gi mchod ba brgya rtsha dang tshhogs kyi yo byad gang byor gtshang dang mdzes ba grem la 
BO_TZ_LAMRIM-YISHE-NYINGPO-P2:6030	bdag mdun gyi ting 'dzin gsal zhing brtan pa dang 'bro 'du'i dmigs pa'i gzer bcas dzapa \u0f84kyi bzlas pas sngon gyi thugs bskyed kyi dam bca' gnyan po bskul /	603	bdag mdun gyi ting dzin gsal zhing brtan ba dang bros du dmigs ba gzer cha dzapa \u0f84kyi bzlas ba sngon gyi thugs skyed kyi dam chos gnyan po skul 
BO_TZ_LAMRIM-YISHE-NYINGPO-P2:6031	tshhogs gsog pa'i rten dkyil 'khor ba dang slar yang mgron thabs kyi lha nam mkha'i khyon gang ba spyan drangs la /	603	tshhogs gsog ba rten dkyil khor ba dang slar yang mgron thabs kyi lha nam mkha khyon gang ba spyan drangs la 
BO_TZ_LAMRIM-YISHE-NYINGPO-P2:6032	lus kyi sgo nas gus pa chen pos lus sa la rdeb pa'i brkyang phyag dang gnas lnga sa la 'dud pa'i 'greng phyag 'tshhal zhing brjod med don gyi bshags pa dang rgyal ba zhi khro rab 'byams kyi mtshhan brjod /	603	lus kyi sgo nas gus ba chen pos lus sa la rdeb ba rkyong phyag dang gnas lnga sa la dud ba greng phyag tshhal zhing rjod med don gyi chags ba dang rgyal ba zhi khro rab byam kyi mtshhan rjod 
BO_TZ_LAMRIM-YISHE-NYINGPO-P2:6033	ngag gi sgo nas nyams chag sbyong ba'i lha gcig sngags gcig tu gyur pa bcom ldan 'das rdo rje sems dpa'i bsgom bzlas phyi nang gsang ba yang gsang gi rim pa rnams bya ba dang ru dra'i smre bshags kyis mtshhon smre sngags kyi sgo nas bshags pa'i tshhig	603	ngag gi sgo nas nyams chag sbyong ba lha gcig sngags gcig tu gyur ba joms ldan da rdo rje sems dpa bsgom bzlas phyi nang gsang ba yang gsang gi rim ba rnams byed ba dang ru dra smre chags kyis mtshhon smre sngags kyi sgo nas chags ba tshhig 
BO_TZ_LAMRIM-YISHE-NYINGPO-P2:6034	skad gsang mthon por brjod /	603	skad gsang mthon por rjod 
BO_TZ_LAMRIM-YISHE-NYINGPO-P2:6035	yid kyi sgo nas lta ba'i klong bshags kyis gsal gdab cing 'khor gsum yongs dag 'das nyams phyogs lhung med pa'i ka dag khyab brdal chen po'i ngang du mnyam par bzhag	603	yid kyi sgo nas lta ba klong chags kyis gsal gdab cing khor gsum yongs dag da nyams phyogs lhung med ba ka dag khyab rdal chen po ngang du mnyam ba jog 
BO_TZ_LAMRIM-YISHE-NYINGPO-P2:6036	/thun mong du bde gshegs spyi bshags brjod cing sgo gsum gyi nyes pa ci mchis pa thams cad gnong 'gyod drag pos mi 'chab par mthol zhing bshags par bya'o //	603	mong du bde gshegs spyi chags rjod cing sgo gsum gyi nyes ba ci mchis ba thams cad gnong gyod drag pos mi chab ba mthol zhing chags ba byed 
BO_TZ_LAMRIM-YISHE-NYINGPO-P2:6037	de ltar lus ngag yid gsum dang sgo gsum thun mong gi nyes bshags gnyen po so so dang 'brel bar klong chen rab 'bogs kyi bkol rgyud dri med bshags pa'i rgyal po sogs las ched du bsngags pa'i bshags chen ru bzhi bya ba ni dmigs su bsal ba'i	603	de ltar lus ngag yid gsum dang sgo gsum thun mong gi nyes chags gnyen po so so dang brel ba klong chen rab bogs kyi khol brgyud dri med chags ba rgyal po sogs las ched du bsngags ba chags chen ru bzhi byed ba ni dmigs su bsal ba 
BO_TZ_LAMRIM-YISHE-NYINGPO-P2:6038	dgongs don no //	603	dgongs don no 
BO_TZ_LAMRIM-YISHE-NYINGPO-P2:6039	gnyis pa ni /	603	gnyis ba ni 
BO_TZ_LAMRIM-YISHE-NYINGPO-P2:6040	nyer spyod nas dgyes pa bskang :	604	nyer spyod nas dgyes ba skong 
BO_TZ_LAMRIM-YISHE-NYINGPO-P2:6041	zhes gsungs te /	604	zhes gsungs te 
BO_TZ_LAMRIM-YISHE-NYINGPO-P2:6042	rang rgyud kyi nyams chag bshags pas sbyangs nas gzhan rgyud ltar snang ba'i rtsha gsum lha tshhogs rnams nyams pa'i skyon gyis thugs mi mnyes pa'i tshhul du bstan cing bka'i chad pa'i gnas su gyur pa skong ba'i las kyis sor chud par byed pa la /	604	rang brgyud kyi nyams chag chags ba sbyong nas gzhan brgyud ltar snang ba rtsha gsum lha tshhogs rnams nyams ba skyon gyis thugs mi mnyes ba tshhul du ston cing bka chad ba gnas su gyur ba skong ba las kyis sor chud ba byed ba la 
BO_TZ_LAMRIM-YISHE-NYINGPO-P2:6043	spyir rgyud lung rnams nas phyi yo byad tshhogs /	604	spyir brgyud lung rnams nas phyi yo byad tshhogs 
BO_TZ_LAMRIM-YISHE-NYINGPO-P2:6044	nang phung po rten /	604	nang phung po rten 
BO_TZ_LAMRIM-YISHE-NYINGPO-P2:6045	gsang ba byang chub sems kyis skong ba'i tshhul dang / khyad par dong sprugs las lta bas la zla ba'i tshhul du rtogs tshhig gis ngo bos skong ba dang / sgom pa ting nge 'dzin gyis gnas lugs las mi g.yo ba'i tshhul du zung bzhis rang bzhin skong ba dang /	604	gsang ba byang chub sems kyis skong ba tshhul dang khyad ba dong sprug las lta ba la zla ba tshhul du rtogs tshhig gis ngo bod skong ba dang sgom ba ting nge dzin gyis gnas lugs las mi g.yo ba tshhul du zung bzhis rang bzhin skong ba dang 
BO_TZ_LAMRIM-YISHE-NYINGPO-P2:6046	lha rtog dbyer med kyi gnas dag gnas bsgyur du shes pas thugs rje'i tshhul la skong bar byed pa gsum /	604	lha rtogs dbyer med kyi gnas dag gnas sgyur du shes ba thugs rje tshhul la skong ba byed ba gsum 
BO_TZ_LAMRIM-YISHE-NYINGPO-P2:6047	bde 'dus sogs las /	604	bde du sogs las 
BO_TZ_LAMRIM-YISHE-NYINGPO-P2:6048	mchod pa phud /	604	mchod ba bud 
BO_TZ_LAMRIM-YISHE-NYINGPO-P2:6049	dam rdzas mdangs /	604	dam rdzas mdangs 
BO_TZ_LAMRIM-YISHE-NYINGPO-P2:6050	srog chags rgyu /	605	srog chags rgyu 
BO_TZ_LAMRIM-YISHE-NYINGPO-P2:6051	gling bzhi mdos /	605	gling bzhi mdos 
BO_TZ_LAMRIM-YISHE-NYINGPO-P2:6052	'gyod tshhangs bshags pa'i skong ba ste skong ba lngar grags pa sogs mang yang thams cad kyi gnad bsdus pa'i snying po /	605	gyod tshhangs chags ba skong ba ste skong ba lngar grags ba sogs mang yang thams cad kyi gnad sdud ba snying po 
BO_TZ_LAMRIM-YISHE-NYINGPO-P2:6053	phyi ltar ye shes kyi dbang po tshhims pa'i slad du me tog sogs nye bar spyod pa lnga po dngos bshams kyi rten byas nas yid sprul nam mkha'i khyon khengs pa dang bkod pa'i khyad par rang bzhin gyis grub pa rnams kyis mchod cing skong ba dang /	605	phyi ltar ye shes kyi dbang po tshhims ba slad du me tog sogs nye ba spyod ba lnga po dngos bshams kyi rten byed nas yid sprul nam mkha khyon kheng ba dang bkod ba khyad ba rang bzhin gyis grub ba rnams kyis mchod cing skong ba dang 
BO_TZ_LAMRIM-YISHE-NYINGPO-P2:6054	nang ltar yid dang ngag dang lus dang de kho na nyid kyi rtog sgrib sbyang ba'i slad du rim pa bzhin zung bzhi'i skong bar grags pa /	605	nang ltar yid dang ngag dang lus dang de kho na nyid kyi rtogs sgrib sbyong ba slad du rim ba bzhin zung bzhi skong ba grags ba 
BO_TZ_LAMRIM-YISHE-NYINGPO-P2:6055	bdud rtshi sman /	605	bdud rtshi sman 
BO_TZ_LAMRIM-YISHE-NYINGPO-P2:6056	dmar chen rak+ta /	605	dmar chen rak+ta 
BO_TZ_LAMRIM-YISHE-NYINGPO-P2:6057	ba lim gtor ma /	605	ba lim thor ma 
BO_TZ_LAMRIM-YISHE-NYINGPO-P2:6058	snang gsal sgron me bzhi po'ang dam tshhig gi rdzas kyis mtshhon byed du byas te gnas lugs kyi rang bzhin gsal gdab cing skong ba dang / gsang ba dam skong rmad du byung zhing dngos grub mchog gi nye rgyu ta na sbyor ba dang / ga na sgrol ba zung du 'brel pa'i brtul zhugs zab mo tshhogs kyi 'khor lo dngos sam /	605	snang gsal sgron me bzhi po dam tshhig gi rdzas kyis mtshhon byed du byed te gnas lugs kyi rang bzhin gsal gdab cing skong ba dang gsang ba dam skong rmad du byung zhing dngos grub mchog gi nye rgyu ta na sbyor ba dang ga na sgrol ba zung du brel ba brtul jug zab mo tshhogs kyi khor lo dngos sam 
BO_TZ_LAMRIM-YISHE-NYINGPO-P2:6059	rjes mthun tshhogs kyi mchod pa tsham la'ang phan yon chen po dang ldan pas de dag rnams kyis thugs dgyes pa chen po'i dam tshhig yongs su bskang bar bya'o //	605	rjes mthun tshhogs kyi mchod ba tsham la phan yon chen po dang ldan ba de dag rnams kyis thugs dgyes ba chen po dam tshhig yongs su skong ba byed 
BO_TZ_LAMRIM-YISHE-NYINGPO-P2:6060	gsum pa ni /	606	gsum ba ni 
BO_TZ_LAMRIM-YISHE-NYINGPO-P2:6061	sgo gsum nas mngon du 'gyurah	606	sgo gsum nas mngon du gyurah 
BO_TZ_LAMRIM-YISHE-NYINGPO-P2:6062	zhes gsungs te /	606	zhes gsungs te 
BO_TZ_LAMRIM-YISHE-NYINGPO-P2:6063	bshags skong de dag tshhul bzhin du byas pa'i yon tan ni /	606	chags skong de dag tshhul bzhin du byed ba yon tan ni 
BO_TZ_LAMRIM-YISHE-NYINGPO-P2:6064	gnas skabs su sgo gsum gyi rtog sgrib dang de dag gi bya ba dang byed pa'i las las gyur pa'i nyams chag ci mchis pa kun zhi zhing /	606	gnas skabs su sgo gsum gyi rtogs sgrib dang de dag gi byed ba dang byed ba las las gyur ba nyams chag ci mchis ba kun zhi zhing 
BO_TZ_LAMRIM-YISHE-NYINGPO-P2:6065	mthar thug sku gsung thugs ye shes rdo rje bzhi yi go 'phang mngon du byed par 'gyur te gsang ba zab mo'i thabs mthar thug pa yin pa'i phyir ro //	606	mthar thug sku gsung thugs ye shes rdo rje bzhi yi go phen mngon du byed ba gyur te gsang ba zab mo thabs mthar thug ba yin ba phyir ro 
BO_TZ_LAMRIM-YISHE-NYINGPO-P2:6066	de ltar yang dri med bshags rgyud las /	606	de ltar yang dri med chags brgyud las 
BO_TZ_LAMRIM-YISHE-NYINGPO-P2:6067	dkyil 'khor gyi lha de rnams kyi mtshhan rnal 'byor pho mo rnams kyis thos pa tsham gyis /	606	dkyil khor gyi lha de rnams kyi mtshhan rnal byor pho mo rnams kyis thos ba tsham gyis 
BO_TZ_LAMRIM-YISHE-NYINGPO-P2:6068	rtsha ba dang yan lag gi dam tshhig nyams chags thams cad bskangs nas de bzhin gshegs pa thams cad kyi sku gsung thugs yon tan phrin las bsam gyis mi khyab pa dang ldan par 'gyur te /	606	rtsha ba dang yan lag gi dam tshhig nyams chags thams cad skong nas de bzhin gshegs ba thams cad kyi sku gsung thugs yon tan phrin las bsam gyis mi khyab ba dang ldan ba gyur te 
BO_TZ_LAMRIM-YISHE-NYINGPO-P2:6069	yi ge 'khor lo tshhogs chen gyi sa la lhun gyis grub par 'gyur ro //	606	yi ge khor lo tshhogs chen gyi sa la lhun gyis grub ba gyur ro 
BO_TZ_LAMRIM-YISHE-NYINGPO-P2:6070	zhes pas mtshhon no //	607	zhes ba mtshhon no 
BO_TZ_LAMRIM-YISHE-NYINGPO-P2:6071	gsum pa don bsdu ba ni /	607	gsum ba don sdud ba ni 
BO_TZ_LAMRIM-YISHE-NYINGPO-P2:6072	gzhan yang nas ngang gis 'char :	607	gzhan yang nas ngang gis char 
BO_TZ_LAMRIM-YISHE-NYINGPO-P2:6073	zhes gsungs te /	607	zhes gsungs te 
BO_TZ_LAMRIM-YISHE-NYINGPO-P2:6074	lam gyi gegs sel ba'i thabs gzhan yang rtsha ba'i bla ma la sangs rgyas dngos su mthong ba'i yid ches dang bka' drin rjes su dran pa'i gdung shugs kyis drangs te bzod med mchi ma 'khrugs pa'i mos gus kho na nyams len gyi srog tu bzung ste rtshal	607	lam gyi gegs sel ba thabs gzhan yang rtsha ba bla ma la sangs rgya dngos su mthong ba yid ches dang bka drin rjes su dran ba gdung shugs kyis drangs te bzod med mchi ma khrugs ba mos gus kho na nyams len gyi srog tu bzung ste rtshal 
BO_TZ_LAMRIM-YISHE-NYINGPO-P2:6075	du 'don / mkha' khyab kyi sems can rnams la phyogs ris dang bral ba'i byams pa dang snying rje tshhad med pa bsgom zhing thams cad sangs rgyas kyi sar 'god par 'dod pa'i byang chub kyi sems rtag tu bskyed /	607	du don mkha khyab kyi sems can rnams la phyogs ris dang bral ba byams ba dang snying rje tshhad med ba bsgom zhing thams cad sangs rgya kyi sar god ba dod ba byang chub kyi sems rtag tu skyed 
BO_TZ_LAMRIM-YISHE-NYINGPO-P2:6076	thos bsam bsgom pa las byung ba'i dri ma med pa'i shes rab zab mos tha snyad sgra tshhig tsham la mi zhen par yang dag pa'i don gyi gnad gsang tshhul bzhin du btshal /	607	thos bsam bsgom ba las byung ba dri ma med ba shes rab zab mos tha snyad sgra tshhig tsham la mi zhen ba yang dag ba don gyi gnad gsang tshhul bzhin du btshal 
BO_TZ_LAMRIM-YISHE-NYINGPO-P2:6077	theg pa yas 'bubs kyi lta bas 'khor 'das la zla zhing bstan rim mas 'dzegs kyi spyod pas blang dor shan dbye bas kun rdzob dang don dam pa gnyis kyi phyogs re rer ltung ba'i gegs chen rang bzhin gyis grol nas /	607	theg ba yas bubs kyi lta ba khor da la zla zhing ston rim mas dzegs kyi spyod ba blang dor shan byed ba kun rdzob dang don dam ba gnyis kyi phyogs re rer ltung ba gegs chen rang bzhin gyis grol nas 
BO_TZ_LAMRIM-YISHE-NYINGPO-P2:6078	lam nyams su blangs pa'i drod rtags yon tan rnams 'bad rtshol med par ngang gis 'char ba ni dpyid dus rlan drod kyi rten 'brel 'tshhogs pa na rtshi shing me tog rang bzhin gyis rgyas pa bzhin no //	607	lam nyams su blangs ba drod rtags yon tan rnams bad rtshol med ba ngang gis char ba ni dpyid dus rlan drod kyi rten brel tshhogs ba na rtshi shing me tog rang bzhin gyis rgya ba bzhin no 
BO_TZ_LAMRIM-YISHE-NYINGPO-P2:6079	rtsha ba'i sa bcad lnga po bogs 'don la gsum /	607	rtsha ba sa gcod lnga po bogs don la gsum 
BO_TZ_LAMRIM-YISHE-NYINGPO-P2:6080	mdor bstan / rgyas bshad /	608	mdor ston rgya chad 
BO_TZ_LAMRIM-YISHE-NYINGPO-P2:6081	don bsdu'o // dang po ni /	608	don sdud dang po ni 
BO_TZ_LAMRIM-YISHE-NYINGPO-P2:6082	de nas sogs tshhig rkang gcig ste /	608	de nas sogs tshhig rkang gcig ste 
BO_TZ_LAMRIM-YISHE-NYINGPO-P2:6083	dper na zhing gi lo tog la 'tshhe ba srung ba'i bya ba grub nas skyong bran dang rig sngags kyi cho ga sogs yar skyed 'byung ba'i thabs la brtshon pa ltar lam gyi gegs bsal ba grub pa de nas yon tan la skyed 'phel gyi bogs 'don dgos	608	dper na zhing gi lo tog la tshhe ba srung ba byed ba grub nas skyong bran dang rig sngags kyi cho ga sogs yar skyed byung ba thabs la brtshon ba ltar lam gyi gegs bsal ba grub ba de nas yon tan la skyed phel gyi bogs don dgos 
BO_TZ_LAMRIM-YISHE-NYINGPO-P2:6084	shing de la'ang phyi nang gsang ba gsum gyi rim par bstan pa ni 'di ltar ro //	608	shing de la phyi nang gsang ba gsum gyi rim ba ston ba ni di ltar ro 
BO_TZ_LAMRIM-YISHE-NYINGPO-P2:6085	gnyis pa la gsum /	608	gnyis ba la gsum 
BO_TZ_LAMRIM-YISHE-NYINGPO-P2:6086	phyi'i / nang gi	608	phyi nang gi 
BO_TZ_LAMRIM-YISHE-NYINGPO-P2:6087	/gsang ba'i bogs 'byin no //	608	ba bogs byin no 
BO_TZ_LAMRIM-YISHE-NYINGPO-P2:6088	dang po la yang gnyis /	608	dang po la yang gnyis 
BO_TZ_LAMRIM-YISHE-NYINGPO-P2:6089	mdor bstan rgyas bshad do //	608	mdor ston rgya chad do 
BO_TZ_LAMRIM-YISHE-NYINGPO-P2:6090	dang po ni /	609	dang po ni 
BO_TZ_LAMRIM-YISHE-NYINGPO-P2:6091	phyi rol nas grogs su 'gyur :	609	phyi rol nas grogs su gyur 
BO_TZ_LAMRIM-YISHE-NYINGPO-P2:6092	zhes gsungs te /	609	zhes gsungs te 
BO_TZ_LAMRIM-YISHE-NYINGPO-P2:6093	phyi rol tu chags sdang gti mug skyed pa'i yul bzang ngan bar ma ci dang ci lta bu zhig shar yang blang dor btang snyoms kyi rtog pa'i gzhan dbang du ma shor bar rab skad cig dang / 'bring gnyis pa /	609	phyi rol tu chags sdang gti mug skyed ba yul bzang ngan ba ma ci dang ci lta bu jig char yang blang dor gtong snyom kyi rtogs ba gzhan dbang du ma chor ba rab skad cig dang bring gnyis ba 
BO_TZ_LAMRIM-YISHE-NYINGPO-P2:6094	tha mas kyang gsum phan chad las mi 'da' bar lam du khyer ba'i tshhul shes pas gnad du btang na tshhogs drug gi yul du snang ba thams cad kyang byang chub sgrub pa'i grogs su 'gyur ro //	609	tha mas kyang gsum phan chad las mi da ba lam du khyer ba tshhul shes ba gnad du gtong na tshhogs drug gi yul du snang ba thams cad kyang byang chub sgrub ba grogs su gyur ro 
BO_TZ_LAMRIM-YISHE-NYINGPO-P2:6095	gnyis pa la gnyis /	609	gnyis ba la gnyis 
BO_TZ_LAMRIM-YISHE-NYINGPO-P2:6096	spyi dang bye brag go	609	spyi dang bye brag go 
BO_TZ_LAMRIM-YISHE-NYINGPO-P2:6097	/dang po ni /	609	po ni 
BO_TZ_LAMRIM-YISHE-NYINGPO-P2:6098	dgra la nas las 'brel bzhag :	609	dgra la nas las brel jog 
BO_TZ_LAMRIM-YISHE-NYINGPO-P2:6099	ces gsungs te /	609	ces gsungs te 
BO_TZ_LAMRIM-YISHE-NYINGPO-P2:6100	yul rkyen de dag lam du ji ltar khyer na 'dun pas blo sbyong ba dang kun rdzob rten 'brel don dam stong nyid kyi tshhul la brten nas te /	610	yul rkyen de dag lam du ji ltar khyer na dun ba blo sbyong ba dang kun rdzob rten brel don dam stong nyid kyi tshhul la rten nas te 
BO_TZ_LAMRIM-YISHE-NYINGPO-P2:6101	spyir sngon las sha 'khon gyis 'tshhe ba dang / drin lan log 'jal 'khor gyi log sgrub sogs mi dang mi min gyi gnod pa'i dgra che phra gang la'ang 'khon 'dzin mi bya bar bzod pa bsgom zhing de dag tshhe rabs du ma'i pha ma yin kyang 'khrul pa'i dbang gis da lta ngo ma shes pas las	610	spyir sngon las sha khon gyis tshhe ba dang drin lan log jal khor gyi log sgrub sogs mi dang mi min gyi gnod ba dgra che phra gang la khon dzin mi byed ba bzod ba bsgom zhing de dag tshhe rabs du ma pha ma yin kyang khrul ba dbang gis da lta ngo ma shes ba las 
BO_TZ_LAMRIM-YISHE-NYINGPO-P2:6102	ngan bsags pa la slar yang snying rje chen po bskyed /	610	ngan bsags ba la slar yang snying rje chen po skyed 
BO_TZ_LAMRIM-YISHE-NYINGPO-P2:6103	gnyen nye 'brel dang mdza' grogs nor rdzas sogs yid du 'ong ba thams cad la sgyu ma rmi lam lta bur blta ba bden med kyi 'dun pa drag tu bsgom zhing zhen 'khris kyi 'dzin pa bcad /	610	gnyen nye brel dang mdza grogs nor rdzas sogs yid du ng ba thams cad la sgyu ma rmi lam lta bur lta ba bden med kyi dun ba drag tu bsgom zhing zhen khris kyi dzin ba gcod 
BO_TZ_LAMRIM-YISHE-NYINGPO-P2:6104	chags sdang gnyis ka mi skye ba'i yul snang bar ma kun la'ang btang snyoms su mi bzhag par mig lam du dkon mchog gi rten mthong du gzhug pa dang rna bar sangs rgyas kyi mtshhan dang gzungs sngags zab mo sgrog pa snar tshhor grol gyi bdug pa lcer	610	chags sdang gnyis ka mi skye ba yul snang ba ma kun la gtong snyom su mi jog ba mig lam du dkon(d) mchog gi rten mthong du jug ba dang rna ba sangs rgya kyi mtshhan dang gzungs sngags zab mo sgrog ba snar tshhor grol gyi bdug ba lcer 
BO_TZ_LAMRIM-YISHE-NYINGPO-P2:6105	myong grol dam rdzas lus kyis phyag bskor yid la dad mos sogs dge rtsha sna re'i bag chags 'jog tu gzhug pas mtshhon bzang po'i las kyi 'brel ba ci thebs su bzhag go	610	myong grol dam rdzas lus kyis phyag skor yid la dad mos sogs dge rtsha sna re bag chags jog tu jug ba mtshhon bzang po las kyi brel ba ci thebs su jog go 
BO_TZ_LAMRIM-YISHE-NYINGPO-P2:6106	/gnyis pa la gnyis /	610	ba la gnyis 
BO_TZ_LAMRIM-YISHE-NYINGPO-P2:6107	kun rdzob dang / don dam gyis lam du khyer tshhul lo /	610	kun rdzob dang don dam gyis lam du khyer tshhul lo 
BO_TZ_LAMRIM-YISHE-NYINGPO-P2:6108	dang po la yang gnyis /	610	dang po la yang gnyis 
BO_TZ_LAMRIM-YISHE-NYINGPO-P2:6109	dngos dang / rgyud la bsten tshhul lo //	610	dngos dang brgyud la sten tshhul lo 
BO_TZ_LAMRIM-YISHE-NYINGPO-P2:6110	dang po ni /	611	dang po ni 
BO_TZ_LAMRIM-YISHE-NYINGPO-P2:6111	kun kyang nas drag tu bya :	611	kun kyang nas drag tu byed 
BO_TZ_LAMRIM-YISHE-NYINGPO-P2:6112	zhes gsungs te /	611	zhes gsungs te 
BO_TZ_LAMRIM-YISHE-NYINGPO-P2:6113	bzang ngan bar mas bsdus pa'i snang ba kun kyang gsog dang gsob dang snying po med pas kun rdzob dang skad cig re res 'pho zhing 'gyur bas mi rtag pa dang snang yang bden par ma grub pas sgyu ma dang mtshhungs par bsam ste /	611	bzang ngan ba mas sdud ba snang ba kun kyang gsog dang gsob dang snying po med ba kun rdzob dang skad cig re res pho zhing gyur ba mi rtag ba dang snang yang bden ba ma grub ba sgyu ma dang mtshhungs ba bsam ste 
BO_TZ_LAMRIM-YISHE-NYINGPO-P2:6114	ting rgyal las /	611	ting rgyal las 
BO_TZ_LAMRIM-YISHE-NYINGPO-P2:6115	sgyu ma byed pa dag gis gzugs sprul te //	611	sgyu ma byed ba dag gis gzugs sprul te 
BO_TZ_LAMRIM-YISHE-NYINGPO-P2:6116	rta dang glang po shing rta sna tshhogs byas //	611	rta dang glang po shing rta sna tshhogs byed 
BO_TZ_LAMRIM-YISHE-NYINGPO-P2:6117	de la ji bzhin snang ba gang yang med //	611	de la ji bzhin snang ba gang yang med 
BO_TZ_LAMRIM-YISHE-NYINGPO-P2:6118	chos rnams thams cad de bzhin shes par gyis //	611	chos rnams thams cad de bzhin shes ba gyis 
BO_TZ_LAMRIM-YISHE-NYINGPO-P2:6119	zhes so // des na dam pa'i chos nyams su len pa ma gtogs gzhan cis kyang tshhe phyi ma lta zhog 'dir yang phan pa spu tsham med pas gtan nas dgos pa med snyam du ci snang thams cad la dgos med kyi 'dun pas zin pa'i zhe bcad drag tu bya'o	611	zhes so des na dam ba chos nyams su len ba ma gtogs gzhan cis kyang tshhe phyi ma lta zhog dir yang phan ba spu tsham med ba gtan nas dgos ba med snyam du ci snang thams cad la dgos med kyi dun ba zin ba zhe gcod drag tu byed 
BO_TZ_LAMRIM-YISHE-NYINGPO-P2:6120	// gnyis pa ni /	612	gnyis ba ni 
BO_TZ_LAMRIM-YISHE-NYINGPO-P2:6121	bde sdug nas rgyun tu bsten :	612	bde sdug nas rgyun tu sten 
BO_TZ_LAMRIM-YISHE-NYINGPO-P2:6122	ces gsungs te /	612	ces gsungs te 
BO_TZ_LAMRIM-YISHE-NYINGPO-P2:6123	khyad par lus dang sems la bde sdug gi tshhor ba myong ba'i phyi nang gi rkyen phra rags gang la 'ang de'i rjes su 'brangs nas ro mi myang bar bde bar shar na de'i rgyu dge ba dang bcas pa mtha' yas par spel te sems can la gtong	612	khyad ba lus dang sems la bde sdug gi tshhor ba myong ba phyi nang gi rkyen phra rags gang la mang de rjes su brang nas ro mi myang ba bde ba char na de rgyu dge ba dang cha ba mtha yas ba spel te sems can la gtong 
BO_TZ_LAMRIM-YISHE-NYINGPO-P2:6124	ba dang / sdug bsngal byung na de'i rgyu sdig pa dang bcas pa sems can kun las bsdus nas rang la len pa'i blo sbyong zab mo'i gnad kyis bzung la lam du btang /	612	ba dang sdug sngal byung na de rgyu sdig ba dang cha ba sems can kun las sdud nas rang la len ba blo sbyong zab mo gnad kyis bzung la lam du gtong 
BO_TZ_LAMRIM-YISHE-NYINGPO-P2:6125	zas gos gnas mal sogs shugs kyis 'byor na brgya phrag ri ba'i zas gos dang khang pa brtshegs pa sogs rab byung la sangs rgyas kyis rjes su gnang bas zhen pa med na ched du spang mi dgos shing /	612	zas gos gnas mal sogs shugs kyis byor na brgya phrag ri ba zas gos dang khang ba brtshegs ba sogs rab byung la sangs rgya kyis rjes su gnang ba zhen ba med na ched du spong mi dgos shing 
BO_TZ_LAMRIM-YISHE-NYINGPO-P2:6126	ma 'byor na phyags dar khrod ba'i gos dang lus 'tshho tsham gyis kha zas ngan ngon gyis btubs pas gang ltar byung yang chog shes pa dang / rkyen bzang ngan la dga' sdug skyen theg cing gcig byung gnyis dgos kyi rtog pa'i bze re mang na 'dod pa'i khol bor 'phyan te lus sems rnal du gnas pa'i go skabs ma 'byung bas ji ltar byung yang mi dga' ba med pa'i yid bde kho na rgyun	612	ma byor na phyags dar khrod ba gos dang lus tshho tsham gyis kha zas ngan ngon gyis thub ba gang ltar byung yang chog shes ba dang rkyen bzang ngan la dga sdug skyen theg cing gcig byung gnyis dgos kyi rtogs ba bze re mang na dod ba khol bor phyan te lus sems rnal du gnas ba go skabs ma byung ba ji ltar byung yang mi dga ba med ba yid bde kho na rgyun 
BO_TZ_LAMRIM-YISHE-NYINGPO-P2:6127	tu bsten par bya'o //	612	tu sten ba byed 
BO_TZ_LAMRIM-YISHE-NYINGPO-P2:6128	gnyis pa don dam la gnyis /	612	gnyis ba don dam la gnyis 
BO_TZ_LAMRIM-YISHE-NYINGPO-P2:6129	mnyam bzhag dang / rjes thob bo //	612	mnyam jog dang rjes thob bo 
BO_TZ_LAMRIM-YISHE-NYINGPO-P2:6130	dang po ni /	613	dang po ni 
BO_TZ_LAMRIM-YISHE-NYINGPO-P2:6131	don dam nas ngang la bzhag :	613	don dam nas ngang la jog 
BO_TZ_LAMRIM-YISHE-NYINGPO-P2:6132	ces gsungs te /	613	ces gsungs te 
BO_TZ_LAMRIM-YISHE-NYINGPO-P2:6133	lam khyer mtha' dag la dngos 'dzin a 'thas su zhen na gnad du mi 'gro ste /	613	lam khyer mtha dag la dngos dzin a thas su zhen na gnad du mi gro ste 
BO_TZ_LAMRIM-YISHE-NYINGPO-P2:6134	sdud pa las /	613	sdud ba las 
BO_TZ_LAMRIM-YISHE-NYINGPO-P2:6135	ji ltar dug dang 'dres pa'i kha zas bzang za ba //	613	ji ltar dug dang dre ba kha zas bzang za ba 
BO_TZ_LAMRIM-YISHE-NYINGPO-P2:6136	dkar po'i chos la dmigs pa'ang de 'dra rgyal bas gsungs //	613	dkar po chos la dmigs ba de dra rgyal ba gsungs 
BO_TZ_LAMRIM-YISHE-NYINGPO-P2:6137	zhes so // des na gnas lugs don dam par mig yul du snang ba'i gzugs dang / rna bar grags pa'i sgra dang / yid yul du rnam par rtog pa'i 'khor 'das kyi chos rnams kun kyang 'khrul ngor snang ba tsham las mngon rjes tshhad ma dang yang dag pa'i shes rab kyis dpyad pa'am sgom byung ye shes khong nas shar na gdod nas rang bzhin gyis ma grub pa'i bden med	613	zhes so des na gnas lugs don dam ba mig yul du snang ba gzugs dang rna ba grags ba sgra dang yid yul du rnam ba rtogs ba khor da kyi chos rnams kun kyang khrul ngor snang ba tsham las mngon rjes tshhad ma dang yang dag ba shes rab kyis dpyod ba sgom byung ye shes khong nas char na gdod nas rang bzhin gyis ma grub ba bden med 
BO_TZ_LAMRIM-YISHE-NYINGPO-P2:6138	nam mkha'i gzugs brnyan lta bu skye 'gag gnas gsum dang bral ba yin pa la de ltar shes nas 'khrul 'dzin rang ngor bltas nas mi rtog pa'i ngang la mnyam par bzhag pa gal che ste /	613	nam mkha gzugs rnyan lta bu skye gag gnas gsum dang bral ba yin ba la de ltar shes nas khrul dzin rang ngor lta nas mi rtogs ba ngang la mnyam ba jog ba gal che ste 
BO_TZ_LAMRIM-YISHE-NYINGPO-P2:6139	sdud pa las /	613	sdud ba las 
BO_TZ_LAMRIM-YISHE-NYINGPO-P2:6140	gang tshhe 'dus byas 'dus ma byas dang dkar nag chos //	614	gang tshhe du byed du ma byed dang dkar nag chos 
BO_TZ_LAMRIM-YISHE-NYINGPO-P2:6141	shes rab rnam par bshigs nas rdul tsham mi dmigs tshhe //	614	shes rab rnam ba bshigs nas rdul tsham mi dmigs tshhe 
BO_TZ_LAMRIM-YISHE-NYINGPO-P2:6142	'jig rten dag na shes rab pha rol phyin grangs 'gro //	614	jig rten dag na shes rab pha rol phyin grangs gro 
BO_TZ_LAMRIM-YISHE-NYINGPO-P2:6143	nam mkha' gang la'ang cung zad mi gnas de dang 'dra //	614	nam mkha gang la cung zad mi gnas de dang dra 
BO_TZ_LAMRIM-YISHE-NYINGPO-P2:6144	zhes pa ltar lam khyer rnams kyi phul du gyur pa'o //	614	zhes ba ltar lam khyer rnams kyi bul du gyur ba 
BO_TZ_LAMRIM-YISHE-NYINGPO-P2:6145	gnyis pa ni /	614	gnyis ba ni 
BO_TZ_LAMRIM-YISHE-NYINGPO-P2:6146	rjes thob nas phyogs su bsgrig :	614	rjes thob nas phyogs su sgrig 
BO_TZ_LAMRIM-YISHE-NYINGPO-P2:6147	ces gsungs te /	614	ces gsungs te 
BO_TZ_LAMRIM-YISHE-NYINGPO-P2:6148	mnyam bzhag las ldangs pa'i rjes thob tu'ang snang grags kyi chos thams cad la bden dngos su mi zhen par /	614	mnyam jog las ldangs ba rjes thob tu snang grags kyi chos thams cad la bden dngos su mi zhen ba 
BO_TZ_LAMRIM-YISHE-NYINGPO-P2:6149	phyi yul gyi snang ba thams cad med bzhin 'khrul ngor snang ba rmi lam lta bu rgyu rkyen rten 'brel tshhogs pa las glo bur du snang ba sgyu ma lta bu /	614	phyi yul gyi snang ba thams cad med bzhin khrul ngor snang ba rmi lam lta bu rgyu rkyen rten brel tshhogs ba las glo bur du snang ba sgyu ma lta bu 
BO_TZ_LAMRIM-YISHE-NYINGPO-P2:6150	med pa la yod par snang ba mig yor lta bu /	615	med ba la yod ba snang ba mig yor lta bu 
BO_TZ_LAMRIM-YISHE-NYINGPO-P2:6151	snang bzhin bden par ma grub pa smig rgyu lta bu /	615	snang bzhin bden ba ma grub ba smig rgyu lta bu 
BO_TZ_LAMRIM-YISHE-NYINGPO-P2:6152	phyi nang gang la'ang med bzhin snang ba brag cha lta bu /	615	phyi nang gang la med bzhin snang ba brag cha lta bu 
BO_TZ_LAMRIM-YISHE-NYINGPO-P2:6153	rten dang brten par snang yang don la med pa dri za'i grong khyer lta bu /	615	rten dang rten ba snang yang don la med ba dri za grong khyer lta bu 
BO_TZ_LAMRIM-YISHE-NYINGPO-P2:6154	snang la rang bzhin ma grub pa me long nang gi gzugs brnyan lta bu /	615	snang la rang bzhin ma grub ba me long nang gi gzugs rnyan lta bu 
BO_TZ_LAMRIM-YISHE-NYINGPO-P2:6155	med snang cir yang 'char ba sprul pa lta bu ste bden med kyi dpe brgyad dang mtshhungs par blta zhing sgo gsum gyis ji ltar nus shing 'byor pas rnam par dkar ba'i las phyogs re ba ma yin par bsod nams kyi sgo mtha' yas par 'jug bzod pa'i	615	med snang cir yang char ba sprul ba lta bu ste bden med kyi dpe brgyad dang mtshhungs ba lta zhing sgo gsum gyis ji ltar nus shing byor ba rnam ba dkar ba las phyogs re ba ma yin ba bsod nams kyi sgo mtha yas ba jug bzod ba 
BO_TZ_LAMRIM-YISHE-NYINGPO-P2:6156	tshhogs chen po bsags shing de la'ang zhen med sgyu ma lta bur shes pa dang 'khor gsum yongs dag gi lta bas lam du khyer /	615	tshhogs chen po bsags shing de la zhen med sgyu ma lta bur shes ba dang khor gsum yongs dag gi lta ba lam du khyer 
BO_TZ_LAMRIM-YISHE-NYINGPO-P2:6157	phung khams skye mched kyis bsdus pa'i 'khor ba'i chos kun nas nyon mongs pa thams cad gnas lugs bde gshegs snying po nyid lhan skyes kyi ma rig pa la brten nas 'du byed 'byung ba sogs glo bur gyi dri mas rnyogs shing ma dag pa'i rgyu dang rkyen	615	phung khams skye mched kyis sdud ba khor ba chos kun nas nyon mongs ba thams cad gnas lugs bde gshegs snying po nyid lhan skye kyi ma rig ba la rten nas du byed byung ba sogs glo bur gyi dri mas rnyogs shing ma dag ba rgyu dang rkyen 
BO_TZ_LAMRIM-YISHE-NYINGPO-P2:6158	gyis mngon par 'du byas pa'i rten 'brel yan lag bcu gnyis lugs 'byung du 'khor ba ste /	615	gyis mngon ba du byed ba rten brel yan lag chu gnyis lugs byung du khor ba ste 
BO_TZ_LAMRIM-YISHE-NYINGPO-P2:6159	ma rig pa dang sred len te nyon mongs pa gsum gyis 'du byed dang srid pa'i las gnyis byas pa las /	615	ma rig ba dang sred len te nyon mongs ba gsum gyis du byed dang srid ba las gnyis byed ba las 
BO_TZ_LAMRIM-YISHE-NYINGPO-P2:6160	rnam shes ming gzugs skye mched drug reg tshhor skye ba rga shi bcas skye ba'i kun nas nyon mongs pa'i gzhi bdun byung zhing de dag las kyang nyon mongs gsum 'byung bas bya dang sgo nga ltar phan tshhun du 'khor ba ste /	616	rnam shes ming gzugs skye mched drug reg tshhor skye ba rga chi cha skye ba kun nas nyon mongs ba gzhi bdun byung zhing de dag las kyang nyon mongs gsum byung ba byed dang sgo nga ltar phan tshhun du khor ba ste 
BO_TZ_LAMRIM-YISHE-NYINGPO-P2:6161	dbu ma rten 'brel snying por /	616	dbu ma rten brel snying por 
BO_TZ_LAMRIM-YISHE-NYINGPO-P2:6162	gsum pa dag las gnyis 'byung ste //	616	gsum ba dag las gnyis byung ste 
BO_TZ_LAMRIM-YISHE-NYINGPO-P2:6163	gnyis las bdun 'byung bdun las kyang //	616	gnyis las bdun byung bdun las kyang 
BO_TZ_LAMRIM-YISHE-NYINGPO-P2:6164	gsum 'byung srid pa'i 'khor lo de //	616	gsum byung srid ba khor lo de 
BO_TZ_LAMRIM-YISHE-NYINGPO-P2:6165	nyid ni yang dang yang du 'khor //	616	nyid ni yang dang yang du khor 
BO_TZ_LAMRIM-YISHE-NYINGPO-P2:6166	zhes pa ltar ro //	616	zhes ba ltar ro 
BO_TZ_LAMRIM-YISHE-NYINGPO-P2:6167	srid pa'i mya ngan las ring du 'das pa zhi ba thar pa dam pa'ang skye ba 'gags na rga shi 'gag	616	srid ba mya ngan las ring du da ba zhi ba thar ba dam ba skye ba gag na rga chi gag 
BO_TZ_LAMRIM-YISHE-NYINGPO-P2:6168	/srid pa 'gags na skye ba 'gag pa sogs yan lag bcu gnyis lugs las ldog cing ma rig pa phug rdib pas dri ma de nyid rnam par byung zhing dag pa'i rten cing 'brel 'byung tsham yin la /	616	ba gag na skye ba gag ba sogs yan lag chu gnyis lugs las ldog cing ma rig ba bugs rdib ba dri ma de nyid rnam ba byung zhing dag ba rten cing brel byung tsham yin la 
BO_TZ_LAMRIM-YISHE-NYINGPO-P2:6169	don dam rang bzhin 'od gsal bskyed bya skyed byed kyi rten 'brel las 'das kyang rnam pa'i 'dogs cha tsham du gzhi dus srid rtsha yan lag bcu gnyis /	616	don dam rang bzhin d gsal skyed byed skyed byed kyi rten brel las da kyang rnam ba dogs cha tsham du gzhi dus srid rtsha yan lag chu gnyis 
BO_TZ_LAMRIM-YISHE-NYINGPO-P2:6170	lam dus su bden don yan lag bcu gnyis /	617	lam dus su bden don yan lag chu gnyis 
BO_TZ_LAMRIM-YISHE-NYINGPO-P2:6171	'bras bus dag pa rnam pa bcu gnyis kyi tshhul du 'char ba ste /	617	bras bud dag ba rnam ba chu gnyis kyi tshhul du char ba ste 
BO_TZ_LAMRIM-YISHE-NYINGPO-P2:6172	mtshhan brjod las /	617	mtshhan rjod las 
BO_TZ_LAMRIM-YISHE-NYINGPO-P2:6173	yan lag bcu gnyis srid rtsha bton //	617	yan lag chu gnyis srid rtsha don 
BO_TZ_LAMRIM-YISHE-NYINGPO-P2:6174	dag pa rnam pa bcu gnyis 'chang //	617	dag ba rnam ba chu gnyis chang 
BO_TZ_LAMRIM-YISHE-NYINGPO-P2:6175	bden bzhi'i tshhul gyi rnam pa can //	617	bden bzhi tshhul gyi rnam ba can 
BO_TZ_LAMRIM-YISHE-NYINGPO-P2:6176	zhes so // mdor na 'khor 'das lam gsum gyi chos thams cad rten cing 'brel 'byung gi snang ba tsham yin zhing de'ang rang bzhin stong pa nyid las bden dngos su grub pa med pas /	617	zhes so mdor na khor da lam gsum gyi chos thams cad rten cing brel byung gi snang ba tsham yin zhing de rang bzhin stong ba nyid las bden dngos su grub ba med ba 
BO_TZ_LAMRIM-YISHE-NYINGPO-P2:6177	'phags pa klus /	617	phag ba klus 
BO_TZ_LAMRIM-YISHE-NYINGPO-P2:6178	gang phyir rten 'byung ma yin pa'i //	617	gang phyir rten byung ma yin ba 
BO_TZ_LAMRIM-YISHE-NYINGPO-P2:6179	chos 'ga' yod pa ma yin te //	617	chos ga yod ba ma yin te 
BO_TZ_LAMRIM-YISHE-NYINGPO-P2:6180	de phyir stong pa ma yin pa'i //	618	de phyir stong ba ma yin ba 
BO_TZ_LAMRIM-YISHE-NYINGPO-P2:6181	chos 'ga' yod pa ma yin no //	618	chos ga yod ba ma yin no 
BO_TZ_LAMRIM-YISHE-NYINGPO-P2:6182	zhes so // rgyu mtshhan de dag gi phyir lam gyi snang ba thams cad kun kyang rten 'brel la rags lus pas thar pa 'dod pa rnams kyis thog mar chos sgor zhugs pa'i 'dun pa dang bla ma bsten pa nas brtshams /	618	zhes so rgyu mtshhan de dag gi phyir lam gyi snang ba thams cad kun kyang rten brel la rags lus ba thar ba dod ba rnams kyis thogs mar chos sgor jug ba dun ba dang bla ma sten ba nas brtshams 
BO_TZ_LAMRIM-YISHE-NYINGPO-P2:6183	yang dag pa'i 'bras bu mngon du ma byas kyi bar du dam chos sgrub pa'i rgyu dang de'i grogs su 'gyur ba'i rkyen gyi rten 'brel thams cad legs pa'i phyogs 'ba' zhig tu bsgrigs pas 'phral dang yun du don gnyis rlabs che 'grub par 'gyur te /	618	yang dag ba bras bu mngon du ma byed kyi ba du dam chos sgrub ba rgyu dang de grogs su gyur ba rkyen gyi rten brel thams cad legs ba phyogs ba jig tu sgrig ba phral dang yun du don gnyis rlabs che grub ba gyur te 
BO_TZ_LAMRIM-YISHE-NYINGPO-P2:6184	bshes springs las /	618	bshes spring las 
BO_TZ_LAMRIM-YISHE-NYINGPO-P2:6185	rten cing 'brel par 'byung 'di sangs rgyas kyi //	618	rten cing brel ba byung di sangs rgya kyi 
BO_TZ_LAMRIM-YISHE-NYINGPO-P2:6186	gsung gi mdzod kyi gces pa zab mo ste //	618	gsung gi mdzod kyi gces ba zab mo ste 
BO_TZ_LAMRIM-YISHE-NYINGPO-P2:6187	gang gis 'di ni yang dag mthong ba des //	618	gang gis di ni yang dag mthong ba des 
BO_TZ_LAMRIM-YISHE-NYINGPO-P2:6188	chos mthong de yis de bzhin gshegs pa mthong //	618	chos mthong de yis de bzhin gshegs ba mthong 
BO_TZ_LAMRIM-YISHE-NYINGPO-P2:6189	zhes so // gnyis pa nang bskyed rdzogs kyi bogs 'don la gnyis /	618	zhes so gnyis ba nang skyed rdzogs kyi bogs don la gnyis 
BO_TZ_LAMRIM-YISHE-NYINGPO-P2:6190	bskyed pa'i dang / rdzogs rim kyi bogs 'don no //	619	skyed ba dang rdzogs rim kyi bogs don no 
BO_TZ_LAMRIM-YISHE-NYINGPO-P2:6191	dang po la gnyis /	619	dang po la gnyis 
BO_TZ_LAMRIM-YISHE-NYINGPO-P2:6192	spyi dang bye brag go	619	spyi dang bye brag go 
BO_TZ_LAMRIM-YISHE-NYINGPO-P2:6193	/dang po ni /	619	po ni 
BO_TZ_LAMRIM-YISHE-NYINGPO-P2:6194	nang du nas ting 'dzin spel :	619	nang du nas ting dzin spel 
BO_TZ_LAMRIM-YISHE-NYINGPO-P2:6195	ces gsungs te /	619	ces gsungs te 
BO_TZ_LAMRIM-YISHE-NYINGPO-P2:6196	nang du rim pa gnyis kyi ting nge 'dzin la rtshal sbyong zhing bogs 'don pa'i tshhul yang /	619	nang du rim ba gnyis kyi ting nge dzin la rtshal sbyong zhing bogs don ba tshhul yang 
BO_TZ_LAMRIM-YISHE-NYINGPO-P2:6197	thog mar kun brtags kyi bskyed rim ji lta bu bsgom yang snang la rang bzhin ma grub pa stong pa'i gzugs brnyan chu'i zla ba lta bur bsgom pa zab pa'i tshhul dang / snod dang bcud kyi rnam pa gang zhig snang ba de thams cad yi dam lha'i rnam par bsgom pas rgya che ba la 'jug pa dang /	619	thogs mar kun rtog kyi skyed rim ji lta bu bsgom yang snang la rang bzhin ma grub ba stong ba gzugs rnyan chu zla ba lta bur bsgom ba zab ba tshhul dang snod dang bcud kyi rnam ba gang jig snang ba de thams cad yi dam lha rnam ba bsgom ba rgya che ba la jug ba dang 
BO_TZ_LAMRIM-YISHE-NYINGPO-P2:6198	de'ang rang gi sems kyi rol rtshal las logs su grub pa med pas sgom mkhan sems dang bsgom bya'i lha sku gnyis don dam chos nyid du ro mnyam par shes pa dang / snang zhing srid pas bsdus pa'i 'jig rten kun kyang rang byung ye shes lha'i sku ru gdod nas gzhi thog tu bzhengs shing rdzogs pa yongs grub don dam pa'i bskyed tshhul dang /	619	de rang gi sems kyi rol rtshal las logs su grub ba med ba sgom mkhan sems dang bsgom byed lha sku gnyis don dam chos nyid du ro mnyam ba shes ba dang snang zhing srid ba sdud ba jig rten kun kyang rang byung ye shes lha sku ru gdod nas gzhi thogs tu bzhengs shing rdzogs ba yongs grub don dam ba skyed tshhul dang 
BO_TZ_LAMRIM-YISHE-NYINGPO-P2:6199	tshhogs drug gi yul du rtog pa'i rgyu ba gang byung yang glo bur thug phrad de ma thag par lha'i rang bzhin kho nar shes pa'i ting 'dzin gyi rol mo mtha' yas par spel ba ste rnam pa lnga yis bskyed rim spyi'i yon tan gyi bogs dbyung ngo	619	tshhogs drug gi yul du rtogs ba rgyu ba gang byung yang glo bur thug phrad de ma thag ba lha rang bzhin kho nar shes ba ting dzin gyi rol mo mtha yas ba spel ba ste rnam ba lnga yis skyed rim spyi yon tan gyi bogs byin ngo 
BO_TZ_LAMRIM-YISHE-NYINGPO-P2:6200	// gnyis pa la gnyis /	620	gnyis ba la gnyis 
BO_TZ_LAMRIM-YISHE-NYINGPO-P2:6201	bskyed pa'i rtshal sbyong ba dang de nyid dag rdzogs smin pa'i tshhul gyis nyams su blang ba'o //	620	skyed ba rtshal sbyong ba dang de nyid dag rdzogs smin ba tshhul gyis nyams su blang ba 
BO_TZ_LAMRIM-YISHE-NYINGPO-P2:6202	dang po ni /	620	dang po ni 
BO_TZ_LAMRIM-YISHE-NYINGPO-P2:6203	bris sku nas ldang la bslab :	620	bri sku nas ldang la bslab 
BO_TZ_LAMRIM-YISHE-NYINGPO-P2:6204	ces gsungs te /	620	ces gsungs te 
BO_TZ_LAMRIM-YISHE-NYINGPO-P2:6205	nyin mo'i dus su lha bzo mkhas pas bris pa'i yi dam gyi sku mtshhan nyid dang ldan pa'am shel lam me long gi gzugs brnyan bkrag mdangs khyad du mtshhar ba nyid rang gi rgyab ngos lta bur bzhag	620	nyin mo dus su lha bzo mkhas ba bri ba yi dam gyi sku mtshhan nyid dang ldan ba shel lam me long gi gzugs rnyan bkrag mdangs khyad du mtshhar ba nyid rang gi rgyab ngos lta bur jog 
BO_TZ_LAMRIM-YISHE-NYINGPO-P2:6206	/mdun du chu'i snod dwangs shing g.yo ba med par de'i gzugs brnyan 'phos pa la rten byas te yid mig rlung gsum po dril la rtshe gcig tu gtad pa'i gsal snang gi rtshal sgrub pa dang / mtshhan mo'i dus su 'dzin pa'i gdams ngag gis rmi lam bzung la zin pa dang de ma thag nyin mor bsgoms pa lta bu'i lha'i skur ldang ba la bslabs pas mtshhan dus kyis nyin snang dang des kyang mtshhan snang gi rtshal bskyed de bogs chen po thon par	620	du chu snod dwangs shing g.yo ba med ba de gzugs rnyan pho ba la rten byed te yid mig rlung gsum po dril la rtshe gcig tu gtod ba gsal snang gi rtshal sgrub ba dang mtshhan mo dus su dzin ba doms ngag gis rmi lam bzung la zin ba dang de ma thag nyin mor sgom ba lta bu lha skur ldang ba la bslabs ba mtshhan dus kyis nyin snang dang des kyang mtshhan snang gi rtshal skyed de bogs chen po thon ba 
BO_TZ_LAMRIM-YISHE-NYINGPO-P2:6207	'gyur ro // gnyis pa ni khyad par	620	gyur ro gnyis ba ni khyad ba 
BO_TZ_LAMRIM-YISHE-NYINGPO-P2:6208	nas mngon tu 'gyur :	620	nas mngon tu gyur 
BO_TZ_LAMRIM-YISHE-NYINGPO-P2:6209	zhes gsungs te /	620	zhes gsungs te 
BO_TZ_LAMRIM-YISHE-NYINGPO-P2:6210	dbyibs dang kha dog gi rnam pa lam byed tsham gyi bskyed rim ni phyi rol pa la'ang yod cing de'i grub 'bras nyi tshhe ba dang bskyed rim rang rgyud par gol ba'i rang 'bras ru dra /	621	dbyibs dang kha dog gi rnam ba lam byed tsham gyi skyed rim ni phyi rol ba la yod cing de grub bras nyi tshhe ba dang skyed rim rang brgyud ba gol ba rang bras ru dra 
BO_TZ_LAMRIM-YISHE-NYINGPO-P2:6211	rgyu mthun 'byung po mthu chen du 'gyur ba yod pas /	621	rgyu mthun byung po mthu chen du gyur ba yod ba 
BO_TZ_LAMRIM-YISHE-NYINGPO-P2:6212	de dag lam du 'gyur ba'i khyad par gyi gnad ni /	621	de dag lam du gyur ba khyad ba gyi gnad ni 
BO_TZ_LAMRIM-YISHE-NYINGPO-P2:6213	'chi bar skye ba'i srid pa dang mthun pa'i bskyed bsdu dang / phyi snod nang bcud dang mthun pa'i rten gzhal yas khang brten pa lha'i 'khor lo bsgom pa sogs mar bltas 'khor ba'i rnam pa dang mthun par lam du byas pas de'i snang zhen dag pa las /	621	chi ba skye ba srid ba dang mthun ba skyed sdud dang phyi snod nang bcud dang mthun ba rten jal yas khang rten ba lha khor lo bsgom ba sogs mar lta khor ba rnam ba dang mthun ba lam du byed ba de snang zhen dag ba las 
BO_TZ_LAMRIM-YISHE-NYINGPO-P2:6214	bskyed pas gzugs sku dang bsdu rim gyis chos sku /	621	skyed ba gzugs sku dang sdud rim gyis chos sku 
BO_TZ_LAMRIM-YISHE-NYINGPO-P2:6215	rten brten pa rnam dag lha'i dkyil 'khor du grub pa sogs yar bltas rnam byang gi 'dra 'bag tu gyur pas mthar thug myang 'das kyi yon tan rdzogs pa'i rgyur 'gyur pa dang / gnas skabs rim pa gnyis ka'i gzhi bting ba las rdzogs rim gyi ye shes smin thabs khyad par can du 'gyur ba'i tshhul legs par shes pas gol 'phyugs med pa'i lam gyi mchog mngon du 'gyur ba yin no //	621	rten rten ba rnam dag lha dkyil khor du grub ba sogs yar lta rnam byang gi dra bag tu gyur ba mthar thug myang da kyi yon tan rdzogs ba rgyur gyur ba dang gnas skabs rim ba gnyis ka gzhi bting ba las rdzogs rim gyi ye shes smin thabs khyad ba can du gyur ba tshhul legs ba shes ba gol phyug med ba lam gyi mchog mngon du gyur ba yin no 
BO_TZ_LAMRIM-YISHE-NYINGPO-P2:6216	gnyis pa rdzogs rim gyi bogs 'don la gsum /	621	gnyis ba rdzogs rim gyi bogs don la gsum 
BO_TZ_LAMRIM-YISHE-NYINGPO-P2:6217	rtsha rlung / chags lam /	621	rtsha rlung chags lam 
BO_TZ_LAMRIM-YISHE-NYINGPO-P2:6218	rdzogs rim spyi'i bogs 'don 'bras bu dang bcas pa'o //	621	rdzogs rim spyi bogs don bras bu dang cha ba 
BO_TZ_LAMRIM-YISHE-NYINGPO-P2:6219	dang po ni /	621	dang po ni 
BO_TZ_LAMRIM-YISHE-NYINGPO-P2:6220	'phrul 'khor nas kun tu brtan :	622	phrul khor nas kun tu brtan 
BO_TZ_LAMRIM-YISHE-NYINGPO-P2:6221	zhes gsungs te /	622	zhes gsungs te 
BO_TZ_LAMRIM-YISHE-NYINGPO-P2:6222	rang lus thabs ldan nyams su len pa'i tshhe /	622	rang lus thabs ldan nyams su len ba tshhe 
BO_TZ_LAMRIM-YISHE-NYINGPO-P2:6223	thun mtshhams rnams su lus sbyong 'phrul 'khor zab mo man ngag lag len gyi gnad dang ldan pa la 'bad pas rtsha'i mdud pa rnams bkrol /	622	thun mtshhams rnams su lus sbyong phrul khor zab mo man ngag lag len gyi gnad dang ldan ba la bad ba rtsha mdud ba rnams grol 
BO_TZ_LAMRIM-YISHE-NYINGPO-P2:6224	rtag tu bar gyi rlung lte ba thad kar brgyangs te 'dzin pa gsang ba ye shes chen po'i rlung sbyor gyis rlung sems kyi rnyogs pa phra rags rang sar dengs shing shes pa rnal du phebs par 'gyur ba dang / gtum mo'i me dmigs mnyam bzhag tu bsgoms shing rjes thob tu mi bsgom pa'i res 'jog can gyi nus pa rnyed par mi 'gyur bas 'bar ba'i gsal snang mnyam rjes kun tu ma chad par brtan par bsgom pa rnams gnad du che'o //	622	rtag tu ba gyi rlung lte ba thad kar rgyong te dzin ba gsang ba ye shes chen po rlung sbyor gyis rlung sems kyi rnyogs ba phra rags rang sar dengs shing shes ba rnal du phebs ba gyur ba dang thum mo me dmigs mnyam jog tu sgom shing rjes thob tu mi bsgom ba res jog can gyi nus ba rnyed ba mi gyur ba bar ba gsal snang mnyam rjes kun tu ma chad ba brtan ba bsgom ba rnams gnad du che 
BO_TZ_LAMRIM-YISHE-NYINGPO-P2:6225	gnyis pa ni /	622	gnyis ba ni 
BO_TZ_LAMRIM-YISHE-NYINGPO-P2:6226	thig le nas rang rtshal spel :	622	thig le nas rang rtshal spel 
BO_TZ_LAMRIM-YISHE-NYINGPO-P2:6227	zhes gsungs te /	622	zhes gsungs te 
BO_TZ_LAMRIM-YISHE-NYINGPO-P2:6228	gzhan lus pho nya'i lam la 'jug pa na /	622	gzhan lus pho nya lam la jug ba na 
BO_TZ_LAMRIM-YISHE-NYINGPO-P2:6229	phyag rgya dang snyoms par 'jug pa'i rjes chags kyi mes kun rdzob byang chub sems kyi thig le rim par 'dzag cing zhu ba na rig stong ka dag nam mkha' lta bu'i ngang las nam yang ma g.yos pas 'khor lo so so'i dbu ma'i lte bar dang /	622	phyag rgya dang snyom ba jug ba rjes chags kyi mes kun rdzob byang chub sems kyi thig le rim ba dzag cing ju ba na rig stong ka dag nam mkha lta bu ngang las nam yang ma g.yos ba khor lo so so dbu ma lte ba dang 
BO_TZ_LAMRIM-YISHE-NYINGPO-P2:6230	khyad par lhan skyes kyi mthar gzung ldog bkram khyab dang 'brel ba'i snying ga'i dbus su zag med ye shes dwangs ma'i thig le chen por bstims pas rtag tu lus sems bde stong gi nyams dang mi 'bral bar 'gyur zhing /	623	khyad ba lhan skye kyi mthar gzung ldog grem khyab dang brel ba snying ga dbus su zag med ye shes dwangs ma thig le chen por stim ba rtag tu lus sems bde stong gi nyams dang mi bral ba gyur zhing 
BO_TZ_LAMRIM-YISHE-NYINGPO-P2:6231	de la rten byas nas phyi nang gang la'ang ched du 'dzin zhen med pa sgyu mar shes pa'i ngang nas tshhogs drug gi yul du bzang ngan bar ma gang shar gyi snang ba sna tshhogs pa yis kyang bde chen 'dren par nus pa'i ting 'dzin gyi rang bzhin	623	de la rten byed nas phyi nang gang la ched du dzin zhen med ba sgyu mar shes ba ngang nas tshhogs drug gi yul du bzang ngan ba ma gang char gyi snang ba sna tshhogs ba yis kyang bde chen bgrang ba nus ba ting dzin gyi rang bzhin 
BO_TZ_LAMRIM-YISHE-NYINGPO-P2:6232	dang mi 'bral bar rtshal sbyong gong nas gong du spel bas mthar 'khor 'das kyi rtog tshhogs bde chen ye shes gcig gi ngang du gyur pa na thabs lam mthar phyin pa'o //	623	dang mi bral ba rtshal sbyong gong nas gong du spel ba mthar khor da kyi rtogs tshhogs bde chen ye shes gcig gi ngang du gyur ba na thabs lam mthar phyin ba 
BO_TZ_LAMRIM-YISHE-NYINGPO-P2:6233	gsum pa ni /	623	gsum ba ni 
BO_TZ_LAMRIM-YISHE-NYINGPO-P2:6234	khyad par nas ris med shar /	623	khyad ba nas ris med char 
BO_TZ_LAMRIM-YISHE-NYINGPO-P2:6235	zhes gsungs te /	623	zhes gsungs te 
BO_TZ_LAMRIM-YISHE-NYINGPO-P2:6236	mtshhan bcas rdzogs rim spyi la khyad par du shes dgos pa sbyang ba'i gzhi'i las su bya ba ma dag pa'i rtsha rlung thig le las gyur pa'i phung khams skye mched kyi 'khrul snang bag chags mtha' yas pa kun /	623	mtshhan cha rdzogs rim spyi la khyad ba du shes dgos ba sbyong ba gzhi las su byed ba ma dag ba rtsha rlung thig le las gyur ba phung khams skye mched kyi khrul snang bag chags mtha yas ba kun 
BO_TZ_LAMRIM-YISHE-NYINGPO-P2:6237	sbyong byed thabs kyi lam mchog lus rtsha sku /	623	sbyong byed thabs kyi lam mchog lus rtsha sku 
BO_TZ_LAMRIM-YISHE-NYINGPO-P2:6238	ngag rlung gsung /	623	ngag rlung gsung 
BO_TZ_LAMRIM-YISHE-NYINGPO-P2:6239	yid thig le thugs rdo rje'i rnal 'byor gnad thog tu thebs pa'i me btsha' ltar zab mo'i mthu dang nus pa'i phyag rgyas byed pa'i gnad legs par bcings te rgyas btab nas gzhan du mi g.yengs pa'i sems rtshe gcig pas bsgom pa de yis /	623	yid thig le thugs rdo rje rnal byor gnad thogs tu thebs ba me btsha ltar zab mo mthu dang nus ba phyag rgya byed ba gnad legs ba ching te rgya debs nas gzhan du mi g.yengs ba sems rtshe gcig ba bsgom ba de yis 
BO_TZ_LAMRIM-YISHE-NYINGPO-P2:6240	glo bur gyi dri ma rnams dag cing sbyangs pa'i 'bras bu chos nyid kyi mkha' la sku dang ye shes phyogs ris med pa'i nyi ma shar ba yin pas de dag gi gnad gsang shes na lam nor 'khrul gyi skyon med pas blun sgom gyi 'phrang las grol	624	glo bur gyi dri ma rnams dag cing sbyong ba bras bu chos nyid kyi mkha la sku dang ye shes phyogs ris med ba nyi ma char ba yin ba de dag gi gnad gsang shes na lam nor khrul gyi skyon med ba blun sgom gyi phrangs las grol 
BO_TZ_LAMRIM-YISHE-NYINGPO-P2:6241	te 'phral yun du bogs chen por 'gyur ro //	624	te phral yun du bogs chen por gyur ro 
BO_TZ_LAMRIM-YISHE-NYINGPO-P2:6242	gsum pa gsang ba a ti'i lam gyi bogs 'don la gnyis /	624	gsum ba gsang ba a ti lam gyi bogs don la gnyis 
BO_TZ_LAMRIM-YISHE-NYINGPO-P2:6243	khregs chod dang / thod rgal gyi'o //	624	khregs chod dang thod rgal gyi 
BO_TZ_LAMRIM-YISHE-NYINGPO-P2:6244	dang po la'ang gsum /	624	dang po la gsum 
BO_TZ_LAMRIM-YISHE-NYINGPO-P2:6245	mdor bstan / rgyas bshad /	624	mdor ston rgya chad 
BO_TZ_LAMRIM-YISHE-NYINGPO-P2:6246	don bsdu'o // dang po ni /	624	don sdud dang po ni 
BO_TZ_LAMRIM-YISHE-NYINGPO-P2:6247	gsang ba nas lam du btang :	624	gsang ba nas lam du gtong 
BO_TZ_LAMRIM-YISHE-NYINGPO-P2:6248	zhes gsungs te /	624	zhes gsungs te 
BO_TZ_LAMRIM-YISHE-NYINGPO-P2:6249	gsang ba rdzogs chen shin tu ka dag khregs chod kyi dgongs pa la gnas pa'i tshhe /	624	gsang ba rdzogs chen shin tu ka dag khregs chod kyi dgongs ba la gnas ba tshhe 
BO_TZ_LAMRIM-YISHE-NYINGPO-P2:6250	nyon mongs pa brgyad khri bzhi stong gi rtsha ba dug lnga las gyur pa'i rnam par rtog pa ji snyed pa rang sems kyi cho 'phrul las shar ba kun /	625	nyon mongs ba brgyad khri bzhi stong gi rtsha ba dug lnga las gyur ba rnam ba rtogs ba ji snyed ba rang sems kyi cho phrul las char ba kun 
BO_TZ_LAMRIM-YISHE-NYINGPO-P2:6251	kha yan du btang ba dang spang bsgyur gyi gnyen po brten pa sogs mi bya bar ye grol rang ngo rig pa'i gnad kyis skad cig ma gsum pa las phan mi 'da' bar bzung la lam du btang bar bya'o //	625	kha yan du gtong ba dang spong sgyur gyi gnyen po rten ba sogs mi byed ba ye grol rang ngo rig ba gnad kyis skad cig ma gsum ba las phan mi da ba bzung la lam du gtong ba byed 
BO_TZ_LAMRIM-YISHE-NYINGPO-P2:6252	gnyis pa ni /	625	gnyis ba ni 
BO_TZ_LAMRIM-YISHE-NYINGPO-P2:6253	'dod la nas chen por grol :	625	dod la nas chen por grol 
BO_TZ_LAMRIM-YISHE-NYINGPO-P2:6254	ces gsungs te /	625	ces gsungs te 
BO_TZ_LAMRIM-YISHE-NYINGPO-P2:6255	de'ang zhib par bkrol na /	625	de zhib ba grol na 
BO_TZ_LAMRIM-YISHE-NYINGPO-P2:6256	mig gi yul du gzugs sdug pas mtshhon lus longs spyod gnyen 'brel 'khor g.yog sogs 'dod pa'i yul la chags shing zhen pa'i rtog pa shar ba'i tshhe /	625	mig gi yul du gzugs sdug ba mtshhon lus longs spyod gnyen brel khor g.yog sogs dod ba yul la chags shing zhen ba rtogs ba char ba tshhe 
BO_TZ_LAMRIM-YISHE-NYINGPO-P2:6257	rtog pa 'gags nas dgag pa dang rjes 'brang gis sgrub pa gang yang mi bya bar rang ngo la bltas pas rig stong rjen par 'char ba de thog tu klod la bzhag pas /	625	rtogs ba gag nas gog ba dang rjes brang gis sgrub ba gang yang mi byed ba rang ngo la lta ba rig stong rjen ba char ba de thogs tu klod la jog ba 
BO_TZ_LAMRIM-YISHE-NYINGPO-P2:6258	bde ba la zhen 'dzin kyi dri ma med bzhin bde stong ma 'gags pa'i nyams myong khong nas sad par gyur pa na /	625	bde ba la zhen dzin kyi dri ma med bzhin bde stong ma gag ba nyams myong khong nas sad ba gyur ba na 
BO_TZ_LAMRIM-YISHE-NYINGPO-P2:6259	so sor rtog pa'i ye shes zhes grags pa de nyid la bya ba yin gyi logs su btshal du med do //	625	so sor rtogs ba ye shes zhes grags ba de nyid la byed ba yin gyi logs su btshal du med do 
BO_TZ_LAMRIM-YISHE-NYINGPO-P2:6260	des mtshhon te /	626	des mtshhon te 
BO_TZ_LAMRIM-YISHE-NYINGPO-P2:6261	mi dang mi ma yin pa'i gnod byed sogs tshhogs drug gi yid du mi 'ong ba la zhe sdang bas sems khro zhing gtum pa'i rnam par rtog pa lam gyis shar ba'i tshhe /	626	mi dang mi ma yin ba gnod byed sogs tshhogs drug gi yid du mi ng ba la zhe sdang ba sems khro zhing thum ba rnam ba rtogs ba lam gyis char ba tshhe 
BO_TZ_LAMRIM-YISHE-NYINGPO-P2:6262	de'i rjes su 'brang na las bsags pas mi 'brang zhing skyon du'ang mi bzung bar rang ngo rig bzhin gang shar de nyid ma bcos rang babs su lhug par bskyangs pas /	626	de rjes su brang na las bsags ba mi brang zhing skyon du mi bzung ba rang ngo rig bzhin gang char de nyid ma chos rang bab su lhug ba skyong ba 
BO_TZ_LAMRIM-YISHE-NYINGPO-P2:6263	rnam pa gsal la ma 'gags shing ngo bo der 'dzin med pa /	626	rnam ba gsal la ma gag shing ngo bo der dzin med ba 
BO_TZ_LAMRIM-YISHE-NYINGPO-P2:6264	de'i ro myong ba dang rjes su 'brang ba'i zhen pa dang 'di yin gyi rtshis gdab dang bral ba dwangs shel gyi gzugs brnyan ltar 'char te /	626	de ro myong ba dang rjes su brang ba zhen ba dang di yin gyi rtshis gdab dang bral ba dwangs shel gyi gzugs rnyan ltar char te 
BO_TZ_LAMRIM-YISHE-NYINGPO-P2:6265	me long lta bu'i ye shes zhes pa ni /	626	me long lta bu ye shes zhes ba ni 
BO_TZ_LAMRIM-YISHE-NYINGPO-P2:6266	de la bya ba yin no //	626	de la byed ba yin no 
BO_TZ_LAMRIM-YISHE-NYINGPO-P2:6267	gnyid dang snyoms las gtshor gyur thos bsam sgom gsum la blo gros kyi snang ba sgrib pa gti mug mun pa'i 'thib po nam byung ba'i tshhe /	626	rnyid dang snyom las gtshor gyur thos bsam sgom gsum la blo gros kyi snang ba sgrib ba gti mug mun ba thib po nam byung ba tshhe 
BO_TZ_LAMRIM-YISHE-NYINGPO-P2:6268	de nyid kyi rang ngo rig pa'i ngang bskyang ba las skyon rtog gis spang ba'am yon tan du blta ba'i dang blang gnyis ka dor bas /	626	de nyid kyi rang ngo rig ba ngang skyong ba las skyon rtogs gis spong ba yon tan du lta ba dang blang gnyis ka dor ba 
BO_TZ_LAMRIM-YISHE-NYINGPO-P2:6269	khyab brdal chen po rtshe gcig gi klong du rnam par mi rtog pa'i rang byung spros bral rjen par lhag gis shar bar 'gyur te /	626	khyab rdal chen po rtshe gcig gi klong du rnam ba mi rtogs ba rang byung spros bral rjen ba lhag gis char ba gyur te 
BO_TZ_LAMRIM-YISHE-NYINGPO-P2:6270	chos kyi dbyings kyi ye shes zhes pa'ang de la bya ba yin no //	627	chos kyi dbyings kyi ye shes zhes ba de la byed ba yin no 
BO_TZ_LAMRIM-YISHE-NYINGPO-P2:6271	gzhan las bdag nyid rigs rus yon tan 'byor pa sogs kyis lhag go snyam du nga rgyal gyis sems khengs pa'i 'dzin pa nang du ldang ba na /	627	gzhan las bdag nyid rigs rus yon tan byor ba sogs kyis lhag go snyam du nga rgyal gyis sems kheng ba dzin ba nang du ldang ba na 
BO_TZ_LAMRIM-YISHE-NYINGPO-P2:6272	de la'ang snga ma rnams bzhin du blang dor gang yang mi bya bar ngar 'dzin pa de nyid kyi rang ngor bltas te mnyam par bzhag pas ci yang mi rtog par rang gzhan mnyam pa chen po'i klong gcig tu gyur na mnyam pa nyid kyi ye shes zhes	627	de la snga ma rnams bzhin du blang dor gang yang mi byed ba ngar dzin ba de nyid kyi rang ngor lta te mnyam ba jog ba ci yang mi rtogs ba rang gzhan mnyam ba chen po klong gcig tu gyur na mnyam ba nyid kyi ye shes zhes 
BO_TZ_LAMRIM-YISHE-NYINGPO-P2:6273	pa ni de la bya'o //	627	ba ni de la byed 
BO_TZ_LAMRIM-YISHE-NYINGPO-P2:6274	gzhan gyi phun sum tshhogs pa la phrag dog cing 'gran zlar sems pa'i zug rngu yid la shar ba'i tshhe na'ang /	627	gzhan gyi phun sum tshhogs ba la phrag dog cing gran zlar sems ba zug rngu yid la char ba tshhe na 
BO_TZ_LAMRIM-YISHE-NYINGPO-P2:6275	de la gnyer kha mi bya bar shar mkhan kho rang gi thog tu gang dgar bor te ngo bor bltas pas /	627	de la gnyer kha mi byed ba char mkhan kho rang gi thogs tu gang dgar bor te ngo bor lta ba 
BO_TZ_LAMRIM-YISHE-NYINGPO-P2:6276	bdag dang gzhan zhes gnyis su 'dzin pa'i rtog pa med par rig stong sgyu mar rdzogs par 'gyur te bya ba grub pa'i ye shes zhes pa'ang de la bya ba yin no //	627	bdag dang gzhan zhes gnyis su dzin ba rtogs ba med ba rig stong sgyu mar rdzogs ba gyur te byed ba grub ba ye shes zhes ba de la byed ba yin no 
BO_TZ_LAMRIM-YISHE-NYINGPO-P2:6277	nyon mongs pa'i rtog pa dang por ngos zin dka'/	627	nyon mongs ba rtogs ba dang por ngos zin 
BO_TZ_LAMRIM-YISHE-NYINGPO-P2:6278	bar du ldog dka'/	627	ba du ldog 
BO_TZ_LAMRIM-YISHE-NYINGPO-P2:6279	mthar rgyun bcad par dka' bas dran shes kyi bya ras bzung nas ji skad bstan pa de ltar rang grol chen po'i dbyings su la zlo shes na dug lnga'i rtog pa mi shar ba ni mi srid la shar tshhad kun spang sgyur gang yang ma dgongs par ye	627	mthar rgyun gcod ba dka ba dran shes kyi byed ras bzung nas ji skad ston ba de ltar rang grol chen po dbyings su la zlo shes na dug lnga rtogs ba mi char ba ni mi srid la char tshhad kun spong sgyur gang yang ma dgongs ba ye 
BO_TZ_LAMRIM-YISHE-NYINGPO-P2:6280	shes lnga'i ngo bor bogs su thon cing /	628	shes lnga ngo bor bogs su thon cing 
BO_TZ_LAMRIM-YISHE-NYINGPO-P2:6281	'dod chags zhe sdang gti mug gsum dang de gsum cha mnyam las byung ba re rer yang nyi khri chig stong re ste bsdoms pas nyon mongs rtog pa'i phung po brgyad khri bzhi stong du grags pa ji snyed pa'ang sbrul mdud dkrol ba po med par rang grol	628	dod chags zhe sdang gti mug gsum dang de gsum cha mnyam las byung ba re rer yang nyi khri chig stong re ste sdom ba nyon mongs rtogs ba phung po brgyad khri bzhi stong du grags ba ji snyed ba sbrul mdud khrol ba po med ba rang grol 
BO_TZ_LAMRIM-YISHE-NYINGPO-P2:6282	ba bzhin du ye shes chen por rang sar grol bar 'gyur te /	628	ba bzhin du ye shes chen por rang sar grol ba gyur te 
BO_TZ_LAMRIM-YISHE-NYINGPO-P2:6283	zhi rgyud las /	628	zhi brgyud las 
BO_TZ_LAMRIM-YISHE-NYINGPO-P2:6284	rang bzhin shes pas mi spang ste //	628	rang bzhin shes ba mi spong ste 
BO_TZ_LAMRIM-YISHE-NYINGPO-P2:6285	rang rig ye shes nyid yin no //	628	rang rig ye shes nyid yin no 
BO_TZ_LAMRIM-YISHE-NYINGPO-P2:6286	zhes dang / mu tig phreng bar /	628	zhes dang mu tig phreng ba 
BO_TZ_LAMRIM-YISHE-NYINGPO-P2:6287	'bad pas grol ba ma yin te //	628	bad ba grol ba ma yin te 
BO_TZ_LAMRIM-YISHE-NYINGPO-P2:6288	ye nyid nas ni grol bar gnas //	628	ye nyid nas ni grol ba gnas 
BO_TZ_LAMRIM-YISHE-NYINGPO-P2:6289	zhes so // spyir nyon mongs pa shar ma thag tu gdong zlog byas na bya shor du 'gro bas rtshal rdzogs su gzhug	628	zhes so spyir nyon mongs ba char ma thag tu gdong zlog byed na byed chor du gro ba rtshal rdzogs su jug 
BO_TZ_LAMRIM-YISHE-NYINGPO-P2:6290	/rtshal rdzogs las ma bsags pa'i skad cig de ma thag par lam du btang bas ye shes su lhag gis shar pa'i dus na rten 'brel bsgrigs dgos shing /	629	rdzogs las ma bsags ba skad cig de ma thag ba lam du gtong ba ye shes su lhag gis char ba dus na rten brel sgrig dgos shing 
BO_TZ_LAMRIM-YISHE-NYINGPO-P2:6291	de nyid ye shes kyi gzhir med na lam du mi 'gro ba dwangs pa'i bzhin snod med na bzhin ras mi 'char ba dang mtshhungs la /	629	de nyid ye shes kyi gzhir med na lam du mi gro ba dwangs ba bzhin snod med na bzhin ras mi char ba dang mtshhungs la 
BO_TZ_LAMRIM-YISHE-NYINGPO-P2:6292	nyon mongs pa gang skyes de rtshal rdzogs shing las ma bsags /	629	nyon mongs ba gang skye de rtshal rdzogs shing las ma bsags 
BO_TZ_LAMRIM-YISHE-NYINGPO-P2:6293	ngo bo ye shes su shes pa'i skad cig de nyid la rtog pa gzhan gyis bar ma chod par lam du btang pa ni grub pa'i dngul chus lcags gser du bsgyur ba bzhin no //	629	ngo bo ye shes su shes ba skad cig de nyid la rtogs ba gzhan gyis ba ma chod ba lam du gtong ba ni grub ba dngul chus lcags gser du sgyur ba bzhin no 
BO_TZ_LAMRIM-YISHE-NYINGPO-P2:6294	gsum pa ni /	629	gsum ba ni 
BO_TZ_LAMRIM-YISHE-NYINGPO-P2:6295	mdor na nas /	629	mdor na nas 
BO_TZ_LAMRIM-YISHE-NYINGPO-P2:6296	bogs su 'char :	629	bogs su char 
BO_TZ_LAMRIM-YISHE-NYINGPO-P2:6297	zhes gsungs te /	629	zhes gsungs te 
BO_TZ_LAMRIM-YISHE-NYINGPO-P2:6298	ji skad bshad pa de dag gi don mdor bsdu na /	629	ji skad chad ba de dag gi don mdor sdud na 
BO_TZ_LAMRIM-YISHE-NYINGPO-P2:6299	sems dang sems las byung ba'i rnam rtog	629	sems dang sems las byung ba rnam rtogs 
BO_TZ_LAMRIM-YISHE-NYINGPO-P2:6300	/dug lngas bsdus pa'i nyon mongs pa /	630	lngas sdud ba nyon mongs ba 
BO_TZ_LAMRIM-YISHE-NYINGPO-P2:6301	lha mthong zhing dad gus sogs bzang rtog	630	lha mthong zhing dad gus sogs bzang rtogs 
BO_TZ_LAMRIM-YISHE-NYINGPO-P2:6302	/'drer snang zhing nyams mi dga' ba sogs ngan rtog	630	snang zhing nyams mi dga ba sogs ngan rtogs 
BO_TZ_LAMRIM-YISHE-NYINGPO-P2:6303	/lus sems la sdug bsngal tshhor ba /	630	sems la sdug sngal tshhor ba 
BO_TZ_LAMRIM-YISHE-NYINGPO-P2:6304	na ba dang 'chi ba sogs bzang du re zhing ngan par dogs pa ci dang ci lta bu byung yang spang blang khu 'phrig gi snyems rtog rdul tsham med par rtog pa de ka rang gi ngo bor bltas te bzang ngan ro snyoms shing /	630	na ba dang chi ba sogs bzang du re zhing ngan ba dogs ba ci dang ci lta bu byung yang spong blang khu phrig gi snyems rtogs rdul tsham med ba rtogs ba de ka rang gi ngo bor lta te bzang ngan ro snyom shing 
BO_TZ_LAMRIM-YISHE-NYINGPO-P2:6305	de ka tsham du'ang ma lus par rang rig gi rtshal sbyong phyogs med du byas pas rnam rtog gi 'phro 'du kun kyang skyon skyed pa'i gegs su mi 'gyur bar yon tan lhag par 'phel ba'i bogs 'don du 'char bar 'gyur te /	630	de ka tsham du ma lus ba rang rig gi rtshal sbyong phyogs med du byed ba rnam rtogs gi phro du kun kyang skyon skyed ba gegs su mi gyur ba yon tan lhag ba phel ba bogs don du char ba gyur te 
BO_TZ_LAMRIM-YISHE-NYINGPO-P2:6306	ting 'dzin rgyal po las /	630	ting dzin rgyal po las 
BO_TZ_LAMRIM-YISHE-NYINGPO-P2:6307	rnam rtog ma rig chen po ste //	630	rnam rtogs ma rig chen po ste 
BO_TZ_LAMRIM-YISHE-NYINGPO-P2:6308	'khor ba'i rgya mtshhor ltung byed yin //	630	khor ba rgya mtshhor ltung byed yin 
BO_TZ_LAMRIM-YISHE-NYINGPO-P2:6309	rtog med ting 'dzin la gnas na //	630	rtogs med ting dzin la gnas na 
BO_TZ_LAMRIM-YISHE-NYINGPO-P2:6310	nam mkha' bzhin du mi rtog gsal //	631	nam mkha bzhin du mi rtogs gsal 
BO_TZ_LAMRIM-YISHE-NYINGPO-P2:6311	zhes so // gnyis pa thod rgal gyi bogs 'don ni /	631	zhes so gnyis ba thod rgal gyi bogs don ni 
BO_TZ_LAMRIM-YISHE-NYINGPO-P2:6312	khyad par nas mchog la sbyor :	631	khyad ba nas mchog la sbyor 
BO_TZ_LAMRIM-YISHE-NYINGPO-P2:6313	zhes gsungs te /	631	zhes gsungs te 
BO_TZ_LAMRIM-YISHE-NYINGPO-P2:6314	thod rgal lhun grub kyi rnal 'byor la gnas pa'i skabs su spyi gnad rnams dkyus ltar la /	631	thod rgal lhun grub kyi rnal byor la gnas ba skabs su spyi gnad rnams dkyu ltar la 
BO_TZ_LAMRIM-YISHE-NYINGPO-P2:6315	khyad par 'od gsal snang ba'i bogs 'don du thog mar khra khang dang de nas mun khang sgo khyud rim pa gsum par sgo gsum byed pa bcings pa'i gnad dang ldan pas mun pa'i rnal 'byor gyis zhag bdun phrag gsum la sogs par bsgoms pas nyin mtshhan rtags	631	khyad ba d gsal snang ba bogs don du thogs mar khra khang dang de nas mun khang sgo khyud rim ba gsum ba sgo gsum byed ba ching ba gnad dang ldan ba mun ba rnal byor gyis zhag bdun phrag gsum la sogs ba sgom ba nyin mtshhan rtags 
BO_TZ_LAMRIM-YISHE-NYINGPO-P2:6316	bcu dang 'od gsal gyi snang ba stong pa'i gzugs brnyan rnam pa thams cad pa rab tu gsal zhing 'phel 'grib bral pa'i brtan por 'gyur la /	631	chu dang d gsal gyi snang ba stong ba gzugs rnyan rnam ba thams cad ba rab tu gsal zhing phel grib bral ba brtan por gyur la 
BO_TZ_LAMRIM-YISHE-NYINGPO-P2:6317	skabs su rdo rje'i bzlas pa dang bum pa can gyi sbyor bas srog dang rtshol ba'i rlung 'khor lo bzhi'i lte bar rtags snang dang lhan cig g.yo med du 'ching ba dang / 'bar 'dzag gi zhu bde drangs shing bde gsal gyi nyams rtogs kun kyang gnyis med ro mnyam khyab brdal chen po'i ngang du 'pho med mi 'gyur ba'i thabs kyis bde ba chen po mchog la sbyor ro //	631	skabs su rdo rje bzlas ba dang bum ba can gyi sbyor ba srog dang rtshol ba rlung khor lo bzhi lte ba rtags snang dang lhan cig g.yo med du ching ba dang bar dzag gi ju bde drangs shing bde gsal gyi nyams rtogs kun kyang gnyis med ro mnyam khyab rdal chen po ngang du pho med mi gyur ba thabs kyis bde ba chen po mchog la sbyor ro 
BO_TZ_LAMRIM-YISHE-NYINGPO-P2:6318	'di ni gsang sngags gsar ma'i lugs kyi bla med rgyud sde thams cad kyi rgyal po dpal dus kyi 'khor lo'i rdzogs rim sbyor ba yan lag drug pa dang bsnyen sgrub rdo rje gsum gyi gnad thams cad kyang 'dus pa ste /	631	di ni gsang sngags gsar ma lugs kyi bla med brgyud sde thams cad kyi rgyal po dpal dus kyi khor lo rdzogs rim sbyor ba yan lag drug ba dang snyen sgrub rdo rje gsum gyi gnad thams cad kyang du ba ste 
BO_TZ_LAMRIM-YISHE-NYINGPO-P2:6319	byed bcings mun pa'i rnal 'byor rtags snang dang bcas pa ni thog mar dge bas sor bsam sku rdo rje /	631	byed ching mun ba rnal byor rtags snang dang cha ba ni thogs mar dge ba sor bsam sku rdo rje 
BO_TZ_LAMRIM-YISHE-NYINGPO-P2:6320	srog rtshol rlung gi sbyor ba ni bar du dge ba srog 'dzin gsung rdo rje /	632	srog rtshol rlung gi sbyor ba ni ba du dge ba srog dzin gsung rdo rje 
BO_TZ_LAMRIM-YISHE-NYINGPO-P2:6321	zhu bde 'gyur med du bsgrub pa ni mthar dge dran ting thugs rdo rje'i rnal 'byor rnams dang don gcig pa'o //	632	ju bde gyur med du sgrub ba ni mthar dge dran ting thugs rdo rje rnal byor rnams dang don gcig ba 
BO_TZ_LAMRIM-YISHE-NYINGPO-P2:6322	gsum pa de dag thams cad kyi don bsdus te bshad pa ni /	632	gsum ba de dag thams cad kyi don sdud te chad ba ni 
BO_TZ_LAMRIM-YISHE-NYINGPO-P2:6323	gzhan yang na /	632	gzhan yang na 
BO_TZ_LAMRIM-YISHE-NYINGPO-P2:6324	'brel bas 'grub :	632	brel ba grub 
BO_TZ_LAMRIM-YISHE-NYINGPO-P2:6325	ces gsungs te /	632	ces gsungs te 
BO_TZ_LAMRIM-YISHE-NYINGPO-P2:6326	bye brag tu bstan pa de dag las gzhan yang lam gyi rnal 'byor thun mong spyi la gal che ba gnad kyi man ngag zab mo nying khur phyungs nas bstan pa ni /	632	bye brag tu ston ba de dag las gzhan yang lam gyi rnal byor thun mong spyi la gal che ba gnad kyi man ngag zab mo nying khur phyungs nas ston ba ni 
BO_TZ_LAMRIM-YISHE-NYINGPO-P2:6327	'jig rten na nyes pa'i skyon ci yod pa de rnams thams cad ni gzhan las ma byung ste bdag tu 'dzin pa 'di kho na las byung bas /	632	jig rten na nyes ba skyon ci yod ba de rnams thams cad ni gzhan las ma byung ste bdag tu dzin ba di kho na las byung ba 
BO_TZ_LAMRIM-YISHE-NYINGPO-P2:6328	kun rdzob byang chub kyi sems byams pa dang snying rje tshhad med pa la brten pa bdag gzhan brje ba'i blo sbyong sogs kyis bdag tu gces par 'dzin pa'i blo bshig	632	kun rdzob byang chub kyi sems byams ba dang snying rje tshhad med ba la rten ba bdag gzhan rje ba blo sbyong sogs kyis bdag tu gces ba dzin ba blo jig 
BO_TZ_LAMRIM-YISHE-NYINGPO-P2:6329	/don dam byang chub sems bdag gzhan tu rtog pas sogs gnyis chos kyi spros pa kun bral zab mo stong nyid kyi lta bas bdag lta'i ngo bo'ang chos kyi dbyings su bcom ste drung ngam rtsha ba nas phyung /	632	dam byang chub sems bdag gzhan tu rtogs ba sogs gnyis chos kyi spros ba kun bral zab mo stong nyid kyi lta ba bdag lta ngo bo chos kyi dbyings su joms ste drung ngam rtsha ba nas byin 
BO_TZ_LAMRIM-YISHE-NYINGPO-P2:6330	'khor 'das lam gsum gyi chos thams cad la kun rdzob don dam gyi bden pa gnyis po ltos 'jog can du grub pas ya bral du ma song par de gnyis dbyer med du spyod pa'i rten 'brel lam du khyer /	633	khor da lam gsum gyi chos thams cad la kun rdzob don dam gyi bden ba gnyis po ltos jog can du grub ba ya bral du ma gro ba de gnyis dbyer med du spyod ba rten brel lam du khyer 
BO_TZ_LAMRIM-YISHE-NYINGPO-P2:6331	'phral yun yon tan gang yang rung ba thams cad chos nyams su blangs pa las byung ba'i phyir theg chen nyams len thams cad kyi rtsha ba nam mkha' dang mnyam pa'i pha ma 'gro drug sems can ris su ma chad pa kun la tshhad dang mu mtha' med	633	phral yun yon tan gang yang rung ba thams cad chos nyams su blangs ba las byung ba phyir theg chen nyams len thams cad kyi rtsha ba nam mkha dang mnyam ba pha ma gro drug sems can ris su ma chad ba kun la tshhad dang mu mtha med 
BO_TZ_LAMRIM-YISHE-NYINGPO-P2:6332	pa'i snying rje dus rtag tu bsgom /	633	ba snying rje dus rtag tu bsgom 
BO_TZ_LAMRIM-YISHE-NYINGPO-P2:6333	byin rlabs dngos grub kyi 'byung gnas dpal ldan rtsha ba'i bla ma nyid dkon mchog kun 'dus su shes pas bzod med kyi mos gus drag po bskyed /	633	byin rlabs dngos grub kyi byung gnas dpal ldan rtsha ba bla ma nyid dkon(d) mchog kun du su shes ba bzod med kyi mos gus drag po skyed 
BO_TZ_LAMRIM-YISHE-NYINGPO-P2:6334	'jig rten pas bsdus pa zag bcas bsod nams kyi tshhogs dang 'jig rten las 'das pas bsdus pa zag med ye shes kyi dge tshhogs phra mos mi ngoms par gong nas gong 'phel brtshon pa chen pos bsgrub /	633	jig rten ba sdud ba zag cha bsod nams kyi tshhogs dang jig rten las da ba sdud ba zag med ye shes kyi dge tshhogs phra mos mi ngoms ba gong nas gong phel brtshon ba chen pos sgrub 
BO_TZ_LAMRIM-YISHE-NYINGPO-P2:6335	dmigs bcas kyi nyams len kun las khyad par du gyur pa sems nyid rig stong rjen pa lam du khyer la mnyam rjes spyod lam gang gi skabs su'ang skad cig tsham yang phyi yul snang la ma yengs shing nang sems kyis gang yang mi bsgom pas /	633	dmigs cha kyi nyams len kun las khyad ba du gyur ba sems nyid rig stong rjen ba lam du khyer la mnyam rjes spyod lam gang gi skabs su skad cig tsham yang phyi yul snang la ma yengs shing nang sems kyis gang yang mi bsgom ba 
BO_TZ_LAMRIM-YISHE-NYINGPO-P2:6336	snang phyogs thabs dang stong phyogs shes rab phyogs rer zhen cing a 'thas pa'i lam la ma gol bar thams snying rje chen pos kun nas bslangs te sbyin sogs bsod nams kyi tshhogs sgrub pa'i bogs su shes rab stong pa nyid kyi lta ba'i gdeng bskyed cing /	633	snang phyogs thabs dang stong phyogs shes rab phyogs rer zhen cing a thas ba lam la ma gol ba thams snying rje chen pos kun nas bslangs te sbyin sogs bsod nams kyi tshhogs sgrub ba bogs su shes rab stong ba nyid kyi lta ba gdeng skyed cing 
BO_TZ_LAMRIM-YISHE-NYINGPO-P2:6337	shes rab stong nyid kyi gnas lugs ji bzhin rtogs pa'i grogs su gong du bstan pa'i snying rje mos gus sogs thabs kyi mchog dang bsod nams sna tshhogs pa nyin re bzhin gong du spel bar bya dgos te /	633	shes rab stong nyid kyi gnas lugs ji bzhin rtogs ba grogs su gong du ston ba snying rje mos gus sogs thabs kyi mchog dang bsod nams sna tshhogs ba nyin re bzhin gong du spel ba byed dgos te 
BO_TZ_LAMRIM-YISHE-NYINGPO-P2:6338	rgyud las / rnal 'byor thabs kyi tshhul min zhing //	633	brgyud las rnal byor thabs kyi tshhul min zhing 
BO_TZ_LAMRIM-YISHE-NYINGPO-P2:6339	shes rab gcig pus 'gyur ba min //	633	shes rab gcig pus gyur ba min 
BO_TZ_LAMRIM-YISHE-NYINGPO-P2:6340	thabs dang shes rab snyoms 'jug pa //	634	thabs dang shes rab snyom jug ba 
BO_TZ_LAMRIM-YISHE-NYINGPO-P2:6341	rnal 'byor de bzhin gshegs pas gsungs //	634	rnal byor de bzhin gshegs ba gsungs 
BO_TZ_LAMRIM-YISHE-NYINGPO-P2:6342	zhes dang / lam sgron las kyang /	634	zhes dang lam sgron las kyang 
BO_TZ_LAMRIM-YISHE-NYINGPO-P2:6343	shes rab bral ba'i thabs dag dang // thabs dang bral ba'i shes rab kyis //	634	shes rab bral ba thabs dag dang thabs dang bral ba shes rab kyis 
BO_TZ_LAMRIM-YISHE-NYINGPO-P2:6344	gang phyir 'ching ba zhes gsungs pas //	634	gang phyir ching ba zhes gsungs ba 
BO_TZ_LAMRIM-YISHE-NYINGPO-P2:6345	de bas gnyis ka spang mi bya //	634	de ba gnyis ka spong mi byed 
BO_TZ_LAMRIM-YISHE-NYINGPO-P2:6346	zhes so // de ltar na thabs kyis shes rab sgrib pa dang shes rab kyis thabs khyad du gsod pa ma yin par gnyis ka 'gal med zung 'jug tu lam du khyer ba de yis nyams dang rtogs pa'i yon tan mtha' dag dbyar gyi mtshho bzhin gong nas gong du 'phel	634	zhes so de ltar na thabs kyis shes rab sgrib ba dang shes rab kyis thabs khyad du gsod ba ma yin ba gnyis ka gal med zung jug tu lam du khyer ba de yis nyams dang rtogs ba yon tan mtha dag dbyar gyi mtshho bzhin gong nas gong du phel 
BO_TZ_LAMRIM-YISHE-NYINGPO-P2:6347	ba dang / sa bcu dang lam lnga'i rim pa ma lus pa kun kyang thabs dang shes rab zung du 'brel bas bde blag tu bgrod cing mthar son par 'gyur te /	634	ba dang sa chu dang lam lnga rim ba ma lus ba kun kyang thabs dang shes rab zung du brel ba bde blag tu bgrod cing mthar son ba gyur te 
BO_TZ_LAMRIM-YISHE-NYINGPO-P2:6348	sdom 'byung las /	634	sdom byung las 
BO_TZ_LAMRIM-YISHE-NYINGPO-P2:6349	shes rab thabs ni mnyam sbyor bas //	634	shes rab thabs ni mnyam sbyor ba 
BO_TZ_LAMRIM-YISHE-NYINGPO-P2:6350	rdzogs pa'i byang chub sgrub byed pa //	635	rdzogs ba byang chub sgrub byed ba 
BO_TZ_LAMRIM-YISHE-NYINGPO-P2:6351	de nyid la ni bla med pa'i //	635	de nyid la ni bla med ba 
BO_TZ_LAMRIM-YISHE-NYINGPO-P2:6352	sangs rgyas kun rnams rab tu bzhugs //	635	sangs rgya kun rnams rab tu bzhugs 
BO_TZ_LAMRIM-YISHE-NYINGPO-P2:6353	dbyer med rnam par yang dag rig	635	dbyer med rnam ba yang dag rig 
BO_TZ_LAMRIM-YISHE-NYINGPO-P2:6354	/gang gi gnas pa rdo rje sems //	635	gi gnas ba rdo rje sems 
BO_TZ_LAMRIM-YISHE-NYINGPO-P2:6355	ji srid rdzogs byang chub par 'gyur //	635	ji srid rdzogs byang chub ba gyur 
BO_TZ_LAMRIM-YISHE-NYINGPO-P2:6356	zhaces so // bogs 'don gyi rim pa 'di rnams kyang rig 'dzin chen po dga' rab rdo rje'i bsam gtan nyams sgron las /	635	zhaces so bogs don gyi rim ba di rnams kyang rig dzin chen po dga rab rdo rje bsam gtan nyams sgron las 
BO_TZ_LAMRIM-YISHE-NYINGPO-P2:6357	lung zab bla ma nyams can sngun //	635	lung zab bla ma nyams can sngun 
BO_TZ_LAMRIM-YISHE-NYINGPO-P2:6358	blta dang lta 'bul nyams bsdur dang // mi rtag 'chi bsam brtshon 'grus bskyed //	635	lta dang lta bul nyams sdur dang mi rtag chi bsam brtshon grus skyed 
BO_TZ_LAMRIM-YISHE-NYINGPO-P2:6359	gnas lugs dran pa'i rtshis zin pas //	635	gnas lugs dran ba rtshis zin ba 
BO_TZ_LAMRIM-YISHE-NYINGPO-P2:6360	gsang spyod thabs la bsten pa dang // lung dang bde ba'i man ngag dang // dmigs med snying rje goms pa dang // gdams pa'i gnad dang shes rab kyis //	636	gsang spyod thabs la sten ba dang lung dang bde ba man ngag dang dmigs med snying rje goms ba dang doms ba gnad dang shes rab kyis 
BO_TZ_LAMRIM-YISHE-NYINGPO-P2:6361	rig pa rtshal sbyong nyams bogs 'don //	636	rig ba rtshal sbyong nyams bogs don 
BO_TZ_LAMRIM-YISHE-NYINGPO-P2:6362	ces gsungs pa sogs kyi don rnams snying por dril ba'o //	636	ces gsungs ba sogs kyi don rnams snying por dril ba 
BO_TZ_LAMRIM-YISHE-NYINGPO-P2:6363	gsum pa gang du mthar phyin pa'i 'bras bu bshad pa la gnyis /	636	gsum ba gang du mthar phyin ba bras bu chad ba la gnyis 
BO_TZ_LAMRIM-YISHE-NYINGPO-P2:6364	mdor bstan / rgyas bshad do //	636	mdor ston rgya chad do 
BO_TZ_LAMRIM-YISHE-NYINGPO-P2:6365	dang po ni /	636	dang po ni 
BO_TZ_LAMRIM-YISHE-NYINGPO-P2:6366	sbyangs pa'i 'bras bu sogs tshhig rkang gcig ste /	636	sbyong ba bras bu sogs tshhig rkang gcig ste 
BO_TZ_LAMRIM-YISHE-NYINGPO-P2:6367	de ltar sbyang gzhi kun khyab bde gshegs snying po la brten pa'i sbyang bya glo bur gyi dri ma sbyong byed rim gnyis lam gyis tshhul bzhin sbyangs pa'i 'bras bu gzhi ji lta ba bzhin mngon du gyur pas spang thob med pa'i sku dang ye shes kyi dkyil	636	de ltar sbyong gzhi kun khyab bde gshegs snying po la rten ba sbyong byed glo bur gyi dri ma sbyong byed rim gnyis lam gyis tshhul bzhin sbyong ba bras bu gzhi ji lta ba bzhin mngon du gyur ba spong thob med ba sku dang ye shes kyi dkyil 
BO_TZ_LAMRIM-YISHE-NYINGPO-P2:6368	'khor chen por rang snang ba'i tshhul ni 'di lta ste /	636	khor chen por rang snang ba tshhul ni di lta ste 
BO_TZ_LAMRIM-YISHE-NYINGPO-P2:6369	zhes so // de la 'bras bu'i ngo bo bshad ma thag pa nyid de /	636	zhes so de la bras bu ngo bo chad ma thag ba nyid de 
BO_TZ_LAMRIM-YISHE-NYINGPO-P2:6370	sgyu 'phral bye brag bstan pa las //	637	sgyu phral bye brag ston ba las 
BO_TZ_LAMRIM-YISHE-NYINGPO-P2:6371	grub pa'i rnal 'byor rnal 'byor che //	637	grub ba rnal byor rnal byor che 
BO_TZ_LAMRIM-YISHE-NYINGPO-P2:6372	lhun grub ji bzhin mngon byas pa'ang //	637	lhun grub ji bzhin mngon byed ba 
BO_TZ_LAMRIM-YISHE-NYINGPO-P2:6373	brtags pa tsham ste gnyis pa med //	637	rtog ba tsham ste gnyis ba med 
BO_TZ_LAMRIM-YISHE-NYINGPO-P2:6374	de phyir de la de brjod do //	637	de phyir de la de rjod do 
BO_TZ_LAMRIM-YISHE-NYINGPO-P2:6375	zhes so // nges tshhig khog gzhung las /	637	zhes so nges tshhig khog gzhung las 
BO_TZ_LAMRIM-YISHE-NYINGPO-P2:6376	grub pa mthar phyin 'bras bur brjod //	637	grub ba mthar phyin bras bur rjod 
BO_TZ_LAMRIM-YISHE-NYINGPO-P2:6377	ces pa ltar /	637	ces ba ltar 
BO_TZ_LAMRIM-YISHE-NYINGPO-P2:6378	rnal 'byor pas don du gnyer nas bsgrub par bya ba mchog gi grub pa mthar phyin pas 'bras bu zhes brjod pa dang / dbye ba snga ma las /	637	rnal byor ba don du gnyer nas sgrub ba byed ba mchog gi grub ba mthar phyin ba bras bu zhes rjod ba dang byed ba snga ma las 
BO_TZ_LAMRIM-YISHE-NYINGPO-P2:6379	'bras bu'i ngo bo sku gsung thugs //	637	bras bu ngo bo sku gsung thugs 
BO_TZ_LAMRIM-YISHE-NYINGPO-P2:6380	yon tan phrin las rnam pa lnga //	638	yon tan phrin las rnam ba lnga 
BO_TZ_LAMRIM-YISHE-NYINGPO-P2:6381	de yang skabs kyis lnga lnga ste //	638	de yang skabs kyis lnga lnga ste 
BO_TZ_LAMRIM-YISHE-NYINGPO-P2:6382	zhes sku gsung thugs yon tan phrin las lnga dang re re la'ang lnga lnga ste 'bras chos nyer lnga'i bdag nyid 'chad par 'gyur ba ltar ro //	638	zhes sku gsung thugs yon tan phrin las lnga dang re re la lnga lnga ste bras chos nyer lnga bdag nyid chad ba gyur ba ltar ro 
BO_TZ_LAMRIM-YISHE-NYINGPO-P2:6383	gnyis pa ni /	638	gnyis ba ni 
BO_TZ_LAMRIM-YISHE-NYINGPO-P2:6384	rang don nas ngang gis 'byung :	638	rang don nas ngang gis byung 
BO_TZ_LAMRIM-YISHE-NYINGPO-P2:6385	zhes gsungs te /	638	zhes gsungs te 
BO_TZ_LAMRIM-YISHE-NYINGPO-P2:6386	'di la lnga /	638	di la lnga 
BO_TZ_LAMRIM-YISHE-NYINGPO-P2:6387	sangs rgyas kun gyi che ba'i yon tan gyi rten byed pa'i cha nas sku dang / gdul bya la chos don brda sprod pas gsung dang / brten pa snying po mi g.yo bas thugs dang / dgos 'dod thams cad 'byung bas yon tan dang / gzhan don mdzad pas phrin las so //	638	sangs rgya kun gyi che ba yon tan gyi rten byed ba cha nas sku dang gdul byed la chos don brda sprod ba gsung dang rten ba snying po mi g.yo ba thugs dang dgos dod thams cad byung ba yon tan dang gzhan don mdzad ba phrin las so 
BO_TZ_LAMRIM-YISHE-NYINGPO-P2:6388	dang po ni /	638	dang po ni 
BO_TZ_LAMRIM-YISHE-NYINGPO-P2:6389	spangs pa dang rtogs pa chen pos rang don mthar phyin pa'i ngo bo dbyings thog tu rig pa'i ye shes grol bas spros pa thams cad nye bar zhi ba ni chos kyi sku /	638	spong ba dang rtogs ba chen pos rang don mthar phyin ba ngo bo dbyings thogs tu rig ba ye shes grol ba spros ba thams cad nye ba zhi ba ni chos kyi sku 
BO_TZ_LAMRIM-YISHE-NYINGPO-P2:6390	snying rje'i sems chen pos gzhan don lhun gyis grub pa'i rang bzhin chos kyi sku las ma g.yos bzhin du dag pa'i gdul bya rgyal sras sa bcu pa'i ngor snang stong zung 'jug thun min rgyu 'bras kyi mtshhan dpe dang ldan par snang ba ni longs spyod rdzogs	639	snying rje sems chen pos gzhan don lhun gyis grub ba rang bzhin chos kyi sku las ma g.yos bzhin du dag ba gdul byed rgyal sras sa chu ba ngor snang stong zung jug thun min rgyu bras kyi mtshhan dpe dang ldan ba snang ba ni longs spyod rdzogs 
BO_TZ_LAMRIM-YISHE-NYINGPO-P2:6391	pa'i sku / ma dag pa'i gdul bya 'gro ba drug gi mos pa dang mthun par gang gis 'dul ba der ston gyi thabs la mkhas pa'i thugs rje'i rol pas ma nges sna tshhogs sprul pa'i tshhul bzo skye mchog sogs snang ba ni sprul pa'i sku /	639	ba sku ma dag ba gdul byed gro ba drug gi mos ba dang mthun ba gang gis dul ba der ston gyi thabs la mkhas ba thugs rje rol ba ma nges sna tshhogs sprul ba tshhul bzo skye mchog sogs snang ba ni sprul ba sku 
BO_TZ_LAMRIM-YISHE-NYINGPO-P2:6392	gsum po de dag gdul bya so so'i skal ba dang mthun par snang ba'i cha so sor ma 'dres par ston pa'i yon tan stobs bcu /	639	gsum po de dag gdul byed so so skal ba dang mthun ba snang ba cha so sor ma dre ba ston ba yon tan stobs chu 
BO_TZ_LAMRIM-YISHE-NYINGPO-P2:6393	mi 'jigs pa bzhi /	639	mi jigs ba bzhi 
BO_TZ_LAMRIM-YISHE-NYINGPO-P2:6394	ma 'dres pa bco brgyad /	639	ma dre ba chos brgyad 
BO_TZ_LAMRIM-YISHE-NYINGPO-P2:6395	byang phyogs kyi chos so bdun gyis mtshhon mkhyen brtshe nus pa'i yon tan bsam gyis mi khyab pa mnga' ba'i cha nas mngon par byang chub pa'i sku /	639	byang phyogs kyi chos so bdun gyis mtshhon mkhyen brtshe nus ba yon tan bsam gyis mi khyab ba mnga ba cha nas mngon ba byang chub ba sku 
BO_TZ_LAMRIM-YISHE-NYINGPO-P2:6396	don dam par gzugs sku gnyis po'ang tha dad rang rgyud par med cing dag pa gnyis ldan stong pa'i cha chos nyid 'od gsal 'pho 'gyur med pa'i dbyings su sku gsum dbyer med ro gcig pa ni mi 'gyur rdo rje'i sku'o //	639	don dam ba gzugs sku gnyis po tha dad rang brgyud ba med cing dag ba gnyis ldan stong ba cha chos nyid d gsal pho gyur med ba dbyings su sku gsum dbyer med ro gcig ba ni mi gyur rdo rje sku 
BO_TZ_LAMRIM-YISHE-NYINGPO-P2:6397	gnyis pa ni /	639	gnyis ba ni 
BO_TZ_LAMRIM-YISHE-NYINGPO-P2:6398	de ltar sku lnga thob nas so so'i gsung lnga pos 'khor la brda sprod cing don mtshhon par byed pa ste /	639	de ltar sku lnga thob nas so so gsung lnga pos khor la brda sprod cing don mtshhon ba byed ba ste 
BO_TZ_LAMRIM-YISHE-NYINGPO-P2:6399	de'ang chos nyid smra brjod dang bral ba'i rnam par dag pa'i ye shes nyid bsam brjod thams cad kyi gzhir gyur pa'i cha ni chos sku skye med don gyi gsung /	639	de chos nyid smra rjod dang bral ba rnam ba dag ba ye shes nyid bsam rjod thams cad kyi gzhir gyur ba cha ni chos sku skye med don gyi gsung 
BO_TZ_LAMRIM-YISHE-NYINGPO-P2:6400	me long gis byad kyi dri ma ngos zin nas sel bar byed pa ltar sku mthong ba de yis 'khor gyi blo la don gyi brda 'phrod pa'i ye shes mtshhon pa ni longs sku dgongs pa brda'i gsung /	640	me long gis byad kyi dri ma ngos zin nas sel ba byed ba ltar sku mthong ba de yis khor gyi blo la don gyi brda phrod ba ye shes mtshhon ba ni longs sku dgongs ba brda gsung 
BO_TZ_LAMRIM-YISHE-NYINGPO-P2:6401	tshhangs pa'i gsung dbyangs yan lag drug cu dang ldan pas gdul bya gang la gang 'dul gyi ngor so so'i sgra skad dang mthun par dus gcig tu tshhig res don re go ba ni sprul sku brjod pa tshhig gi gsung /	640	tshhangs ba gsung dbyangs yan lag drug cu dang ldan ba gdul byed gang la gang dul gyi ngor so so sgra skad dang mthun ba dus gcig tu tshhig res don re go ba ni sprul sku rjod ba tshhig gi gsung 
BO_TZ_LAMRIM-YISHE-NYINGPO-P2:6402	don du tshhig gcig ma gsungs kyang rigs drug so so'i sgra skad dang mos pa ji lta de ltar snang zhing de thams cad kyang rang rig par gsal la cir yang mi 'gag pa'i ye shes ni mngon byang rig pa'i gsung /	640	don du tshhig gcig ma gsungs kyang rigs drug so so sgra skad dang mos ba ji lta de ltar snang zhing de thams cad kyang rang rig ba gsal la cir yang mi gag ba ye shes ni mngon byang rig ba gsung 
BO_TZ_LAMRIM-YISHE-NYINGPO-P2:6403	sgra skad thams cad grags stong gnyis su med pas mtha' gnyis grol bar go brda 'phrod pa'i ye shes ni rdo rje'i gsung ste /	640	sgra skad thams cad grags stong gnyis su med ba mtha gnyis grol ba go brda phrod ba ye shes ni rdo rje gsung ste 
BO_TZ_LAMRIM-YISHE-NYINGPO-P2:6404	gsung lnga po de rnams ngo bo brda sprod par gcig la brjod tshhul dang rtog pa tha dad pa'o //	640	gsung lnga po de rnams ngo bo brda sprod ba gcig la rjod tshhul dang rtogs ba tha dad ba 
BO_TZ_LAMRIM-YISHE-NYINGPO-P2:6405	gsum pa ni /	640	gsum ba ni 
BO_TZ_LAMRIM-YISHE-NYINGPO-P2:6406	sku lnga'i snying por gyur pa thugs lnga ni brten na ye shes lnga po ste /	640	sku lnga snying por gyur ba thugs lnga ni rten na ye shes lnga po ste 
BO_TZ_LAMRIM-YISHE-NYINGPO-P2:6407	de'ang glo bur gyi sgrib pa mtha' dag ma spangs bral ba'i rang bzhin rtogs pa'i tshhe gzhi don gyi kun gzhi mngon du gyur pa ni cir yang mi dmigs pa chos kyi dbyings kyi ye shes /	640	de glo bur gyi sgrib ba mtha dag ma spong bral ba rang bzhin rtogs ba tshhe gzhi don gyi kun gzhi mngon du gyur ba ni cir yang mi dmigs ba chos kyi dbyings kyi ye shes 
BO_TZ_LAMRIM-YISHE-NYINGPO-P2:6408	de'i tshhe sbyor ba don gyi kun gzhi gnas gyur pa las gsal la mi rtog pas lhag ma gsum gyi 'char gzhir gyur ba ni me long lta bu'i ye shes der shar cing /	640	de tshhe sbyor ba don gyi kun gzhi gnas gyur ba las gsal la mi rtogs ba lhag ma gsum gyi char gzhir gyur ba ni me long lta bu ye shes der char cing 
BO_TZ_LAMRIM-YISHE-NYINGPO-P2:6409	sgo lnga gnas gyur 'gro don mdzad pa la thogs pa med pa bya ba grub pa'i ye shes dang / yid gnas gyur pas shes bya'i yul dus gsum gyi chos thams cad pad+ma'i 'dab ma ltar gsal la ma 'dres par mkhyen pa ni sor rtog ye shes gnyis kyang /	640	sgo lnga gnas gyur gro don mdzad ba la thogs ba med ba byed ba grub ba ye shes dang yid gnas gyur ba shes byed yul dus gsum gyi chos thams cad pad+ma dab ma ltar gsal la ma dre ba mkhyen ba ni sor rtogs ye shes gnyis kyang 
BO_TZ_LAMRIM-YISHE-NYINGPO-P2:6410	nyon yid gnas gyur bzang ngan blang dor med pa mnyam pa nyid kyi ye shes su zlum pa'o //	641	nyon yid gnas gyur bzang ngan blang dor med ba mnyam ba nyid kyi ye shes su zlum ba 
BO_TZ_LAMRIM-YISHE-NYINGPO-P2:6411	de dag las chos dbyings stong pa nyid kyi ye shes ni chos sku rnam par mi rtog pa'i thugs /	641	de dag las chos dbyings stong ba nyid kyi ye shes ni chos sku rnam ba mi rtogs ba thugs 
BO_TZ_LAMRIM-YISHE-NYINGPO-P2:6412	mnyam nyid ye shes ni longs sku mnyam pa chen po'i thugs /	641	mnyam nyid ye shes ni longs sku mnyam ba chen po thugs 
BO_TZ_LAMRIM-YISHE-NYINGPO-P2:6413	bya grub ye shes ni sprul sku 'gro ba sgrol ba'i thugs /	641	byed grub ye shes ni sprul sku gro ba sgrol ba thugs 
BO_TZ_LAMRIM-YISHE-NYINGPO-P2:6414	me long ye shes ni mngon byang ci yang sa ler mkhyen pa'i thugs /	641	me long ye shes ni mngon byang ci yang sa ler mkhyen ba thugs 
BO_TZ_LAMRIM-YISHE-NYINGPO-P2:6415	sor rtog ye shes ni mi phyed rdo rje'i thugs so //	641	sor rtogs ye shes ni mi phyed rdo rje thugs so 
BO_TZ_LAMRIM-YISHE-NYINGPO-P2:6416	bzhi pa ni /	641	bzhi ba ni 
BO_TZ_LAMRIM-YISHE-NYINGPO-P2:6417	sku de rnams kyi yan lag gi chos su gyur pa rnam par dag pa'i zhing khams /	641	sku de rnams kyi yan lag gi chos su gyur ba rnam ba dag ba zhing khams 
BO_TZ_LAMRIM-YISHE-NYINGPO-P2:6418	rgya tshhad bral ba'i gzhal yas khang pa dang / gsal zhing dag pa'i 'od zer /	641	rgya tshhad bral ba jal yas khang ba dang gsal zhing dag ba d zer 
BO_TZ_LAMRIM-YISHE-NYINGPO-P2:6419	khyad par 'phags pa'i gdan khri /	641	khyad ba phag ba gdan khri 
BO_TZ_LAMRIM-YISHE-NYINGPO-P2:6420	dgyes rgur rol pa'i rgyan gyi yon tan rnams rdzogs pa'o //	642	dgyes rgur rol ba rgyan gyi yon tan rnams rdzogs ba 
BO_TZ_LAMRIM-YISHE-NYINGPO-P2:6421	de la cung zad spro na /	642	de la cung zad spro na 
BO_TZ_LAMRIM-YISHE-NYINGPO-P2:6422	chos sku'i zhing khams dbyings rang bzhin gyis rnam par dag pa /	642	chos sku zhing khams dbyings rang bzhin gyis rnam ba dag ba 
BO_TZ_LAMRIM-YISHE-NYINGPO-P2:6423	longs sku'i zhing khams rang gsal lhun grub 'od kyi 'khor lo /	642	longs sku zhing khams rang gsal lhun grub d kyi khor lo 
BO_TZ_LAMRIM-YISHE-NYINGPO-P2:6424	sprul sku'i zhing khams stong gsum mi mjed bye ba phrag brgya /	642	sprul sku zhing khams stong gsum mi mjed bye ba phrag brgya 
BO_TZ_LAMRIM-YISHE-NYINGPO-P2:6425	gzhal yas khang ni chos sku la chos dbyings spros pa dang bral ba /	642	jal yas khang ni chos sku la chos dbyings spros ba dang bral ba 
BO_TZ_LAMRIM-YISHE-NYINGPO-P2:6426	longs sku la lhun grub dbyings kyi snang ba /	642	longs sku la lhun grub dbyings kyi snang ba 
BO_TZ_LAMRIM-YISHE-NYINGPO-P2:6427	sprul sku la ye shes rin po che'i rang bzhin /	642	sprul sku la ye shes rin po che rang bzhin 
BO_TZ_LAMRIM-YISHE-NYINGPO-P2:6428	'od zer la'ang chos sku la ye shes lnga'i 'od zer /	642	d zer la chos sku la ye shes lnga d zer 
BO_TZ_LAMRIM-YISHE-NYINGPO-P2:6429	longs sku la ye shes kyi rang gdangs 'od lnga ru 'bar ba /	642	longs sku la ye shes kyi rang gdang d lnga ru bar ba 
BO_TZ_LAMRIM-YISHE-NYINGPO-P2:6430	sprul sku la sku'i gnas ba spu'i bu ga re re nas kyang 'od zer bye ba brgya stong phrag drug cu 'phro ba /	643	sprul sku la sku gnas ba spu bu ga re re nas kyang d zer bye ba brgya stong phrag drug cu phro ba 
BO_TZ_LAMRIM-YISHE-NYINGPO-P2:6431	gdan khri ni chos sku la lta ba kha sbyor /	643	gdan khri ni chos sku la lta ba kha sbyor 
BO_TZ_LAMRIM-YISHE-NYINGPO-P2:6432	longs sku la shes rab kha sbyor /	643	longs sku la shes rab kha sbyor 
BO_TZ_LAMRIM-YISHE-NYINGPO-P2:6433	sprul sku la thugs rje kha sbyor ro //	643	sprul sku la thugs rje kha sbyor ro 
BO_TZ_LAMRIM-YISHE-NYINGPO-P2:6434	rgyan cha ni chos sku skye med rnam dag la rgyan gyi tha snyad mdzad pa dang / longs sku la 'gag med rang gsal gyi rgyan thun mong ma yin pa'i mtshhan dpe ste /	643	rgyan cha ni chos sku skye med rnam dag la rgyan gyi tha snyad mdzad ba dang longs sku la gag med rang gsal gyi rgyan thun mong ma yin ba mtshhan dpe ste 
BO_TZ_LAMRIM-YISHE-NYINGPO-P2:6435	de la phyi nang gsang ba gsum gsum du dbyer yod cing /	643	de la phyi nang gsang ba gsum gsum du dbyer yod cing 
BO_TZ_LAMRIM-YISHE-NYINGPO-P2:6436	gzhan yang longs sku rtags kyi rgyan bcur grags pa /	643	gzhan yang longs sku rtags kyi rgyan jur grags ba 
BO_TZ_LAMRIM-YISHE-NYINGPO-P2:6437	dbu rgyan / snyan rgyan /	643	dbu rgyan snyan rgyan 
BO_TZ_LAMRIM-YISHE-NYINGPO-P2:6438	mgu chu / do shal /	643	mgu chu do shal 
BO_TZ_LAMRIM-YISHE-NYINGPO-P2:6439	dpung rgyan / phyag gdub gnyis /	643	dpung rgyan phyag gdub gnyis 
BO_TZ_LAMRIM-YISHE-NYINGPO-P2:6440	zhabs gdub gnyis /	644	zhabs gdub gnyis 
BO_TZ_LAMRIM-YISHE-NYINGPO-P2:6441	se mo do dang bcu'o //	644	se mo do dang chu 
BO_TZ_LAMRIM-YISHE-NYINGPO-P2:6442	sprul sku'i rgyan thun mong gi mtshhan bzang so gnyis dang dpe byad brgyad cu ste /	644	sprul sku rgyan thun mong gi mtshhan bzang so gnyis dang dpe byad brgyad cu ste 
BO_TZ_LAMRIM-YISHE-NYINGPO-P2:6443	de ni 'khor los sgyur ba'i rgyal po la'ang phyogs mthun tsham yod pas thun mong gi mtshhan dper bshad do //	644	de ni khor los sgyur ba rgyal po la phyogs mthun tsham yod ba thun mong gi mtshhan dper chad do 
BO_TZ_LAMRIM-YISHE-NYINGPO-P2:6444	lnga pa ni /	644	lnga ba ni 
BO_TZ_LAMRIM-YISHE-NYINGPO-P2:6445	las dang nyon mongs pa'i rnam par rtog pa dang nad gdon sogs zhi bar byed pa dang / tshhe bsod dpal 'byor rang rig pa'i ye shes kyi mngon rtogs thams cad rgyas par byed pa dang / rlung sems snang bas bsdus pa'i 'khor 'das kyi chos thams cad rang dbang du mdzad pa dang /	644	las dang nyon mongs ba rnam ba rtogs ba dang nad don sogs zhi ba byed ba dang tshhe bsod dpal byor rang rig ba ye shes kyi mngon rtogs thams cad rgya ba byed ba dang rlung sems snang ba sdud ba khor da kyi chos thams cad rang dbang du mdzad ba dang 
BO_TZ_LAMRIM-YISHE-NYINGPO-P2:6446	zhi bas mi thul pa'i dgra bgegs log 'dren rnams thugs rje drag por khros pas tshhar bcad pa dang / gnas lugs ji lta ba mngon du gyur pas mdzad dang mdzad par bya ba gang yang mi dmigs pa'i ngang nas phyogs dang ris su chad pa med pa ni lhun gyis grub pa'i phrin las so //	644	zhi ba mi thul ba dgra bgegs log bgrang rnams thugs rje drag por khro ba tshhar gcod ba dang gnas lugs ji lta ba mngon du gyur ba mdzad dang mdzad ba byed ba gang yang mi dmigs ba ngang nas phyogs dang ris su chad ba med ba ni lhun gyis grub ba phrin las so 
BO_TZ_LAMRIM-YISHE-NYINGPO-P2:6447	de lta bu'i phrin las kyis gdul bya 'dul ba ni rtag khyab lhun grub kyi bdag nyid can te /	644	de lta bu phrin las kyis gdul byed dul ba ni rtag khyab lhun grub kyi bdag nyid can te 
BO_TZ_LAMRIM-YISHE-NYINGPO-P2:6448	nam mkha' ji srid bar 'khor ba'i mtha' zad pa med cing 'khor ba ji srid ma stong bar sangs rgyas kyi phrin las rgyun chad mi mnga' bar rtag pa ste /	644	nam mkha ji srid ba khor ba mtha zad ba med cing khor ba ji srid ma stong ba sangs rgya kyi phrin las rgyun chad mi mnga ba rtag ba ste 
BO_TZ_LAMRIM-YISHE-NYINGPO-P2:6449	mngon rtogs rgyan las /	644	mngon rtogs rgyan las 
BO_TZ_LAMRIM-YISHE-NYINGPO-P2:6450	de bzhin 'khor ba ji srid 'di'i //	645	de bzhin khor ba ji srid di 
BO_TZ_LAMRIM-YISHE-NYINGPO-P2:6451	las ni rgyun mi chad par 'dod //	645	las ni rgyun mi chad ba dod 
BO_TZ_LAMRIM-YISHE-NYINGPO-P2:6452	ces so // rtag pa de'ang phyogs rer 'jug pa ma yin par ji snyed nam mkha'i khams kyis khyab pa de snyed kyi gdul bya sems can kyi khams la phyogs ris med par khyab pa ste /	645	ces so rtag ba de phyogs rer jug ba ma yin ba ji snyed nam mkha khams kyis khyab ba de snyed kyi gdul byed sems can kyi khams la phyogs ris med ba khyab ba ste 
BO_TZ_LAMRIM-YISHE-NYINGPO-P2:6453	rgyud bla mar /	645	brgyud bla mar 
BO_TZ_LAMRIM-YISHE-NYINGPO-P2:6454	de ltar nam mkha'i mtha' klas kyi //	645	de ltar nam mkha mtha klas kyi 
BO_TZ_LAMRIM-YISHE-NYINGPO-P2:6455	'gro la rtag tu lhun grub par //	645	gro la rtag tu lhun grub ba 
BO_TZ_LAMRIM-YISHE-NYINGPO-P2:6456	thogs med blo ldan de yis ni //	645	thogs med blo ldan de yis ni 
BO_TZ_LAMRIM-YISHE-NYINGPO-P2:6457	sems can don ni yang dag 'jug	645	sems can don ni yang dag jug 
BO_TZ_LAMRIM-YISHE-NYINGPO-P2:6458	/ces so // gdul bya 'dul ba'i dus la babs pa na dbang po dang 'tshhams par thams cad kyi don ma nor bar ji lta ba bzhin 'bad rtshol med par ngang gis 'byung ba lhun gyis grub pa ste /	645	so gdul byed dul ba dus la bab ba na dbang po dang tshhams ba thams cad kyi don ma nor ba ji lta ba bzhin bad rtshol med ba ngang gis byung ba lhun gyis grub ba ste 
BO_TZ_LAMRIM-YISHE-NYINGPO-P2:6459	rim gsum las /	645	rim gsum las 
BO_TZ_LAMRIM-YISHE-NYINGPO-P2:6460	'bras bu yon tan lhun grub pas //	646	bras bu yon tan lhun grub ba 
BO_TZ_LAMRIM-YISHE-NYINGPO-P2:6461	yid bzhin nor bu ltar snang ba'o //	646	yid bzhin nor bu ltar snang ba 
BO_TZ_LAMRIM-YISHE-NYINGPO-P2:6462	zhes so // bzhi pa man ngag gi dgos 'brel bstan pa ni /	646	zhes so bzhi ba man ngag gi dgos brel ston ba ni 
BO_TZ_LAMRIM-YISHE-NYINGPO-P2:6463	de ltar nas myur rdzogs byed /	646	de ltar nas myur rdzogs byed 
BO_TZ_LAMRIM-YISHE-NYINGPO-P2:6464	ces gsungs te /	646	ces gsungs te 
BO_TZ_LAMRIM-YISHE-NYINGPO-P2:6465	sngar rgyas par bstan pa de ltar sbyang gzhi bde bar gshegs pa'i snying po 'dam khrod na gnas pa'i nor bu bzhin du sems can thams cad kyi rgyud la gdod nas rang babs su bzhugs pa la /	646	sngar rgya ba ston ba de ltar sbyong gzhi bde ba gshegs ba snying po dam khrod na gnas ba nor bu bzhin du sems can thams cad kyi brgyud la gdod nas rang bab su bzhugs ba la 
BO_TZ_LAMRIM-YISHE-NYINGPO-P2:6466	sbyong byed thun mong dang thun mong ma yin pa rim pa gnyis kyis bsdus pa'i rnal 'byor chu dang 'dag rdzas lta bu'i lam gyis mtshhams sbyar nas /	646	sbyong byed thun mong dang thun mong ma yin ba rim ba gnyis kyis sdud ba rnal byor chu dang dag rdzas lta bu lam gyis mtshhams sbyor nas 
BO_TZ_LAMRIM-YISHE-NYINGPO-P2:6467	sbyang bya med snang gnyis 'dzin glo bur gyi dri ma rags pa 'dam rdzab lta bu sbyangs shing phra ba sa bon bag chags dang bcas pa'ang spangs te /	646	sbyong byed med snang gnyis dzin glo bur gyi dri ma rags ba dam rdzab lta bu sbyong shing phra ba sa bon bag chags dang cha ba spong te 
BO_TZ_LAMRIM-YISHE-NYINGPO-P2:6468	sbyangs pa'i 'bras bu gzhi la ji ltar yod pa'i yon tan mngon du gyur te yid bzhin gyi nor bu dri ma thams cad dang bral ba las 'dod rgu 'bad med du 'byung ba bzhin rang dang gzhan gyi don rtshol ba med par myur du rdzogs par byed	646	sbyong ba bras bu gzhi la ji ltar yod ba yon tan mngon du gyur te yid bzhin gyi nor bu dri ma thams cad dang bral ba las dod rgu bad med du byung ba bzhin rang dang gzhan gyi don rtshol ba med ba myur du rdzogs ba byed 
BO_TZ_LAMRIM-YISHE-NYINGPO-P2:6469	pa'o // de la dgos 'brel gyi ngo bo ni /	646	ba de la dgos brel gyi ngo bo ni 
BO_TZ_LAMRIM-YISHE-NYINGPO-P2:6470	mtshhon bya mtshhon byed yod pa las dgos pa dang nying dgos shugs las grub pa'o //	647	mtshhon byed mtshhon byed yod ba las dgos ba dang nying dgos shugs las grub ba 
BO_TZ_LAMRIM-YISHE-NYINGPO-P2:6471	nges tshhig ni /	647	nges tshhig ni 
BO_TZ_LAMRIM-YISHE-NYINGPO-P2:6472	dgos sogs chos bzhi yod pa de dag phan tshhun gcig la gcig ltos su 'brel zhing /	647	dgos sogs chos bzhi yod ba de dag phan tshhun gcig la gcig ltos su brel zhing 
BO_TZ_LAMRIM-YISHE-NYINGPO-P2:6473	mthar thug 'bras bu bsgrub pa la'ang de dag med na mi 'byung gi 'brel par grub pa'o //	647	mthar thug bras bu sgrub ba la de dag med na mi byung gi brel ba grub ba 
BO_TZ_LAMRIM-YISHE-NYINGPO-P2:6474	dbye na / thugs thig las /	647	byed na thugs thig las 
BO_TZ_LAMRIM-YISHE-NYINGPO-P2:6475	brjod 'brel dgos pa yang dgos dang // rgyu rkyen yan lag bzhi ru bzung //	647	rjod brel dgos ba yang dgos dang rgyu rkyen yan lag bzhi ru bzung 
BO_TZ_LAMRIM-YISHE-NYINGPO-P2:6476	zhes pa ltar brjod bya /	647	zhes ba ltar rjod byed 
BO_TZ_LAMRIM-YISHE-NYINGPO-P2:6477	rjod byed / dgos pa /	647	rjod byed dgos ba 
BO_TZ_LAMRIM-YISHE-NYINGPO-P2:6478	nying dgos bzhi /	647	nying dgos bzhi 
BO_TZ_LAMRIM-YISHE-NYINGPO-P2:6479	de la'ang grol lam dbang btshan du byas na /	647	de la grol lam dbang btshan du byed na 
BO_TZ_LAMRIM-YISHE-NYINGPO-P2:6480	sngar smos pa'i sbyang gzhi bde gshegs snying po ni mtshhon bya rang bzhin gzhi'i rgyud de brjod bya /	648	sngar smos ba sbyong gzhi bde gshegs snying po ni mtshhon byed rang bzhin gzhi brgyud de rjod byed 
BO_TZ_LAMRIM-YISHE-NYINGPO-P2:6481	sbyong byed lam gyi rim pa brdar btags yi ge dang bcas pa ni mtshhon byed lam rkyen te rjod byed /	648	sbyong byed lam gyi rim ba rdar dogs yi ge dang cha ba ni mtshhon byed lam rkyen te rjod byed 
BO_TZ_LAMRIM-YISHE-NYINGPO-P2:6482	de la thos bsam byas pas brjod bya don spyi'i tshhul du go ba ni dgos pa /	648	de la thos bsam byed ba rjod byed don spyi tshhul du go ba ni dgos ba 
BO_TZ_LAMRIM-YISHE-NYINGPO-P2:6483	de ltar shes pa'i don bsgoms pas thun mong dang mchog gi dngos grub mngon du byed pa ni nyid dgos so //	648	de ltar shes ba don sgom ba thun mong dang mchog gi dngos grub mngon du byed ba ni nyid dgos so 
BO_TZ_LAMRIM-YISHE-NYINGPO-P2:6484	thabs lam dbang btshan du byas na /	648	thabs lam dbang btshan du byed na 
BO_TZ_LAMRIM-YISHE-NYINGPO-P2:6485	lhan skyes ye shes gdod nas rang la rang chas su bzhugs pa ni brjod bya /	648	lhan skye ye shes gdod nas rang la rang cha su bzhugs ba ni rjod byed 
BO_TZ_LAMRIM-YISHE-NYINGPO-P2:6486	de rtogs byed thabs kyi man ngag glegs bam dang bcas pa ni rjod byed /	648	de rtogs byed thabs kyi man ngag glegs bam dang cha ba ni rjod byed 
BO_TZ_LAMRIM-YISHE-NYINGPO-P2:6487	de don nyams su blangs pas bde chen gyi ye shes khyad par can rgyud la skyes pa ni dgos pa /	648	de don nyams su blangs ba bde chen gyi ye shes khyad ba can brgyud la skye ba ni dgos ba 
BO_TZ_LAMRIM-YISHE-NYINGPO-P2:6488	de goms par byas pas mchog tu mi 'gyur ba'i bde chen ye shes mngon du byas pa ni nying dgos so //	648	de goms ba byed ba mchog tu mi gyur ba bde chen ye shes mngon du byed ba ni nying dgos so 
BO_TZ_LAMRIM-YISHE-NYINGPO-P2:6489	'brel ba'i don kyang /	648	brel ba don kyang 
BO_TZ_LAMRIM-YISHE-NYINGPO-P2:6490	brjod bya rjod byed gnyis shes bya shes byed dang / rjod byed dgos pa gnyis thabs las thabs byung dang / dgos pa nying dgos gnyis de las de byung dang / nying dgos dang brjod bya gnyis ngo bo bdag gcig gi 'brel bar grub pa yin no //	649	rjod byed rjod byed gnyis shes byed shes byed dang rjod byed dgos ba gnyis thabs las thabs byung dang dgos ba nying dgos gnyis de las de byung dang nying dgos dang rjod byed gnyis ngo bo bdag gcig gi brel ba grub ba yin no 
BO_TZ_LAMRIM-YISHE-NYINGPO-P2:6491	lnga pa 'khor la gdams shing bstan pa gtad pa la gnyis /	649	lnga ba khor la doms shing ston ba gtod ba la gnyis 
BO_TZ_LAMRIM-YISHE-NYINGPO-P2:6492	man ngag 'di shin tu zab par gdams pa dang / 'khor la gtad pa smon lam dang bcas pa'o //	649	man ngag di shin tu zab ba doms ba dang khor la gtod ba smon lam dang cha ba 
BO_TZ_LAMRIM-YISHE-NYINGPO-P2:6493	dang po ni /	649	dang po ni 
BO_TZ_LAMRIM-YISHE-NYINGPO-P2:6494	rgyu 'bras nas gshegs shul 'di :	649	rgyu bras nas gshegs shul di 
BO_TZ_LAMRIM-YISHE-NYINGPO-P2:6495	zhes pa'i bar gyis bstan te /	649	zhes ba ba gyis ston te 
BO_TZ_LAMRIM-YISHE-NYINGPO-P2:6496	de ltar ji skad bstan pa'i zhal gdams man ngag lam gyi rim pa khyad gzhi'i gzhung nyid ni /	649	de ltar ji skad ston ba zhal doms man ngag lam gyi rim ba khyad gzhi gzhung nyid ni 
BO_TZ_LAMRIM-YISHE-NYINGPO-P2:6497	rgyu lam du byed pa phar phyin gyi theg pa dang 'bras bu lam du byed pa gsang sngags rdo rje theg pa'i chos tshhul rgya mtshho chen po'i yang bcud bdud rtshi'i gong bu lta bu /	649	rgyu lam du byed ba phar phyin gyi theg ba dang bras bu lam du byed ba gsang sngags rdo rje theg ba chos tshhul rgya mtshho chen po yang bcud bdud rtshi gong bu lta bu 
BO_TZ_LAMRIM-YISHE-NYINGPO-P2:6498	khyad par du'ang rgyud la ma ha a nu man ngag a ti yo ga ste nang rgyud sde gsum gyi dgongs pa'i mthil du thug pa /	649	khyad ba du brgyud la ma ha a nu man ngag a ti yo ga ste nang brgyud sde gsum gyi dgongs ba mthil du thug ba 
BO_TZ_LAMRIM-YISHE-NYINGPO-P2:6499	'chad pa'i tshhul mdo sngags kyi chos sgo kun dang mthun la don zab cing 'dril la ma tshhang ba med pa'i phyir kun las khyad par du 'phags pa theg rim kun gyi skyel sa gnad gcig tu 'dril ba ye shes snying po'i lam rim zab mo 'di la	649	chad ba tshhul mdo sngags kyi chos sgo kun dang mthun la don zab cing dril la ma tshhang ba med ba phyir kun las khyad ba du phag ba theg rim kun gyi skyel sa gnad gcig tu dril ba ye shes snying po lam rim zab mo di la 
BO_TZ_LAMRIM-YISHE-NYINGPO-P2:6500	brten nas / mig 'phrul gyi snang ba lta bur dka' ba med cing myur ba kho nar sangs rgyas kyi 'bras bu mngon du byed pa'i thabs bla na med par gyur pa yin la /	650	rten nas mig phrul gyi snang ba lta bur dka ba med cing myur ba kho nar sangs rgya kyi bras bu mngon du byed ba thabs bla na med ba gyur ba yin la 
BO_TZ_LAMRIM-YISHE-NYINGPO-P2:6501	khyad chos yon tan gzhung 'di nyid skal pa dang ldan pa gang dag gis mthong ba tsham gyis byin rlabs kyi zil dang gzi brjid chen po rang shugs kyis 'bebs pa dang / slob dpon gyis bshad pa'i tshhig rna bar thos pa tsham gyis don spyi go zhing de la rtogs dpyod gyi bsam pas nyams myong dang rtogs pa'i ye shes klong nas brdol ba dang /	650	khyad chos yon tan gzhung di nyid skal ba dang ldan ba gang dag gis mthong ba tsham gyis byin rlabs kyi zil dang gzi brjid chen po rang shugs kyis bebs ba dang slob dpon gyis chad ba tshhig rna ba thos ba tsham gyis don spyi go zhing de la rtogs dpyod gyi bsam ba nyams myong dang rtogs ba ye shes klong nas rdol ba dang 
BO_TZ_LAMRIM-YISHE-NYINGPO-P2:6502	rnam par g.yeng ba spangs te zla ba drug tu 'di'i don rtshe gcig tu bsgoms pas rdo rje mi phyed pa gsum gyi ye shes chen po rang bzhin gyis shar bar nges pa ste /	650	rnam ba g.yeng ba spong te zla ba drug tu di don rtshe gcig tu sgom ba rdo rje mi phyed ba gsum gyi ye shes chen po rang bzhin gyis char ba nges ba ste 
BO_TZ_LAMRIM-YISHE-NYINGPO-P2:6503	khyad par de ldan gyi gzhung 'di tshhul ji ltar na /	650	khyad ba de ldan gyi gzhung di tshhul ji ltar na 
BO_TZ_LAMRIM-YISHE-NYINGPO-P2:6504	ka dag chos sku kun tu bzang po dang lhun grub longs sku rdo rje sems dpa'/	650	ka dag chos sku kun tu bzang po dang lhun grub longs sku rdo rje sems 
BO_TZ_LAMRIM-YISHE-NYINGPO-P2:6505	zung 'jug sprul sku pad+ma 'byung gnas gsum po don dam gyi dbyings la tha dad du dbye ba byar med cing chos kyi dbyings su ro gcig par lhun gyis rdzogs pa'i phyir na /	650	zung jug sprul sku pad+ma byung gnas gsum po don dam gyi dbyings la tha dad du byed ba byar med cing chos kyi dbyings su ro gcig ba lhun gyis rdzogs ba phyir na 
BO_TZ_LAMRIM-YISHE-NYINGPO-P2:6506	brtag gnyis las /	650	rtog gnyis las 
BO_TZ_LAMRIM-YISHE-NYINGPO-P2:6507	'chad pa po nga chos kyang nga //	650	chad ba po nga chos kyang nga 
BO_TZ_LAMRIM-YISHE-NYINGPO-P2:6508	rang gi tshhogs ldan nyan pa nga //	650	rang gi tshhogs ldan nyan ba nga 
BO_TZ_LAMRIM-YISHE-NYINGPO-P2:6509	'jigs rten ston pa bsgrub bya nga //	650	jigs rten ston ba sgrub byed nga 
BO_TZ_LAMRIM-YISHE-NYINGPO-P2:6510	'jig rten 'jig rten 'das pa nga //	651	jig rten jig rten da ba nga 
BO_TZ_LAMRIM-YISHE-NYINGPO-P2:6511	zhes gsungs pa ltar tshhad dang mu med pa'i rab 'byams rgyud sde rgya mtshho kun gyi 'phro gzhir gyur pas rgyud ston pa po dang de'i bstan pa zab gsang snying po'i don gyi rgyud lung rnams dang / de'i zab gnad lag len tu dril pa'i man ngag nyid kyang tha dad rang mtshhan du ma grub par ngo bo chos sku gcig gi rang snang nyid yin kyang /	651	zhes gsungs ba ltar tshhad dang mu med ba rab byam brgyud sde rgya mtshho kun gyi phro gzhir gyur ba brgyud ston ba po dang de ston ba zab gsang snying po don gyi brgyud lung rnams dang de zab gnad lag len tu dril ba man ngag nyid kyang tha dad rang mtshhan du ma grub ba ngo bo chos sku gcig gi rang snang nyid yin kyang 
BO_TZ_LAMRIM-YISHE-NYINGPO-P2:6512	rnam pa tsham du dzam bus mtshhan pa'i gling bskal pa bzang po'i sangs rgyas rnams 'byung zhing 'di'i gdul bya rnams thar par drang ba'i slad du /	651	rnam ba tsham du dzam bud mtshhan ba gling bskal ba bzang po sangs rgya rnams byung zhing di gdul byed rnams thar ba dren ba slad du 
BO_TZ_LAMRIM-YISHE-NYINGPO-P2:6513	nub phyogs o rgyan d+ha na ko sha'i mtshho gling du ngo mtshhar pad+ma'i sdong po nas brdzus te byung ba dang / o di ya na'i yul sogs su rigs mchog gi mngal du skyes pa sogs gzhan snang 'char tshhul gcig tu ma nges par tha dad pas mdzad pa'i cho 'phrul bcu gcig dang brgya rtsha la sogs ba cir yang ston pa'i skabs su bab pa de'i tshhe na /	651	nub phyogs o rgyan d+ha na ko sha mtshho gling du ngo mtshhar pad+ma sdong po nas brdzus te byung ba dang o di ya na yul sogs su rigs mchog gi mngal du skye ba sogs gzhan snang char tshhul gcig tu ma nges ba tha dad ba mdzad ba cho phrul chu gcig dang brgya rtsha la sogs ba cir yang ston ba skabs su bab ba de tshhe na 
BO_TZ_LAMRIM-YISHE-NYINGPO-P2:6514	'phags yul shar phyogs bkra shis ma ra ta'i ka'i brag phug tu tshhe lam gyi phyag rgya man+dar ba la rten byas te 'chi med tshhe'i rig 'dzin bsgrubs pa'i dus bcom ldan 'das tshhe dpag med mgon dngos su byon nas bskal pa ma stong gi bar du skye	651	phag yul char phyogs bkra shis ma ra ta ka brag bugs tu tshhe lam gyi phyag rgya man+dar ba la rten byed te chi med tshhe rig dzin sgrub ba dus joms ldan da tshhe dpog med mgon dngos su byon nas bskal ba ma stong gi ba du skye 
BO_TZ_LAMRIM-YISHE-NYINGPO-P2:6515	'chi med pa rdo rje'i skur bzhugs pa'i dbang bskur zhing rgyud dang gdams ngag dpag tu med pa bstshal pa dang / bal yul yang le shod bkra shis ba'i nags tshhal byang chub dam pa'i gling du yang dag grub pa gcig pu'i rnal 'byor gyis phyag rgya chen po'i mchog sgrub ba'i tshhe dpal chen he ru ka'i ye shes kyi skur rang byung chos nyid rdo rje'i rang sgras pad+ma	651	chi med ba rdo rje skur bzhugs ba dbang skur zhing brgyud dang doms ngag dpog tu med ba bstshal ba dang bal yul yang le shod bkra shis ba nags tshhal byang chub dam ba gling du yang dag grub ba gcig pu rnal byor gyis phyag rgya chen po mchog sgrub ba tshhe dpal chen he ru ka ye shes kyi skur rang byung chos nyid rdo rje rang sgras pad+ma 
BO_TZ_LAMRIM-YISHE-NYINGPO-P2:6516	sam b+ha ba bdag la dngos su bstshal pa'i rgyud dang gdams pa mtha' yas pa de dag kun gyi yang zhun bcud du dril ba'ang lam rim zab mo 'di kho na yin la /	651	sam b+ha ba bdag la dngos su bstshal ba brgyud dang doms ba mtha yas ba de dag kun gyi yang zhun bcud du dril ba lam rim zab mo di kho na yin la 
BO_TZ_LAMRIM-YISHE-NYINGPO-P2:6517	sprul pa'i sku mchog dga' rab rdo rje /	651	sprul ba sku mchog dga rab rdo rje 
BO_TZ_LAMRIM-YISHE-NYINGPO-P2:6518	ye shes sku can shri sim ham/	651	ye shes sku can shri sim 
BO_TZ_LAMRIM-YISHE-NYINGPO-P2:6519	klong dgu'i ye shes dpal chen po brgyad kyi go 'phang grub pa rdo rje'i rig 'dzin chen po rnam pa brgyad la sogs pa grub pa mchog gi sa la bzhugs pa rnams las thun mong khyad par gyi lam rim mtha' yas pa nos pa'i tshhul bstan pa dang	651	klong dgu ye shes dpal chen po brgyad kyi go phen grub ba rdo rje rig dzin chen po rnam ba brgyad la sogs ba grub ba mchog gi sa la bzhugs ba rnams las thun mong khyad ba gyi lam rim mtha yas ba nos ba tshhul ston ba dang 
BO_TZ_LAMRIM-YISHE-NYINGPO-P2:6520	/ phan tshhun du dam pa chos kyi bka'i 'gro ba chen po mdzad nas rtogs pa'i gdeng tshhad dang lta dgongs kyi nyams myong zab mo bsdur nas gtan la phab pa'i gnad kyi mdo byang yang 'di las gzhan du med cing /	652	phan tshhun du dam ba chos kyi bka gro ba chen po mdzad nas rtogs ba gdeng tshhad dang lta dgongs kyi nyams myong zab mo sdur nas gtan la bebs ba gnad kyi mdo byang yang di las gzhan du med cing 
BO_TZ_LAMRIM-YISHE-NYINGPO-P2:6521	'phags yul nub phyogs gsang chen 'byung gnas o rgyan /	652	phag yul nub phyogs gsang chen byung gnas o rgyan 
BO_TZ_LAMRIM-YISHE-NYINGPO-P2:6522	lho phyogs sangs rgyas 'byon pa'i gnas rgya gar /	652	lho phyogs sangs rgya byon ba gnas rgya gar 
BO_TZ_LAMRIM-YISHE-NYINGPO-P2:6523	byang phyogs thugs rje chen po'i gdul zhing bod yul la sogs pa dzam gling gi yul gru mtha' dbus sing+ga dang 'gro lding sogs gling phran rnams su /	652	byang phyogs thugs rje chen po gdul zhing bod yul la sogs ba dzam gling gi yul gru mtha dbus sing+ga dang gro lding sogs gling phran rnams su 
BO_TZ_LAMRIM-YISHE-NYINGPO-P2:6524	bla ma gu ru rin po che nyid kyi sgrub thabs che chung mtha' yas pa rdzogs pa chen po pha ma gnyis 'brel gyi rgyud dang 'brel ba'i gdams zab /	652	bla ma gu ru rin po che nyid kyi sgrub thabs che chung mtha yas ba rdzogs ba chen po pha ma gnyis brel gyi brgyud dang brel ba doms zab 
BO_TZ_LAMRIM-YISHE-NYINGPO-P2:6525	thugs rje chen po zhi khro'i bskyed rdzogs grangs las 'das pa ste skal ldan gcig mi tshhe gcig gis sangs rgyas kyi sar bgrod pa'i lam zab snying por dril ba de gsum dang / sgrub sde chen po brgyad dkyil 'khor gcig tu sgrub pa dang bye brag so sor sgrub pa'i thabs la sogs pa zab cing rgya che ba'i chos kyi 'khor lo 'byams su klas pa bskor ba de dag kun gyi zab don gcig tu bsdus shing ma nor ba'i lam	652	thugs rje chen po zhi khro skyed rdzogs grangs las da ba ste skal ldan gcig mi tshhe gcig gis sangs rgya kyi sar bgrod ba lam zab snying por dril ba de gsum dang sgrub sde chen po brgyad dkyil khor gcig tu sgrub ba dang bye brag so sor sgrub ba thabs la sogs ba zab cing rgya che ba chos kyi khor lo byam su klas ba skor ba de dag kun gyi zab don gcig tu sdud shing ma nor ba lam 
BO_TZ_LAMRIM-YISHE-NYINGPO-P2:6526	mchog kyang 'di nyid kho na yin no //	652	mchog kyang di nyid kho na yin no 
BO_TZ_LAMRIM-YISHE-NYINGPO-P2:6527	mdor bsdu na rjod byed tshhig tshhogs nyung yang brjod bya'i don ma tshhang pa gang yang med par gnad du 'dril zhing /	652	mdor sdud na rjod byed tshhig tshhogs nyung yang rjod byed don ma tshhang ba gang yang med ba gnad du dril zhing 
BO_TZ_LAMRIM-YISHE-NYINGPO-P2:6528	rdo rje'i tshhig gis ma bcings par zhal gdams rjen phyungs su bstan pas go sla ba /	652	rdo rje tshhig gis ma ching ba zhal doms rjen phyungs su ston ba go sla ba 
BO_TZ_LAMRIM-YISHE-NYINGPO-P2:6529	mang nyung ran pas rgyun tu khyer bde ba /	652	mang nyung ran ba rgyun tu khyer bde ba 
BO_TZ_LAMRIM-YISHE-NYINGPO-P2:6530	lta sgom spyod pa yan lag bcas ma tshhang ba med pas gzhung gzhan la ma ltos par /	653	lta sgom spyod ba yan lag cha ma tshhang ba med ba gzhung gzhan la ma ltos ba 
BO_TZ_LAMRIM-YISHE-NYINGPO-P2:6531	dbang po dman pa nyan rang /	653	dbang po dman ba nyan rang 
BO_TZ_LAMRIM-YISHE-NYINGPO-P2:6532	'bring po byang sems /	653	bring po byang sems 
BO_TZ_LAMRIM-YISHE-NYINGPO-P2:6533	dbang mchog rdo rje theg pa dag gi rang lam yongs su rdzogs pa'i phyir na /	653	dbang mchog rdo rje theg ba dag gi rang lam yongs su rdzogs ba phyir na 
BO_TZ_LAMRIM-YISHE-NYINGPO-P2:6534	sde snod gsum dang theg dgu'i snying po mthar thug pa'i zhal gdams 'di las lhag pa gzhan gang du btshal yang ma mchis so //	653	sde snod gsum dang theg dgu snying po mthar thug ba zhal doms di las lhag ba gzhan gang du btshal yang ma mchis so 
BO_TZ_LAMRIM-YISHE-NYINGPO-P2:6535	rgyu mtshhan de lta bu'i phyir bdag nyid gsung rdo rje pad+ma sam b+ha ba'i gsang chen thugs kyi thig le ye shes lnga ldan gyi rang 'od gsal ba'i dbyings las /	653	rgyu mtshhan de lta bu phyir bdag nyid gsung rdo rje pad+ma sam b+ha ba gsang chen thugs kyi thig le ye shes lnga ldan gyi rang d gsal ba dbyings las 
BO_TZ_LAMRIM-YISHE-NYINGPO-P2:6536	mi shigs na da'i dwangs ma chos nyid rdo rje'i rang sgra'i rgyud kyi rgyal por rang byung ba /	653	mi shigs na da dwangs ma chos nyid rdo rje rang sgra brgyud kyi rgyal por rang byung ba 
BO_TZ_LAMRIM-YISHE-NYINGPO-P2:6537	'das pa dang da ltar dang ma byon pa'i dus gsum gyi sangs rgyas stobs bcu mnga' ba kun gshegs shing gshegs la gshegs par 'gyur ba'i shul lam chen po 'di ni /	653	da ba dang da ltar dang ma byon ba dus gsum gyi sangs rgya stobs chu mnga ba kun gshegs shing gshegs la gshegs ba gyur ba shul lam chen po di ni 
BO_TZ_LAMRIM-YISHE-NYINGPO-P2:6538	zhes zab gnyan gces pa'i gdams pa la dngos po nges bzung du bstan pa'o //	653	zhes zab gnyan gces ba doms ba la dngos po nges bzung du ston ba 
BO_TZ_LAMRIM-YISHE-NYINGPO-P2:6539	gnyis pa ni /	653	gnyis ba ni 
BO_TZ_LAMRIM-YISHE-NYINGPO-P2:6540	mnga' bdag nas 'grub par shog :	654	mnga bdag nas grub ba shog 
BO_TZ_LAMRIM-YISHE-NYINGPO-P2:6541	ces gsungs te /	654	ces gsungs te 
BO_TZ_LAMRIM-YISHE-NYINGPO-P2:6542	mnga' bdag chos kyi rgyal po yab 'jam mgon khri srong lde'u btshan dang lha sras sku mched sngon gyi las 'phro dang smon lam dag pas gdams zab bdud rtshi sbyin pa'i snod dang ldan cing sprul pa'i lo tsha ba bai ro tsha na slob dpon chen po shri	654	mnga bdag chos kyi rgyal po yab jam mgon khri srong ldeu btshan dang lha sras sku mched sngon gyi las phro dang smon lam dag ba doms zab bdud rtshi sbyin ba snod dang ldan cing sprul ba lo tsha ba bai ro tsha na slob dpon chen po shri 
BO_TZ_LAMRIM-YISHE-NYINGPO-P2:6543	sing ha las rdzogs pa chen po'i lta dgongs mthar phyin pa o rgyan bdag dang dgongs pa'i rtogs tshhad mnyam pa dang / thugs zin gyi gzungs ma dbyings phyug ye shes da ki mtshho rgyal ma gu ru nyid la sgo gsum gus pa chen pos zhabs tog phul du phyin pas mnyes pa rnam gsum 'grub pa'i phyir /	654	sing ha las rdzogs ba chen po lta dgongs mthar phyin ba o rgyan bdag dang dgongs ba rtogs tshhad mnyam ba dang thugs zin gyi gzungs ma dbyings phyug ye shes da ki mtshho rgyal ma gu ru nyid la sgo gsum gus ba chen pos zhabs tog bul du phyin ba mnyes ba rnam gsum grub ba phyir 
BO_TZ_LAMRIM-YISHE-NYINGPO-P2:6544	chos rgyal yab sras dag pa'i snod ldan du gyur cing lo tsha chen po skal pa mchog dang ldan la ye shes mtshho rgyal rgyud lung nas 'byung ba'i mtshhan nyid dang ldan pa ste /	654	chos rgyal yab sras dag ba snod ldan du gyur cing lo tsha chen po skal ba mchog dang ldan la ye shes mtshho rgyal brgyud lung nas byung ba mtshhan nyid dang ldan ba ste 
BO_TZ_LAMRIM-YISHE-NYINGPO-P2:6545	dngos su smin pa gsum ldan lhan cig pa'i 'khor 'dus pa rnams dang / brgyud nas go phye ba'i 'khor ma 'ongs pa'i gang zag snod ldan skal ldan mtshhan ldan gyi tshhogs rnams la gnyer du gtad pa yin pas /	654	dngos su smin ba gsum ldan lhan cig ba khor du ba rnams dang brgyud nas go byed ba khor ma ngs ba gang zag snod ldan skal ldan mtshhan ldan gyi tshhogs rnams la gnyer du gtod ba yin ba 
BO_TZ_LAMRIM-YISHE-NYINGPO-P2:6546	btang snyoms ngang du yal bar ma dor bar gces tshhad srog dang phongs tshhad mig 'bras ltar btsha' bas rtag pa snying gi dbus su dran pa'i gzungs kyis ma brjed par zungs shig	654	gtong snyom ngang du yal ba ma dor ba gces tshhad srog dang phong tshhad mig bras ltar btsha ba rtag ba snying gi dbus su dran ba gzungs kyis ma brjed ba zungs shig 
BO_TZ_LAMRIM-YISHE-NYINGPO-P2:6547	/der ma zad gzhung 'di yi ger bkod nas yang dang yang du ltos la ji skad bstan pa'i lam 'dir zhugs pa dang 'di nyid gzhan la rgya cher bshad pa dang rang gis brtshon pas 'di'i don nyams su longs nges par sgrubs shig	654	ma zad gzhung di yi ger bkod nas yang dang yang du ltos la ji skad ston ba lam dir jug ba dang di nyid gzhan la rgya cher chad ba dang rang gis brtshon ba di don nyams su longs nges ba sgrubs shig 
BO_TZ_LAMRIM-YISHE-NYINGPO-P2:6548	/ces zab mo'i bka'i gtad gnyer phyi tshhig nan thag tu bsdams nas /	654	zab mo bka gtod gnyer phyi tshhig nan thag tu sdom nas 
BO_TZ_LAMRIM-YISHE-NYINGPO-P2:6549	gong du bsngags pa brjod pa don dang ldan pa'i gdams pa khyad par can 'di la brten nas /	654	gong du bsngags ba rjod ba don dang ldan ba doms ba khyad ba can di la rten nas 
BO_TZ_LAMRIM-YISHE-NYINGPO-P2:6550	de ltar dang ma 'ongs pa na mtha' yas pa'i gdul bya dngos dang brgyud nas mthong thos dran reg gis 'brel bar gyur ba de kun gcig kyang ma lus par /	655	de ltar dang ma ngs ba na mtha yas ba gdul byed dngos dang brgyud nas mthong thos dran reg gis brel ba gyur ba de kun gcig kyang ma lus ba 
BO_TZ_LAMRIM-YISHE-NYINGPO-P2:6551	rang byung gdod ma'i sangs rgyas ye shes snying po'i 'bras bu dus gzhan du mi ltos pas tshhe 'dir kho nar 'grub par shog cig	655	rang byung gdod ma sangs rgya ye shes snying po bras bu dus gzhan du mi ltos ba tshhe dir kho nar grub ba shog cig 
BO_TZ_LAMRIM-YISHE-NYINGPO-P2:6552	/ces smon lam du mdzad pa ste rdo rje'i gsung nam yang bslu ba med pas de ltar 'grub pa'ang yang dag nges pa'i tshhad ma'o //	655	smon lam du mdzad ba ste rdo rje gsung nam yang bslu ba med ba de ltar grub ba yang dag nges ba tshhad ma 
BO_TZ_LAMRIM-YISHE-NYINGPO-P2:6553	rtsha ba'i bzhi pa mjug gi don la gnyis /	655	rtsha ba bzhi ba mjug gi don la gnyis 
BO_TZ_LAMRIM-YISHE-NYINGPO-P2:6554	gzhung yang dag par grub pa'i tshhig gis mjug bsdu ba dang / de ltar grub pa'i gzhung nyid sngon dang phyi mar dar ba'i tshhul lo //	655	gzhung yang dag ba grub ba tshhig gis mjug sdud ba dang de ltar grub ba gzhung nyid sngon dang phyi mar dar ba tshhul lo 
BO_TZ_LAMRIM-YISHE-NYINGPO-P2:6555	dang po ni /	655	dang po ni 
BO_TZ_LAMRIM-YISHE-NYINGPO-P2:6556	ces thugs kyi mdzod nas dam par bzhugs so :	655	ces thugs kyi mdzod nas dam ba bzhugs so 
BO_TZ_LAMRIM-YISHE-NYINGPO-P2:6557	zhes gsungs te /	655	zhes gsungs te 
BO_TZ_LAMRIM-YISHE-NYINGPO-P2:6558	de skad ces dus gsum sangs rgyas thams cad kyi gsang gsum sgyu 'phrul drwa ba'i spyi gzugs gu ru rin po che'i thugs kyi dgongs pa'i snying po phyung /	655	de skad ces dus gsum sangs rgya thams cad kyi gsang gsum sgyu phrul drwa ba spyi gzugs gu ru rin po che thugs kyi dgongs ba snying po byin 
BO_TZ_LAMRIM-YISHE-NYINGPO-P2:6559	gsang ba ye shes chen po'i mdzod brtol nas gsung yan lag drug cu dang ldan pa tshhangs pa'i dbyangs kyi mdo sngags gdams pa zab rgu'i yang zhun du dril nas bka' bstshal pas thams cad dgyes pa chen po'i tshhims pa'i mdongs gsol du /	655	gsang ba ye shes chen po mdzod rtol nas gsung yan lag drug cu dang ldan ba tshhangs ba dbyangs kyi mdo sngags doms ba zab rgu yang zhun du dril nas bka bstshal ba thams cad dgyes ba chen po tshhims ba mdongs gsol du 
BO_TZ_LAMRIM-YISHE-NYINGPO-P2:6560	ngo mtshhar rmad du byung ba'i rdzu 'phrul gyi rnam par rol ba dang / rnam par thar pa'i bkod pa mtha' yas pa 'dus pa'i tshhogs kyi dbang po'i spyod yul du snang bar mdzad pa dang bcas te ston 'khor dgongs pa mnyam nyid du gyur nas gu ru nyid kyi sku gsung thugs mi zad pa rgyan gyi 'khor lor lhun gyis grub	656	ngo mtshhar rmad du byung ba rdzu phrul gyi rnam ba rol ba dang rnam ba thar ba bkod ba mtha yas ba du ba tshhogs kyi dbang po spyod yul du snang ba mdzad ba dang cha te ston khor dgongs ba mnyam nyid du gyur nas gu ru nyid kyi sku gsung thugs mi zad ba rgyan gyi khor lor lhun gyis grub 
BO_TZ_LAMRIM-YISHE-NYINGPO-P2:6561	pa stug po bkod pa'i rgyan mchog dam par dus bzhir 'pho 'gyur mi mnga' bar bzhugs so //	656	ba stug po bkod ba rgyan mchog dam ba dus bzhir pho gyur mi mnga ba bzhugs so 
BO_TZ_LAMRIM-YISHE-NYINGPO-P2:6562	sa ma ya :	656	sa ma ya 
BO_TZ_LAMRIM-YISHE-NYINGPO-P2:6563	zhes pa don mang por 'jug kyang 'dir gzhung zab pa'i phyir snod min la gsang ba dang / rdo rje'i tshhig mi 'gyur ba'i dam tshhig gi rgya'o //	656	zhes ba don mang por jug kyang dir gzhung zab ba phyir snod min la gsang ba dang rdo rje tshhig mi gyur ba dam tshhig gi rgya 
BO_TZ_LAMRIM-YISHE-NYINGPO-P2:6564	gnyis pa la gnyis /	656	gnyis ba la gnyis 
BO_TZ_LAMRIM-YISHE-NYINGPO-P2:6565	sngon gyi skal ldan rnams kyis bzung tshhul dang / ma 'ongs 'gro ba rnams kyi don du gter du sbas pa'i tshhul lo //	656	sngon gyi skal ldan rnams kyis bzung tshhul dang ma ngs gro ba rnams kyi don du gter du sbed ba tshhul lo 
BO_TZ_LAMRIM-YISHE-NYINGPO-P2:6566	dang po la gsum /	656	dang po la gsum 
BO_TZ_LAMRIM-YISHE-NYINGPO-P2:6567	bka'i bsdu ba ji ltar byas tshhul /	656	bka sdud ba ji ltar byed tshhul 
BO_TZ_LAMRIM-YISHE-NYINGPO-P2:6568	des 'gro don 'byung tshhul /	656	des gro don byung tshhul 
BO_TZ_LAMRIM-YISHE-NYINGPO-P2:6569	de nyams su blang tshhul lo //	656	de nyams su blang tshhul lo 
BO_TZ_LAMRIM-YISHE-NYINGPO-P2:6570	dang po ni /	657	dang po ni 
BO_TZ_LAMRIM-YISHE-NYINGPO-P2:6571	de ltar bka' bstshal pa sogs nas /	657	de ltar bka bstshal ba sogs nas 
BO_TZ_LAMRIM-YISHE-NYINGPO-P2:6572	gwa'ur 'chang ste gnas so :	657	gwaur chang ste gnas so 
BO_TZ_LAMRIM-YISHE-NYINGPO-P2:6573	zhes pa'i bar gyis rdo rje'i gsung mtha' dag gi bka'i sdud pa po ye shes mtshho rgyal gyis mi brjed pa'i gzungs kyis thugs su bzung ste bsam sgom gyis gtan la phab /	657	zhes ba ba gyis rdo rje gsung mtha dag gi bka sdud ba po ye shes mtshho rgyal gyis mi brjed ba gzungs kyis thugs su bzung ste bsam sgom gyis gtan la bebs 
BO_TZ_LAMRIM-YISHE-NYINGPO-P2:6574	de tsham du ma bzhag par chos rgyal yab sras lo chen bai ro bcas lhan cig thos pa'i 'khor rnams dang dgongs pa bsdur gyi tshhig don lhag chad med pa'i zhu tig mdzad nas mkha' 'gro'i brda yig tu bkod cing thugs dam du 'bral med bcangs bar bstan	657	de tsham du ma jog ba chos rgyal yab sras lo chen bai ro cha lhan cig thos ba khor rnams dang dgongs ba sdur gyi tshhig don lhag chad med ba ju tig mdzad nas mkha gro brda yig tu bkod cing thugs dam du bral med chang ba ston 
BO_TZ_LAMRIM-YISHE-NYINGPO-P2:6575	pa'o // gnyis pa ni /	657	ba gnyis ba ni 
BO_TZ_LAMRIM-YISHE-NYINGPO-P2:6576	nam zhig gi tshhe nas mi snang bar gyur to :	657	nam jig gi tshhe nas mi snang ba gyur to 
BO_TZ_LAMRIM-YISHE-NYINGPO-P2:6577	sa ma ya :	657	sa ma ya 
BO_TZ_LAMRIM-YISHE-NYINGPO-P2:6578	zhes pa'i bar gyis /	657	zhes ba ba gyis 
BO_TZ_LAMRIM-YISHE-NYINGPO-P2:6579	dag pa'i 'khor rnams mgrin gcig tu gdams pa 'dzin skyong spel gsum ji ltar bya ba zhus pa'i lan du gu ru rin po ches rnam thar mdor bsdus pas thog grangs /	657	dag ba khor rnams mgrin gcig tu doms ba dzin skyong spel gsum ji ltar byed ba zhus ba lan du gu ru rin po ches rnam thar mdor sdud ba thogs grangs 
BO_TZ_LAMRIM-YISHE-NYINGPO-P2:6580	spyir mdzad pa'i cho 'phrul mtha' yas pa dang bye brag gangs can bod kyi yul du sangs rgyas kyi mdzad pa bsam yas rab 'byams su bstan pa'i tshhul dang / khyad par bdud 'joms rdo rje drag po'i rtshal gyi skur bzhengs nas zab rgu'i gdams bcud ye shes snying po lam 'bras bu dang bcas pa'i chos skor ma 'ongs gdul bya'i don du zab mo don du sba bar gdams pa dang /	658	spyir mdzad ba cho phrul mtha yas ba dang bye brag gangs can bod kyi yul du sangs rgya kyi mdzad ba bsam yas rab byam su ston ba tshhul dang khyad ba bdud joms rdo rje drag po rtshal gyi skur bzhengs nas zab rgu doms bcud ye shes snying po lam bras bu dang cha ba chos skor ma ngs gdul byed don du zab mo don du sbed ba doms ba dang 
BO_TZ_LAMRIM-YISHE-NYINGPO-P2:6581	gter gnas 'chol ba'i khro rgyal rdo rje gro lod mchog gi skur bstan te gcig las du mar 'phrul ba'i tshhul gyis dam srid gdug pa can btul ba'i gnas stag tshhang ming can bcu gsum yod pa'i ya gyal mdo khams 'bri zla zal mo sgang gi rgyud sbas	658	gter gnas chol ba khro rgyal rdo rje gro lod mchog gi skur ston te gcig las du mar phrul ba tshhul gyis dam srid gdug ba can dul ba gnas stag tshhang ming can chu gsum yod ba ya gyal mdo khams bri zla zal mo sgang gi brgyud sbed 
BO_TZ_LAMRIM-YISHE-NYINGPO-P2:6582	gnas chen po rdo rje zil khrom gyi 'dab zhol rong rme dkar mo stag tshhang gi gnas kyi bzhugs tshhul che brjod phan yon dang bcas pa /	658	gnas chen po rdo rje zil khrom gyi dab zhol rong rme dkar mo stag tshhang gi gnas kyi bzhugs tshhul che rjod phan yon dang cha ba 
BO_TZ_LAMRIM-YISHE-NYINGPO-P2:6583	der sku gsung thugs rten sogs ji ltar sba ba'i tshhul /	658	der sku gsung thugs rten sogs ji ltar sbed ba tshhul 
BO_TZ_LAMRIM-YISHE-NYINGPO-P2:6584	gang la bcol gdams bya ba'i gter srung /	658	gang la chol doms byed ba gter srung 
BO_TZ_LAMRIM-YISHE-NYINGPO-P2:6585	sbas pa'i gter de 'byin pa'i dus tshhod /	658	sbed ba gter de byin ba dus tshhod 
BO_TZ_LAMRIM-YISHE-NYINGPO-P2:6586	'don pa'i skyes bu /	658	don ba skye bu 
BO_TZ_LAMRIM-YISHE-NYINGPO-P2:6587	gdams pa'i snod ldan /	658	doms ba snod ldan 
BO_TZ_LAMRIM-YISHE-NYINGPO-P2:6588	de la brten nas phrin las 'byung tshhul /	658	de la rten nas phrin las byung tshhul 
BO_TZ_LAMRIM-YISHE-NYINGPO-P2:6589	skyes bu dam pa'i rnam thar ma nges pa skyong tshhul /	658	skye bu dam ba rnam thar ma nges ba skyong tshhul 
BO_TZ_LAMRIM-YISHE-NYINGPO-P2:6590	lam rim 'bri klog 'chad nyan gyi phan yon /	659	lam rim bri klog chad nyan gyi phan yon 
BO_TZ_LAMRIM-YISHE-NYINGPO-P2:6591	zhar byung bod khams bde ba'i rim gro ji ltar sgrub pa'i tshhul yon tan dang bcas pa gsal bar bstan mthar bka' bstshal pa la rjes su yi rang zhing dad gus chen pos mchod bstod phul te smon lam btab pas gu ru rin po ches mthun 'gyur bstshal	659	zhar byung bod khams bde ba rim gro ji ltar sgrub ba tshhul yon tan dang cha ba gsal ba ston mthar bka bstshal ba la rjes su yi rang zhing dad gus chen pos mchod bstod bul te smon lam debs ba gu ru rin po ches mthun gyur bstshal 
BO_TZ_LAMRIM-YISHE-NYINGPO-P2:6592	cing bkra shis pa'i mtshhan ltas rgya cher snang ba dang / rig 'dzin mkha' 'gro dkar phyogs skyong ba rnams kyis bstan pa 'di nyid srung zhing skyong ba'i dam bca' phul ba bcas bstan to //	659	cing bkra shis ba mtshhan ltas rgya cher snang ba dang rig dzin mkha gro dkar phyogs skyong ba rnams kyis ston ba di nyid srung zhing skyong ba dam chos bul ba cha ston to 
BO_TZ_LAMRIM-YISHE-NYINGPO-P2:6593	gsum pa ni /	659	gsum ba ni 
BO_TZ_LAMRIM-YISHE-NYINGPO-P2:6594	de nas ji ltar nas gnas pa na :	659	de nas ji ltar nas gnas ba na 
BO_TZ_LAMRIM-YISHE-NYINGPO-P2:6595	zhes pa'i bar gyis dag pa'i 'khor de rnams kyis gzhung 'di la thos bsam sgom pa mthar phyin par mdzad nas tshhig don cha tshhang ba'i dpe rgyud gzhan la ma bstan par mgul du 'chang /	659	zhes ba ba gyis dag ba khor de rnams kyis gzhung di la thos bsam sgom ba mthar phyin ba mdzad nas tshhig don cha tshhang ba dpe brgyud gzhan la ma ston ba mgul du chang 
BO_TZ_LAMRIM-YISHE-NYINGPO-P2:6596	snyan brgyud dum dum khrigs ci rigs pa skal ldan gzhan la'ang bstan cing spel ba'i tshhul bshad /	659	snyan brgyud dum dum khrigs ci rigs ba skal ldan gzhan la ston cing spel ba tshhul chad 
BO_TZ_LAMRIM-YISHE-NYINGPO-P2:6597	gnyis pa gter du sbas pa'i tshhul la gnyis /	659	gnyis ba gter du sbed ba tshhul la gnyis 
BO_TZ_LAMRIM-YISHE-NYINGPO-P2:6598	sbas tshhul dngos dang / zhar byung de bton nas 'gro don 'byung tshhul lo //	659	sbed tshhul dngos dang zhar byung de don nas gro don byung tshhul lo 
BO_TZ_LAMRIM-YISHE-NYINGPO-P2:6599	dang po ni /	659	dang po ni 
BO_TZ_LAMRIM-YISHE-NYINGPO-P2:6600	nam zhig gu ru rin po ches sogs nas /	660	nam jig gu ru rin po ches sogs nas 
BO_TZ_LAMRIM-YISHE-NYINGPO-P2:6601	man+t+ra gu h+ya sa ma ya :	660	man+t+ra gu h+ya sa ma ya 
BO_TZ_LAMRIM-YISHE-NYINGPO-P2:6602	zhes pa'i bar gyis /	660	zhes ba ba gyis 
BO_TZ_LAMRIM-YISHE-NYINGPO-P2:6603	ye shes da ki'i rje mo mtshho rgyal mas gu ru srin po'i kha gnon du gshegs pa'i rjes bod khams mtha' dbus kun tu gter zhabs bsdams pa'i dus su sngags srung ral gcig mas rjes su bskul bas rkyen byas te /	660	ye shes da ki rje mo mtshho rgyal mas gu ru srin po kha gnon du gshegs ba rjes bod khams mtha dbus kun tu gter zhabs sdom ba dus su sngags srung ral gcig mas rjes su skul ba rkyen byed te 
BO_TZ_LAMRIM-YISHE-NYINGPO-P2:6604	gu rus lung bstan pa'i gnas su rdzu 'phrul gyis sbas shing zab mo'i rgya rim pa bcu gsum gyis btab nas gter srung bdud dang btshan gyi mgon po la gnyer du gtad cing rdo rje'i lung don 'grub pa'i smon lam mdzad pa na gu ru rin po che	660	gu rus lung ston ba gnas su rdzu phrul gyis sbed shing zab mo rgya rim ba chu gsum gyis debs nas gter srung bdud dang btshan gyi mgon po la gnyer du gtod cing rdo rje lung don grub ba smon lam mdzad ba na gu ru rin po che 
BO_TZ_LAMRIM-YISHE-NYINGPO-P2:6605	skad cig gis byon nas bden tshhig dang rab tu gnas pa'i phrin las mdzad tshhul rnams bstan to //	660	skad cig gis byon nas bden tshhig dang rab tu gnas ba phrin las mdzad tshhul rnams ston to 
BO_TZ_LAMRIM-YISHE-NYINGPO-P2:6606	gnyis pa ni /	660	gnyis ba ni 
BO_TZ_LAMRIM-YISHE-NYINGPO-P2:6607	bkra shis pa'i sngags tshhig gis thog drangs /	660	bkra shis ba sngags tshhig gis thogs drangs 
BO_TZ_LAMRIM-YISHE-NYINGPO-P2:6608	mkhas pa'i gtshug rgyan sogs kyis /	660	mkhas ba gtshug rgyan sogs kyis 
BO_TZ_LAMRIM-YISHE-NYINGPO-P2:6609	rdo rje'i lung don ltar 'gro 'dul grub pa'i rig 'dzin chen po lhan rgyas pas 'phral gyi kha byang dang sngon gnas rjes dran gyi gsal snang la brten /	660	rdo rje lung don ltar gro dul grub ba rig dzin chen po lhan rgya ba phral gyi kha byang dang sngon gnas rjes dran gyi gsal snang la rten 
BO_TZ_LAMRIM-YISHE-NYINGPO-P2:6610	zab mo'i gter rgya bkrol te sbas pa'i gter rnams sa steng du snang bar mdzad pas skal ldan skyes mchog rnams kyis 'dzin skyong spel te 'gro don mtha' rgyas su 'phel ba'i sgo mo gsar du phyes pa'i tshhul smon lam dang bcas bstan pa'o //	661	zab mo gter rgya grol te sbed ba gter rnams sa steng du snang ba mdzad ba skal ldan skye mchog rnams kyis dzin skyong spel te gro don mtha rgya su phel ba sgo mo gsar du phyes ba tshhul smon lam dang cha ston ba 
BO_TZ_LAMRIM-YISHE-NYINGPO-P2:6611	//om swa sti sid+d+ham/	661	swa sti 
BO_TZ_LAMRIM-YISHE-NYINGPO-P2:6612	gang zhig sangs rgyas snying po dri mar bcas pa rgyu dang 'bras bu'i bstan rim gyis //	661	gang jig sangs rgya snying po dri mar cha ba rgyu dang bras bu ston rim gyis 
BO_TZ_LAMRIM-YISHE-NYINGPO-P2:6613	legs sbyong cho ga gzhung lugs gcig tum tshhang med ston shing rta chen po'i srol //	661	legs sbyong cho ga gzhung lugs gcig tum tshhang med ston shing rta chen po srol 
BO_TZ_LAMRIM-YISHE-NYINGPO-P2:6614	kun mkhyen ye shes rgya mtshho las 'khrungs byis blo'i yul 'das rdo rje'i tshhig gi mdzod //	661	kun mkhyen ye shes rgya mtshho las khrung byis blo yul da rdo rje tshhig gi mdzod 
BO_TZ_LAMRIM-YISHE-NYINGPO-P2:6615	thar 'dod 'jug ngogs gcig pu 'dir zhugs mi gnas byang chub myur du mngon byed 'gyur //	661	thar dod jug ngogs gcig pu dir jug mi gnas byang chub myur du mngon byed gyur 
BO_TZ_LAMRIM-YISHE-NYINGPO-P2:6616	blo dman sbrang bu'i bgrod pas mkha' lam bzhin //	661	blo dman sbrang bu bgrod ba mkha lam bzhin 
BO_TZ_LAMRIM-YISHE-NYINGPO-P2:6617	dgongs don ji bzhin 'grel bar nus min kyang //	661	dgongs don ji bzhin grel ba nus min kyang 
BO_TZ_LAMRIM-YISHE-NYINGPO-P2:6618	gsang bdag rig 'dzin bla mas rjes gnang zhing //	661	gsang bdag rig dzin bla mas rjes gnang zhing 
BO_TZ_LAMRIM-YISHE-NYINGPO-P2:6619	gzhan dag 'bad pas bskul phyir cung zad bkrol //	661	gzhan dag bad ba skul phyir cung zad grol 
BO_TZ_LAMRIM-YISHE-NYINGPO-P2:6620	thos pa'i lang tshhos rab dregs ston chen gyi //	662	thos ba lang tshhos rab dregs ston chen gyi 
BO_TZ_LAMRIM-YISHE-NYINGPO-P2:6621	don du 'gyur min thar pa don gnyer pa'i //	662	don du gyur min thar ba don gnyer ba 
BO_TZ_LAMRIM-YISHE-NYINGPO-P2:6622	dad brtshon blo dman rnams la snying gi dpyid //	662	dad brtshon blo dman rnams la snying gi dpyid 
BO_TZ_LAMRIM-YISHE-NYINGPO-P2:6623	ster byed yongs 'dus gsar pa'i skyed tshhal lo //	662	ster byed yongs du gsar ba skyed tshhal lo 
BO_TZ_LAMRIM-YISHE-NYINGPO-P2:6624	ma rtogs log rtog blo yis phyogs bslad pas //	662	ma rtogs log rtogs blo yis phyogs bslad ba 
BO_TZ_LAMRIM-YISHE-NYINGPO-P2:6625	ma bkral log par bkral sogs nongs pa'i sprin //	662	ma bkral log ba bkral sogs nongs ba sprin 
BO_TZ_LAMRIM-YISHE-NYINGPO-P2:6626	gzhung bzang nyin byed sgrib rnams chos dbyings mkhar //	662	gzhung bzang nyin byed sgrib rnams chos dbyings mkhar 
BO_TZ_LAMRIM-YISHE-NYINGPO-P2:6627	rtsha gsum thugs rje'i shugs kyis dengs mdzad gsol /	662	rtsha gsum thugs rje shugs kyis dengs mdzad gsol 
BO_TZ_LAMRIM-YISHE-NYINGPO-P2:6628	khengs pa'i blos min dad pa kho na yis //	662	kheng ba blos min dad ba kho na yis 
BO_TZ_LAMRIM-YISHE-NYINGPO-P2:6629	sri zhu phul ba'i dge 'bras phra mo tsham //	662	sri ju bul ba dge bras phra mo tsham 
BO_TZ_LAMRIM-YISHE-NYINGPO-P2:6630	gang mchis skye dgu'i rmongs pa'i mig sel cing //	663	gang mchis skye dgu rmongs ba mig sel cing 
BO_TZ_LAMRIM-YISHE-NYINGPO-P2:6631	dri bral ye shes spyan yangs thob phyir bsngo //	663	dri bral ye shes spyan yangs thob phyir sngo 
BO_TZ_LAMRIM-YISHE-NYINGPO-P2:6632	'gro kun rgyal bstan yongs rdzogs bka' srol 'dir //	663	gro kun rgyal ston yongs rdzogs bka srol dir 
BO_TZ_LAMRIM-YISHE-NYINGPO-P2:6633	thos bsam sgom pa'i skal ba mchog ldan cing //	663	thos bsam sgom ba skal ba mchog ldan cing 
BO_TZ_LAMRIM-YISHE-NYINGPO-P2:6634	rang lam mthar phyin bgrod gcig 'bras bu'i dpal //	663	rang lam mthar phyin bgrod gcig bras bu dpal 
BO_TZ_LAMRIM-YISHE-NYINGPO-P2:6635	myur du thob nas don gnyis lhun grub shog	663	myur du thob nas don gnyis lhun grub shog 
BO_TZ_LAMRIM-YISHE-NYINGPO-P2:6636	/srid na mtshhungs med nor bu dpag bsam shing //	663	na mtshhungs med nor bu dpog bsam shing 
BO_TZ_LAMRIM-YISHE-NYINGPO-P2:6637	nyi zla'i dkyil 'khor rgyas 'dra'i gzhung 'di yang //	663	nyi zla dkyil khor rgya dra gzhung di yang 
BO_TZ_LAMRIM-YISHE-NYINGPO-P2:6638	mi nyams rab 'phel de 'dzin skyes mchog rnams //	663	mi nyams rab phel de dzin skye mchog rnams 
BO_TZ_LAMRIM-YISHE-NYINGPO-P2:6639	sku tshhe brtan cing bzhed don kun 'grub shog	663	sku tshhe brtan cing bzhed don kun grub shog 
BO_TZ_LAMRIM-YISHE-NYINGPO-P2:6640	/'dir 'brel yon tan ji ltar rdo rje'i lung gis bsngags pa bzhin //	664	brel yon tan ji ltar rdo rje lung gis bsngags ba bzhin 
BO_TZ_LAMRIM-YISHE-NYINGPO-P2:6641	bdag gzhan 'brel bcas dka' ba med thob theg mchog yid bzhin nor //	664	bdag gzhan brel cha dka ba med thob theg mchog yid bzhin nor 
BO_TZ_LAMRIM-YISHE-NYINGPO-P2:6642	bshad sgrub rgyal mtshhan rtshe mor bkod las grub gnyis 'dod rgu'i char //	664	chad sgrub rgyal mtshhan rtshe mor bkod las grub gnyis dod rgu char 
BO_TZ_LAMRIM-YISHE-NYINGPO-P2:6643	'jig rten gsum na khyab cing rtag 'bebs bkra shis khyab gyur cig	664	jig rten gsum na khyab cing rtag bebs bkra shis khyab gyur cig 
BO_TZ_LAMRIM-YISHE-NYINGPO-P2:6644	/ces thugs sgrub rnam pa bzhi'i rgyab chos zhal gdams lam rim ye shes snying po'i 'grel pa mdor bsdus su byas pa 'di'ang /	664	thugs sgrub rnam ba bzhi rgyab chos zhal doms lam rim ye shes snying po grel ba mdor sdud su byed ba di 
BO_TZ_LAMRIM-YISHE-NYINGPO-P2:6645	khyab bdag 'khor lo'i mgon po gter chen rig 'dzin bla ma lhan rgyas nas bka' lung gi rjes su gnang ba dang / rgyal dbang thams cad mkhyen pa bcu bzhi pa'i thugs sras kam tshhang bstan pa'i gsal byed mtshhur phu rje dpon mchog sprul rnam pa gnyis dang /	664	khyab bdag khor lo mgon po gter chen rig dzin bla ma lhan rgya nas bka lung gi rjes su gnang ba dang rgyal dbang thams cad mkhyen ba chu bzhi ba thugs sras kam tshhang ston ba gsal byed mtshhur phu rje dpon mchog sprul rnam ba gnyis dang 
BO_TZ_LAMRIM-YISHE-NYINGPO-P2:6646	mkhyen ldan da ki bde chen chos sgron nas kyang gser gyi me tog bcas ring nas bskul cing slad du gter sras rig 'dzin tshhe dbang grags pa dang lhan cig gsung bskul gnang ba dang / byang sems dge ba'i bshes gnyen tshhwa nyag bla ma shes rab gtshor gyur mos ldan gzhan dag gis kyang nan bskyar mdzad pa la brten /	664	mkhyen ldan da ki bde chen chos sgron nas kyang gser gyi me tog cha ring nas skul cing slad du gter sras rig dzin tshhe dbang grags ba dang lhan cig gsung skul gnang ba dang byang sems dge ba bshes gnyen tshhwa nyag bla ma shes rab gtshor gyur mos ldan gzhan dag gis kyang nan skyor mdzad ba la rten 
BO_TZ_LAMRIM-YISHE-NYINGPO-P2:6647	thams cad mkhyen gzigs 'jam mgon bla ma rin po ches bstshal pa'i sa bcad dang / zhal gyi bdud rtshi dngos su thob pa yid yul gang mchis gtshor bzung /	664	thams cad mkhyen gzigs jam mgon bla ma rin po ches bstshal ba sa gcod dang zhal gyi bdud rtshi dngos su thob ba yid yul gang mchis gtshor bzung 
BO_TZ_LAMRIM-YISHE-NYINGPO-P2:6648	'thad 'os kyi cha 'ga' zhig mkhas pa gzhan gyi legs bshad las kyang blangs te blun sgom spong ba pa'i gzugs brnyan pad+ma gar dbang blo gros mtha' yas sam /	664	thad s kyi cha ga jig mkhas ba gzhan gyi legs chad las kyang blangs te blun sgom spong ba ba gzugs rnyan pad+ma gar dbang blo gros mtha yas sam 
BO_TZ_LAMRIM-YISHE-NYINGPO-P2:6649	'chi med bstan gnyis g.yung drung gling pa rtshal gyis shri de bi ko ti dpal spungs yang khrod tsha 'dra rin chen brag gi sgrub gnas su go sla 'dus gsal gyi tshhul du bgyis pa bstan 'gror phan bde'i snang ba mi nub dar zhing rgyas pa'i rgyur gyur	664	chi med ston gnyis g.yung drung gling ba rtshal gyis shri de bi ko ti dpal spung yang khrod tsha dra rin chen brag gi sgrub gnas su go sla du gsal gyi tshhul du bgyid ba ston gror phan bde snang ba mi nub dar zhing rgya ba rgyur gyur 
BO_TZ_LAMRIM-YISHE-NYINGPO-P2:6650	cig ! /om swasti /	665	cig swasti 
BO_TZ_LAMRIM-YISHE-NYINGPO-P2:6651	'chi med mtshhor 'khrungs rgyal bas skal bzang 'gror //	665	chi med mtshhor khrung rgyal ba skal bzang gror 
BO_TZ_LAMRIM-YISHE-NYINGPO-P2:6652	mdo sngags lam rim yongs rdzogs zhal gdams su //	665	mdo sngags lam rim yongs rdzogs zhal doms su 
BO_TZ_LAMRIM-YISHE-NYINGPO-P2:6653	bstshal pa'i gzhung bzang 'jam mgon bla ma yis //	665	bstshal ba gzhung bzang jam mgon bla ma yis 
BO_TZ_LAMRIM-YISHE-NYINGPO-P2:6654	rdo rje'i tshhig don 'grel ba'i legs bshad gang //	665	rdo rje tshhig don grel ba legs chad gang 
BO_TZ_LAMRIM-YISHE-NYINGPO-P2:6655	lung rtogs mdzod 'dzin mchog sprul rin po che //	665	lung rtogs mdzod dzin mchog sprul rin po che 
BO_TZ_LAMRIM-YISHE-NYINGPO-P2:6656	dkon mchog 'gyur med bstan pa'i rgyal mtshhan gyis //	665	dkon(d) mchog gyur med ston ba rgyal mtshhan gyis 
BO_TZ_LAMRIM-YISHE-NYINGPO-P2:6657	gcig las du mar 'char ba'i par gyi 'phrul //	665	gcig las du mar char ba ba gyi phrul 
BO_TZ_LAMRIM-YISHE-NYINGPO-P2:6658	tshi ke nor bu gling gi chos grwar bsgrubs //	665	tshi ke nor bu gling gi chos grwar sgrub 
BO_TZ_LAMRIM-YISHE-NYINGPO-P2:6659	de dge dung dang kun+da ltar dkar bas //	665	de dge dung dang kun+da ltar dkar ba 
BO_TZ_LAMRIM-YISHE-NYINGPO-P2:6660	gzhi rgyud rigs sad yang dag lta ba rtogs //	666	gzhi brgyud rigs sad yang dag lta ba rtogs 
BO_TZ_LAMRIM-YISHE-NYINGPO-P2:6661	lam rgyud sku bzhi ye shes mngon gyur shog	666	lam brgyud sku bzhi ye shes mngon gyur shog 
BO_TZ_LAMRIM-YISHE-NYINGPO-P2:6662	/ces par byang smon tshhig tu chos smra ba'i ban+de blo gros rgya mtshhos bris pa dge legs 'phel //	666	ba byang smon tshhig tu chos smra ba ban+de blo gros rgya mtshhos bri ba dge legs phel 
BO_TZ_LAMRIM-YISHE-NYINGPO-P2:6663	sarba da ka l+ya nam b+ha wan+tu ///	666	sarba da ka l+ya nam b+ha wan+tu 
