segmentnr	original	folio	stemmed
BO_TZ_PEMA-SANGTHIG-P33:0	@#// pad+ma gsang ba'i thig le las /	0	pad+ma gsang ba thig le las 
BO_TZ_PEMA-SANGTHIG-P33:1	thun mong tshhe yi dbang bskur 'chi med grub pa'i bcud len zhes bya ba bzhugs so //	0	thun mong tshhe yi dbang skur chi med grub ba bcud len zhes byed ba bzhugs so 
BO_TZ_PEMA-SANGTHIG-P33:2	na mo pad+maka ra ye /	0	na mo pad+maka ra ye 
BO_TZ_PEMA-SANGTHIG-P33:3	dkyil 'khor kun gyi khyab pa'i bdag	0	dkyil khor kun gyi khyab ba bdag 
BO_TZ_PEMA-SANGTHIG-P33:4	/'chi med pad+ma sam b+ha war //	0	med pad+ma sam b+ha war 
BO_TZ_PEMA-SANGTHIG-P33:5	sgo gsum gus pas rab btud de //	0	sgo gsum gus ba rab dud de 
BO_TZ_PEMA-SANGTHIG-P33:6	tshhe yi dbang bskur 'jug bder bsdeb //	0	tshhe yi dbang skur jug bder sdeb 
BO_TZ_PEMA-SANGTHIG-P33:7	'di la gsum /	0	di la gsum 
BO_TZ_PEMA-SANGTHIG-P33:8	sbyor dngos rjes so //	0	sbyor dngos rjes so 
BO_TZ_PEMA-SANGTHIG-P33:9	dang po ni /	0	dang po ni 
BO_TZ_PEMA-SANGTHIG-P33:10	stegs bu'i khar man+dal tshhom bu lha grangs bkod pa'i steng many+dzi'i khar tshhe 'brang bum gzugs rgyan spros can /	1	stegs bu khar man+dal tshhom bu lha grangs bkod ba steng many+dzi khar tshhe brang bum gzugs rgyan spros can 
BO_TZ_PEMA-SANGTHIG-P33:11	g.yas g.yon du thabs shes kyi rdzas tshhe ril /	1	g.yas g.yon du thabs shes kyi rdzas tshhe ril 
BO_TZ_PEMA-SANGTHIG-P33:12	tshhe chang / mda' dar /	1	tshhe chang mda dar 
BO_TZ_PEMA-SANGTHIG-P33:13	sman raka gtor gsum /	1	sman raka thor gsum 
BO_TZ_PEMA-SANGTHIG-P33:14	nyer spyod / sngon 'gro'i gtor ma sogs dgos pa'i yo byad 'du bya'o //	1	nyer spyod sngon gro thor ma sogs dgos ba yo byad du byed 
BO_TZ_PEMA-SANGTHIG-P33:15	de nas 'chi med tshhe yi phrin las btang ste /	1	de nas chi med tshhe yi phrin las gtong ste 
BO_TZ_PEMA-SANGTHIG-P33:16	bzlas pa'i thog mar dzapa? khang dbyes la /	1	bzlas ba thogs mar dzapa? khang dbyes la 
BO_TZ_PEMA-SANGTHIG-P33:17	bdag mdun lha yi skur gsal ba'i :	1	bdag mdun lha yi skur gsal ba 
BO_TZ_PEMA-SANGTHIG-P33:18	snying dbus dag pa'i sogs kyis bdag mdun sgrub rdzas rnams dmigs bzlas kyis khyab par byas la /	1	snying dbus dag ba sogs kyis bdag mdun sgrub rdzas rnams dmigs bzlas kyis khyab ba byed la 
BO_TZ_PEMA-SANGTHIG-P33:19	rtsha sngags ci 'grub bzla /	1	rtsha sngags ci grub bzla 
BO_TZ_PEMA-SANGTHIG-P33:20	bdag mdun gtsho 'khor rnams kyi sku las lha mo mgyogs ma'i sprul pa nyi zer gyi rdul ltar 'phros pas /	2	bdag mdun gtsho khor rnams kyi sku las lha mo mgyog ma sprul ba nyi zer gyi rdul ltar phro ba 
BO_TZ_PEMA-SANGTHIG-P33:21	rang gzhan gyi bla tshhe chad nyams yar pa thams cad 'od zer thig le kha dog lnga ldan gyi rnam par bsdus te bdag gnas sgrub pa'i rdzas la thim par bsam la /	2	rang gzhan gyi bla tshhe chad nyams yar ba thams cad d zer thig le kha dog lnga ldan gyi rnam ba sdud te bdag gnas sgrub ba rdzas la thim ba bsam la 
BO_TZ_PEMA-SANGTHIG-P33:22	gzhung gsal tshhe 'gugs lan gsum sogs gyer zhing /	2	gzhung gsal tshhe gugs lan gsum sogs gyer zhing 
BO_TZ_PEMA-SANGTHIG-P33:23	stong tshhigs mchod bstod 'bul /	2	stong tshhigs mchod bstod bul 
BO_TZ_PEMA-SANGTHIG-P33:24	rig pa'i me tog dor zhing slob ma 'jug par gnang bar zhu ba bcas song nas /	2	rig ba me tog dor zhing slob ma jug ba gnang ba ju ba cha gro nas 
BO_TZ_PEMA-SANGTHIG-P33:25	gnyis pa dngos gzhi dbang bskur ba la /	2	gnyis ba dngos gzhi dbang skur ba la 
BO_TZ_PEMA-SANGTHIG-P33:26	slob ma rnams las khrus bya /	2	slob ma rnams las khru byed 
BO_TZ_PEMA-SANGTHIG-P33:27	bgegs gtor byin gyis brlabs nas las byang ltar bgegs gtor btang zhing srung 'khor bsgom /	2	bgegs thor byin gyis brlabs nas las byang ltar bgegs thor gtong zhing srung khor bsgom 
BO_TZ_PEMA-SANGTHIG-P33:28	gral du 'khod de sems bskyed gsal gdab spyi ltar song nas chos bshad kyi khyad par /	2	gral du khod de sems skyed gsal gdab spyi ltar gro nas chos chad kyi khyad ba 
BO_TZ_PEMA-SANGTHIG-P33:29	de yang ji skad du /	2	de yang ji skad du 
BO_TZ_PEMA-SANGTHIG-P33:30	slob dpon ngag gi dbang phyug grags pa'i zhal snga nas /	3	slob dpon ngag gi dbang phyug grags ba zhal snga nas 
BO_TZ_PEMA-SANGTHIG-P33:31	'khor bar srog las gces pa ni //	3	khor ba srog las gces ba ni 
BO_TZ_PEMA-SANGTHIG-P33:32	'ga' yang yod pa ma yin te //	3	ga yang yod ba ma yin te 
BO_TZ_PEMA-SANGTHIG-P33:33	de bas myur du thabs mang pos //	3	de ba myur du thabs mang pos 
BO_TZ_PEMA-SANGTHIG-P33:34	'chi ba blu ba yang dag brtsham //	3	chi ba blu ba yang dag brtsham 
BO_TZ_PEMA-SANGTHIG-P33:35	zhes gsungs pa ltar /	3	zhes gsungs ba ltar 
BO_TZ_PEMA-SANGTHIG-P33:36	'chi ba blu ba'i thabs mdo rgyud bstan bcos rnams su mtha' klas par gsungs pa las /	3	chi ba blu ba thabs mdo brgyud ston chos rnams su mtha klas ba gsungs ba las 
BO_TZ_PEMA-SANGTHIG-P33:37	da lam skabs su babs pa /	3	da lam skabs su bab ba 
BO_TZ_PEMA-SANGTHIG-P33:38	dus gsum kun mkhyen ma ha gu ru'i thugs tig pad+ma zab pa rtsha ba'i rgyud dang rjes su 'brel ba'i thun mong tshhe yi dbang bskur zab mo sgrub pa la bdag nyid kyis bgyi bar 'os pa'i rim pa rnams sngon du legs par song ba yin pas /	3	dus gsum kun mkhyen ma ha gu ru thugs tig pad+ma zab ba rtsha ba brgyud dang rjes su brel ba thun mong tshhe yi dbang skur zab mo sgrub ba la bdag nyid kyis bgyid ba s ba rim ba rnams sngon du legs ba gro ba yin ba 
BO_TZ_PEMA-SANGTHIG-P33:39	khyed rnams kyi bya ba'i thog mar 'chi med tshhe yi dbang bskur gsan pa'i ched du man+dal /	3	khyed rnams kyi byed ba thogs mar chi med tshhe yi dbang skur gsan ba ched du man+dal 
BO_TZ_PEMA-SANGTHIG-P33:40	de ltar man+dal gyis mtshhams sbyar nas bla ma dang gnyis su med pa'i skyabs yul nam mkha' gang bar bzhugs pa'i spyan sngar skyabs su 'gro ba 'di'i rjes zlos /	4	de ltar man+dal gyis mtshhams sbyor nas bla ma dang gnyis su med ba skyob yul nam mkha gang ba bzhugs ba spyan sngar skyob su gro ba di rjes zlos 
BO_TZ_PEMA-SANGTHIG-P33:41	na mo : gdod nas dag pa sogs lan gsum /	4	na mo gdod nas dag ba sogs lan gsum 
BO_TZ_PEMA-SANGTHIG-P33:42	yul mchog de dag gi spyan sngar smon pa dang 'jug pa'i bdag nyid can gyi sems bskyed pa 'di'i rjes zlos /	4	yul mchog de dag gi spyan sngar smon ba dang jug ba bdag nyid can gyi sems skyed ba di rjes zlos 
BO_TZ_PEMA-SANGTHIG-P33:43	ho : med bzhin snang ba sogs gsum /	4	ho med bzhin snang ba sogs gsum 
BO_TZ_PEMA-SANGTHIG-P33:44	rgyun bshags yan lag brgyad pa 'di'i rjes zlos /	4	rgyun chags yan lag brgyad ba di rjes zlos 
BO_TZ_PEMA-SANGTHIG-P33:45	'chi med tshhe yi sogs lan gsum /	4	chi med tshhe yi sogs lan gsum 
BO_TZ_PEMA-SANGTHIG-P33:46	khyad par 'chi med tshhe yi dbang bskur zhu ba'i ched du gsol ba 'debs pa 'di'i rjes zlos /	4	khyad ba chi med tshhe yi dbang skur ju ba ched du gsol ba debs ba di rjes zlos 
BO_TZ_PEMA-SANGTHIG-P33:47	kye ho : thugs rje'i bdag nyid slob dpon gyis :	4	kye ho thugs rje bdag nyid slob dpon gyis 
BO_TZ_PEMA-SANGTHIG-P33:48	bdag cag 'khor ba las sgrol phyir :	4	bdag cag khor ba las sgrol phyir 
BO_TZ_PEMA-SANGTHIG-P33:49	'chi med tshhe yi dkyil 'khor du :	4	chi med tshhe yi dkyil khor du 
BO_TZ_PEMA-SANGTHIG-P33:50	ma smin smin byed dbang bskur stshol :	5	ma smin smin byed dbang skur stshol 
BO_TZ_PEMA-SANGTHIG-P33:51	lan gsum / de nas dbang gi gzhi 'god pa ye shes pa dbab pa la dmigs pa 'di bzhin du mdzod /	5	lan gsum de nas dbang gi gzhi god ba ye shes ba bebs ba la dmigs ba di bzhin du mdzod 
BO_TZ_PEMA-SANGTHIG-P33:52	las sngags kyis bsang /	5	las sngags kyis bsang 
BO_TZ_PEMA-SANGTHIG-P33:53	swa b+ha was sbyang /	5	swa b+ha was sbyong 
BO_TZ_PEMA-SANGTHIG-P33:54	sgo gsum dngos 'dzin mi dmigs par //	5	sgo gsum dngos dzin mi dmigs ba 
BO_TZ_PEMA-SANGTHIG-P33:55	slob ma dpal chen he ru ka :	5	slob ma dpal chen he ru ka 
BO_TZ_PEMA-SANGTHIG-P33:56	rta mchog rgyal por gsal ba yi :	5	rta mchog rgyal por gsal ba yi 
BO_TZ_PEMA-SANGTHIG-P33:57	snying gar chu skyes nyi zla'i dbus :	5	snying gar chu skye nyi zla dbus 
BO_TZ_PEMA-SANGTHIG-P33:58	'chi med ye shes tshhe dpag med :	5	chi med ye shes tshhe dpog med 
BO_TZ_PEMA-SANGTHIG-P33:59	de yi thugs kar mkha' 'gro ma :	5	de yi thugs kar mkha gro ma 
BO_TZ_PEMA-SANGTHIG-P33:60	gsang ba ye shes dmar gsal mdangs :	6	gsang ba ye shes dmar gsal mdangs 
BO_TZ_PEMA-SANGTHIG-P33:61	da ru dkrol zhing thod chang bsnams :	6	da ru khrol zhing thod chang snom 
BO_TZ_PEMA-SANGTHIG-P33:62	'od dmar zhags pas bskor ba yi :	6	d dmar zhags ba skor ba yi 
BO_TZ_PEMA-SANGTHIG-P33:63	gsang bar g.yung drung ris dmar po :	6	gsang ba g.yung drung ris dmar po 
BO_TZ_PEMA-SANGTHIG-P33:64	g.yon phyogs drag tu 'khor ba las :	6	g.yon phyogs drag tu khor ba las 
BO_TZ_PEMA-SANGTHIG-P33:65	mkha' 'gro bde ba'i gar dang sgras :	6	mkha gro bde ba gar dang sgras 
BO_TZ_PEMA-SANGTHIG-P33:66	sras bcas rgyal rnams dbang med bkug :	6	sras cha rgyal rnams dbang med gugs 
BO_TZ_PEMA-SANGTHIG-P33:67	slob ma'i lus la thim par bsam :	6	slob ma lus la thim ba bsam 
BO_TZ_PEMA-SANGTHIG-P33:68	spro na byin 'beb dbyangs dang bcas gyer la /	6	spro na byin beb dbyangs dang cha gyer la 
BO_TZ_PEMA-SANGTHIG-P33:69	sngags mthar / satwam b+ha ya satwam b+ha ya /	6	sngags mthar satwam b+ha ya satwam b+ha ya 
BO_TZ_PEMA-SANGTHIG-P33:70	ra ra ra ra /	7	ra ra ra ra 
BO_TZ_PEMA-SANGTHIG-P33:71	tsha la ya tsha la ya /	7	tsha la ya tsha la ya 
BO_TZ_PEMA-SANGTHIG-P33:72	hrim hrim/ phem phem/	7	hrim phem 
BO_TZ_PEMA-SANGTHIG-P33:73	hu~m ahha dz+haimh zhes rol mo'i sgra dang bcas te byin dbab /	7	hu~m ahha dz+haimh zhes rol mo sgra dang cha te byin bebs 
BO_TZ_PEMA-SANGTHIG-P33:74	tish+tha badzrah zhes rdo rje me tog dang bcas spyi bor bzhag ste brtan par bya /	7	tish+tha badzrah zhes rdo rje me tog dang cha spyi bor jog ste brtan ba byed 
BO_TZ_PEMA-SANGTHIG-P33:75	dngos gzhi dbang bskur ba la thog mar tshhe bcud 'gugs pa'i slad du dmigs pa 'di bzhin du mdzod cig	7	dngos gzhi dbang skur ba la thogs mar tshhe bcud gugs ba slad du dmigs ba di bzhin du mdzod cig 
BO_TZ_PEMA-SANGTHIG-P33:76	/bdag mdun dkyil 'khor gyi lha tshhogs rnams kyi thugs ka nas 'od zer lcags kyu'i dbyibs can dang / lha mo mgyogs ma'i sprul pa nyi zer gyi rdul 'khrigs pa ltar stong gsum phyogs bcu'i 'jig rten gyi khams gang bar 'phros pas /	7	mdun dkyil khor gyi lha tshhogs rnams kyi thugs ka nas d zer lcags kyu dbyibs can dang lha mo mgyog ma sprul ba nyi zer gyi rdul khrig ba ltar stong gsum phyogs chu jig rten gyi khams gang ba phro ba 
BO_TZ_PEMA-SANGTHIG-P33:77	sa chu me rlung sogs 'byung ba chen po bzhi'i bcud dwangs ma /	7	sa chu me rlung sogs byung ba chen po bzhi bcud dwangs ma 
BO_TZ_PEMA-SANGTHIG-P33:78	nang bcud kyi sems can phyogs skyong rgyal chen tshhangs pa brgya byin 'khor los bsgyur ba'i rgyal po sogs kyi tshhe dang bsod nams /	7	nang bcud kyi sems can phyogs skyong rgyal chen tshhangs ba brgya byin khor los sgyur ba rgyal po sogs kyi tshhe dang bsod nams 
BO_TZ_PEMA-SANGTHIG-P33:79	dpal dang bkrag mdangs gzi brjid /	7	dpal dang bkrag mdangs gzi brjid 
BO_TZ_PEMA-SANGTHIG-P33:80	drang srong rig 'dzin tshhe la dbang ba rnams kyi mthu stobs nus pa tshhe yi dngos grub /	8	dren srong rig dzin tshhe la dbang ba rnams kyi mthu stobs nus ba tshhe yi dngos grub 
BO_TZ_PEMA-SANGTHIG-P33:81	'phags tshhogs 'jig rten las 'das pa sangs rgyas byang sems /	8	phag tshhogs jig rten las da ba sangs rgya byang sems 
BO_TZ_PEMA-SANGTHIG-P33:82	nyan thos rang rgyal rnams kyi tshhe yi byin rlabs /	8	nyan thos rang rgyal rnams kyi tshhe yi byin rlabs 
BO_TZ_PEMA-SANGTHIG-P33:83	khyad par bsgrub bya rnams kyi bla tshhe yar pa /	8	khyad ba sgrub byed rnams kyi bla tshhe yar ba 
BO_TZ_PEMA-SANGTHIG-P33:84	'thor ba / byad ma gdon bgegs 'byung pos brkus phrogs khyer pa thams cad dwangs ma'i thig le 'od zer kha dog sna tshhogs /	8	thor ba byad ma don bgegs byung pos rku phrog khyer ba thams cad dwangs ma thig le d zer kha dog sna tshhogs 
BO_TZ_PEMA-SANGTHIG-P33:85	srog rten a nr-i hu~m gsum gyi rnam pa dpag tu med par spyan drangs te mdun bskyed sgrub rdzas rnams la sib sib thim pas /	8	srog rten a nr-i hu~m gsum gyi rnam ba dpog tu med ba spyan drangs te mdun skyed sgrub rdzas rnams la sib sib thim ba 
BO_TZ_PEMA-SANGTHIG-P33:86	grub pa'i dngul chu bzhin du dge legs dpal yon gyi snang ba mchog tu 'bar ba'i dwangs ma thig le chen por gyur par bsam la tshhe 'gugs dbyangs dang bcas te gyer /	8	grub ba dngul chu bzhin du dge legs dpal yon gyi snang ba mchog tu bar ba dwangs ma thig le chen por gyur ba bsam la tshhe gugs dbyangs dang cha te gyer 
BO_TZ_PEMA-SANGTHIG-P33:87	de nas tshhe yi 'brang rgyas 'di nyid snod bcud yongs rdzogs rab 'byams tshhe lha'i dkyil 'khor chen por gsal ba khyed rang rnams kyi spyi bor bzhag pas /	8	de nas tshhe yi brang rgya di nyid snod bcud yongs rdzogs rab byam tshhe lha dkyil khor chen por gsal ba khyed rang rnams kyi spyi bor jog ba 
BO_TZ_PEMA-SANGTHIG-P33:88	lha tshhogs rnams kyi gnas gsum dang gtsho bo'i phyag mtshhan tshhe bum dang gsang ba'i sbyor mtshhams nas 'chi med ye shes kyi bdud rtshi'i rgyun dpag tu med pa babs /	8	lha tshhogs rnams kyi gnas gsum dang gtsho bo phyag mtshhan tshhe bum dang gsang ba sbyor mtshhams nas chi med ye shes kyi bdud rtshi rgyun dpog tu med ba bab 
BO_TZ_PEMA-SANGTHIG-P33:89	khyed rang gi lus kyi nang thams cad gang /	8	khyed rang gi lus kyi nang thams cad gang 
BO_TZ_PEMA-SANGTHIG-P33:90	dbang bzhi'i rim pa thod rgal du thob /	9	dbang bzhi rim ba thod rgal du thob 
BO_TZ_PEMA-SANGTHIG-P33:91	sku gsung thugs ye shes rdo rje'i tshhe yi dngos grub thams cad thob pa'i mos pa mdzod cig	9	sku gsung thugs ye shes rdo rje tshhe yi dngos grub thams cad thob ba mos ba mdzod cig 
BO_TZ_PEMA-SANGTHIG-P33:92	/om: mi 'gyur snying po 'od gsal ba :	9	mi gyur snying po d gsal ba 
BO_TZ_PEMA-SANGTHIG-P33:93	rdo rje'i rang bzhin 'pho 'gyur bral :	9	rdo rje rang bzhin pho gyur bral 
BO_TZ_PEMA-SANGTHIG-P33:94	lhar snang ye shes phyag rgya che :	9	lhar snang ye shes phyag rgya che 
BO_TZ_PEMA-SANGTHIG-P33:95	sku gsung thugs kyi dbang bskur ro :	9	sku gsung thugs kyi dbang skur ro 
BO_TZ_PEMA-SANGTHIG-P33:96	ka ya wa ka tshit+ta a b+hi shiny+tsha hu~m:	9	ka ya wa ka tshit+ta a b+hi shiny+tsha hu~m: 
BO_TZ_PEMA-SANGTHIG-P33:97	zhes spyi bor bzhag cing dbang bskur /	9	zhes spyi bor jog cing dbang skur 
BO_TZ_PEMA-SANGTHIG-P33:98	lag g.yas su thabs kyi rdzas tshhe yi ril bu byin pa myang pas bde chen rdo rje'i tshhe la mnga' brnyes pa'i mos pa mdzod cig	9	lag g.yas su thabs kyi rdzas tshhe yi ril bu byin ba myang ba bde chen rdo rje tshhe la mnga brnyes ba mos ba mdzod cig 
BO_TZ_PEMA-SANGTHIG-P33:99	/om: bkra shis snying po tshhe yi dngos :	9	bkra shis snying po tshhe yi dngos 
BO_TZ_PEMA-SANGTHIG-P33:100	rtag pa dam pa rdo rje'i srog :	10	rtag ba dam ba rdo rje srog 
BO_TZ_PEMA-SANGTHIG-P33:101	grub pa'i bcud len 'chi med dbyig :	10	grub ba bcud len chi med dbyig 
BO_TZ_PEMA-SANGTHIG-P33:102	myang pas ye shes mchog thob bsam :	10	myang ba ye shes mchog thob bsam 
BO_TZ_PEMA-SANGTHIG-P33:103	om badzra a yu she sid+d+hi pha la hu~m:	10	om badzra a yu she sid+d+hi pha la hu~m: 
BO_TZ_PEMA-SANGTHIG-P33:104	lag g.yon du shes rab kyi rdzas tshhe yi bdud rtshi byin pa la brten /	10	lag g.yon du shes rab kyi rdzas tshhe yi bdud rtshi byin ba la rten 
BO_TZ_PEMA-SANGTHIG-P33:105	rnam kun mchog ldan ye shes chen po'i tshhe la mnga' brnyes pa'i mos pa mdzod cig	10	rnam kun mchog ldan ye shes chen po tshhe la mnga brnyes ba mos ba mdzod cig 
BO_TZ_PEMA-SANGTHIG-P33:106	/om: bkra shis snying po sogs nas /	10	bkra shis snying po sogs nas 
BO_TZ_PEMA-SANGTHIG-P33:107	sid+d+hi pha la hu~m:	10	sid+d+hi pha la hu~m: 
BO_TZ_PEMA-SANGTHIG-P33:108	de ltar lus kyi nang thams cad 'chi med tshhe yi bdud rtshis gang ba dwangs ma'i dwangs ma thams cad khyed rang rta mgrin du gsal ba'i snying gar hu~m gi khog par nr-i yig as mtshhan pa la thim pas 'chi med rdo rje'i srog 'grub /	10	de ltar lus kyi nang thams cad chi med tshhe yi bdud rtshis gang ba dwangs ma dwangs ma thams cad khyed rang rta mgrin du gsal ba snying gar hu~m gi khog ba nr-i yig as mtshhan ba la thim ba chi med rdo rje srog grub 
BO_TZ_PEMA-SANGTHIG-P33:109	tshhe rten de nyid yi ge hu~m kha sbyor gyi rgyas btab pas gzhom zhig 'pho 'gyur dang bral ba'i rdo rje'i tshhe thob pa'i mos pa mdzod cig	10	tshhe rten de nyid yi ge hu~m kha sbyor gyi rgya debs ba joms jig pho gyur dang bral ba rdo rje tshhe thob ba mos ba mdzod cig 
BO_TZ_PEMA-SANGTHIG-P33:110	/a : 'byung lnga'i khams nas yar pa'i tshhe :	11	byung lnga khams nas yar ba tshhe 
BO_TZ_PEMA-SANGTHIG-P33:111	yum lnga'i klong du phyag rgyas btab :	11	yum lnga klong du phyag rgya debs 
BO_TZ_PEMA-SANGTHIG-P33:112	'pho 'gyur med pa rdo rje'i tshhe :	11	pho gyur med ba rdo rje tshhe 
BO_TZ_PEMA-SANGTHIG-P33:113	gzhom med klong du a ti ho :	11	joms med klong du a ti ho 
BO_TZ_PEMA-SANGTHIG-P33:114	zhes mda' dar spyi bor rgya gram du bzhag cing rgyas gdab /	11	zhes mda dar spyi bor rgya grams du jog cing rgya gdab 
BO_TZ_PEMA-SANGTHIG-P33:115	de ltar 'chi med tshhe yi dbang bskur yongs su rdzogs pa la nam mkha' gang ba'i rtsha gsum rgyal ba rab 'byams kyis shis pa brjod pas mnga' gsol ba'i mos mdzod cig	11	de ltar chi med tshhe yi dbang skur yongs su rdzogs ba la nam mkha gang ba rtsha gsum rgyal ba rab byam kyis shis ba rjod ba mnga gsol ba mos mdzod cig 
BO_TZ_PEMA-SANGTHIG-P33:116	/ces brjod la /	11	rjod la 
BO_TZ_PEMA-SANGTHIG-P33:117	dkon mchog gsum gyi bkra shis sogs brjod /	11	dkon(d) mchog gsum gyi bkra shis sogs rjod 
BO_TZ_PEMA-SANGTHIG-P33:118	rjes kyi rim pa la /	11	rjes kyi rim ba la 
BO_TZ_PEMA-SANGTHIG-P33:119	dam tshhig khas blang /	11	dam tshhig khas blang 
BO_TZ_PEMA-SANGTHIG-P33:120	gtang rag 'bul ba /	12	gtong rag bul ba 
BO_TZ_PEMA-SANGTHIG-P33:121	dge ba bsngo ba sogs spyi ltar byas pas 'grub bo //	12	dge ba sngo ba sogs spyi ltar byed ba grub bo 
BO_TZ_PEMA-SANGTHIG-P33:122	zhes pa'ang nyer mkho'i yan lag tu bdud 'joms nam mkha'i rdo rjes bris pa 'gro kun 'chi ba'i 'jigs pa las myur du grol ba'i rgyur gyur cig	12	zhes ba nyer mkho yan lag tu bdud joms nam mkha rdo rjes bri ba gro kun chi ba jigs ba las myur du grol ba rgyur gyur cig 
BO_TZ_PEMA-SANGTHIG-P33:123	/sarba mang+ga lam/// /	12	mang+ga 
