segmentnr	original	folio	stemmed
BO_TZ_Terdzo-OM-P2:0	@#// rtsha ba gsum chos skyong nor gyi lhag pa'i lha rab 'byams kyi sgrub thabs 'dod 'jo'i bum bzang zhes bya ba bzhugs so //	0	rtsha ba gsum chos skyong nor gyi lhag ba lha rab byam kyi sgrub thabs dod jo bum bzang zhes byed ba bzhugs so 
BO_TZ_Terdzo-OM-P2:1	spyi chings /	0	spyi ching 
BO_TZ_Terdzo-OM-P2:2	om swasti / khyab bdag ston pa rdo rje sems dpa' nyid //	0	om swasti khyab bdag ston ba rdo rje sems dpa nyid 
BO_TZ_Terdzo-OM-P2:3	dpal ldan bla ma mchog gi rnam rol can //	0	dpal ldan bla ma mchog gi rnam rol can 
BO_TZ_Terdzo-OM-P2:4	rab 'byams dkyil 'khor rgya mtshhor yongs 'char ba'i //	0	rab byam dkyil khor rgya mtshhor yongs char ba 
BO_TZ_Terdzo-OM-P2:5	ngo mtshhar sgyu ma'i byed po der phyag 'tshhal //	0	ngo mtshhar sgyu ma byed po der phyag tshhal 
BO_TZ_Terdzo-OM-P2:6	gdod ma'i ye shes dbyings su dbyer med kyang //	0	gdod ma ye shes dbyings su dbyer med kyang 
BO_TZ_Terdzo-OM-P2:7	sna tshhogs 'gro blo'i rjes su thugs rje'i rtshal //	0	sna tshhogs gro blo rjes su thugs rje rtshal 
BO_TZ_Terdzo-OM-P2:8	rtsha gsum 'khor lo'i rnam rol mtha' yas par //	0	rtsha gsum khor lo rnam rol mtha yas ba 
BO_TZ_Terdzo-OM-P2:9	'char ba'i pha mtha' 'di zhes mtshhon du ci //	0	char ba pha mtha di zhes mtshhon du ci 
BO_TZ_Terdzo-OM-P2:10	'on kyang rang skal mnyam pa'i dman blo can //	1	n kyang rang skal mnyam ba dman blo can 
BO_TZ_Terdzo-OM-P2:11	'gro la rjes brtshe'i phan pa lhur byed pas //	1	gro la rjes brtshe phan ba lhur byed ba 
BO_TZ_Terdzo-OM-P2:12	rgya che'i sgrub thabs chu gter ma brgal kyang //	1	rgya che sgrub thabs chu gter ma rgol kyang 
BO_TZ_Terdzo-OM-P2:13	rab zab snying po'i bdud rtshis 'dod ster byed //	1	rab zab snying po bdud rtshis dod ster byed 
BO_TZ_Terdzo-OM-P2:14	de phyir rang gzhan phan bde yis //	1	de phyir rang gzhan phan bde yis 
BO_TZ_Terdzo-OM-P2:15	kun dgar byed pa bdud rtshi'i skyes //	1	kun dgar byed ba bdud rtshi skye 
BO_TZ_Terdzo-OM-P2:16	sgruba~x pa'i thaba~xs tshhul 'do~xd 'jo~x yi //	1	sgruba~x ba thaba~xs tshhul do~xd jo~x yi 
BO_TZ_Terdzo-OM-P2:17	buma~x pa bza~xng po'i dpal 'di sbyin //	1	buma~x ba bza~xng po dpal di sbyin 
BO_TZ_Terdzo-OM-P2:18	de yang rdo rje theg pa'i chos tshhul rnams las /	1	de yang rdo rje theg ba chos tshhul rnams las 
BO_TZ_Terdzo-OM-P2:19	lhag pa'i lha du ma'i sgrub thabs mtha' yas pa zhig	1	lhag ba lha du ma sgrub thabs mtha yas ba jig 
BO_TZ_Terdzo-OM-P2:20	/skal pa dang ldan pa'i 'gro ba rnams kyi bsam pa dang rjes su mthun par byung ba las /	2	ba dang ldan ba gro ba rnams kyi bsam ba dang rjes su mthun ba byung ba las 
BO_TZ_Terdzo-OM-P2:21	'dir byin rlabs kyi bka' srol ma nyams par rgyun chags su bzhugs pa'i sgrub thabs nye bar mkho ba dag phyogs gcig tu sdeb pa la /	2	dir byin rlabs kyi bka srol ma nyams ba rgyun chags su bzhugs ba sgrub thabs nye ba mkho ba dag phyogs gcig tu sdeb ba la 
BO_TZ_Terdzo-OM-P2:22	de dag kyang byin rlabs dang rjes gnang dang rig gtad dang bzlas lung la sogs pa'i cho ga'i rnam grangs tha dad pa'i tshhul can te /	2	de dag kyang byin rlabs dang rjes gnang dang rig gtod dang bzlas lung la sogs ba cho ga rnam grangs tha dad ba tshhul can te 
BO_TZ_Terdzo-OM-P2:23	de thams cad kyang dang por dkyil 'khor chen po gcig tu dbang bskur ba thob cing dam tshhig dang ldan pa dag la sbyin par bya ba yin gyi /	2	de thams cad kyang dang por dkyil khor chen po gcig tu dbang skur ba thob cing dam tshhig dang ldan ba dag la sbyin ba byed ba yin gyi 
BO_TZ_Terdzo-OM-P2:24	gzhan du na 'bras bu mchog thob pa las ring du 'gyur ba'o //	2	gzhan du na bras bu mchog thob ba las ring du gyur ba 
BO_TZ_Terdzo-OM-P2:25	des na slob dpon yang 'di nyid thob pa tsham gyis mi chog ste /	2	des na slob dpon yang di nyid thob ba tsham gyis mi chog ste 
BO_TZ_Terdzo-OM-P2:26	rab tu dkyil 'khor gyi bdag po 'dir bstan lha rigs gtsho bo rnams kyi bsnyen pa song ba'am /	2	rab tu dkyil khor gyi bdag po dir ston lha rigs gtsho bo rnams kyi snyen ba gro ba 
BO_TZ_Terdzo-OM-P2:27	min na'ang dkyil 'khor chen po gcig gi bsnyen pa thems shing cho ga lag len la mkhas pa /	2	min na dkyil khor chen po gcig gi snyen ba thems shing cho ga lag len la mkhas ba 
BO_TZ_Terdzo-OM-P2:28	khyad par 'di nyid kyi cho ga dang lag len la goms 'dris dang ldan pa zhig nges par dgos so //	2	khyad ba di nyid kyi cho ga dang lag len la goms dris dang ldan ba jig nges ba dgos so 
BO_TZ_Terdzo-OM-P2:29	de la sgrub thabs yongs su grags pa rnams nye bar mkho ba'i phyir dang / shin tu dkon pa 'ga' zhig ni rgyun mi chad par bya ba'i phyir dang / phyi 'gyur gyi sgrub thabs 'ga' zhig kyang nyer mkho'i dbang du byas nas phyogs gcig tu bkod pa'i rnam grangs ni 'di ltar ro /	2	de la sgrub thabs yongs su grags ba rnams nye ba mkho ba phyir dang shin tu dkon(d) ba ga jig ni rgyun mi chad ba byed ba phyir dang phyi gyur gyi sgrub thabs ga jig kyang nyer mkho dbang du byed nas phyogs gcig tu bkod ba rnam grangs ni di ltar ro 
BO_TZ_Terdzo-OM-P2:30	7 /de la bla ma zhi ba'i skor la /	3	la bla ma zhi ba skor la 
BO_TZ_Terdzo-OM-P2:31	bla ma gsang 'dus las thod phreng rtshal sgos sgrub kyi zlum po bzhi dbang /	3	bla ma gsang du las thod phreng rtshal sgos sgrub kyi zlum po bzhi dbang 
BO_TZ_Terdzo-OM-P2:32	gsang 'dus gtor dbang gnad kyi shog gcig mar grags pa /   pad gling dang chu bo gcig 'dres /	3	gsang du thor dbang gnad kyi shog gcig mar grags ba pad gling dang chu bo gcig dre 
BO_TZ_Terdzo-OM-P2:33	nyang gter bla ma yongs rdzogs kyi gtor dbang rnams so /	3	nyang gter bla ma yongs rdzogs kyi thor dbang rnams so 
BO_TZ_Terdzo-OM-P2:34	7 /bla ma drag po'i skor la /	3	ma drag po skor la 
BO_TZ_Terdzo-OM-P2:35	nyang gter drag dmar bde 'dus kyi dbang bka' rdo rje spyi blugs /   rdor gling dang pad gling chu bo gcig 'dres /	3	nyang gter drag dmar bde du kyi dbang bka rdo rje spyi blugs rdar gling dang pad gling chu bo gcig dre 
BO_TZ_Terdzo-OM-P2:36	'bring po me'i spu gri'i dbang chog	3	bring po me spu gri dbang chog 
BO_TZ_Terdzo-OM-P2:37	/che 'bring gnyis ka dang 'brel ba'i byin rlabs lu gu rgyud /	3	bring gnyis ka dang brel ba byin rlabs lu gu brgyud 
BO_TZ_Terdzo-OM-P2:38	drag dmar bka' ma 'o bran lugs /	3	drag dmar bka ma mang bran lugs 
BO_TZ_Terdzo-OM-P2:39	byang gter drag po rtshal gyi byin rlabs thugs rje'i dbang bskur rnams so /	3	byang gter drag po rtshal gyi byin rlabs thugs rje dbang skur rnams so 
BO_TZ_Terdzo-OM-P2:40	7 /tshhe dpag med kyi skor la /	4	dpog med kyi skor la 
BO_TZ_Terdzo-OM-P2:41	tshhe dpag med lung lugs sangs rgyas gsang ba'i man ngag	4	tshhe dpog med lung lugs sangs rgya gsang ba man ngag 
BO_TZ_Terdzo-OM-P2:42	/chos dbang gi gter ma   nyang dang zung 'brel /bla ma longs sku'i rdzong chen tshhe dbang /	4	dbang gi gter ma nyang dang zung brel ma longs sku rdzong chen tshhe dbang 
BO_TZ_Terdzo-OM-P2:43	byang gter tshhe sgrub lcags sdong ma /	4	byang gter tshhe sgrub lcags sdong ma 
BO_TZ_Terdzo-OM-P2:44	pad gling tshhe sgrub rdo rje phreng ba'i tshhe dbang sgrub khog las gsung rgyun bzhin phyung pa /	4	pad gling tshhe sgrub rdo rje phreng ba tshhe dbang sgrub khog las gsung rgyun bzhin byin ba 
BO_TZ_Terdzo-OM-P2:45	grub thob thang stong pa'i gdams pa 'chi med dpal ster gyi tshhe sgrub rnams so /	4	grub thob thang stong ba doms ba chi med dpal ster gyi tshhe sgrub rnams so 
BO_TZ_Terdzo-OM-P2:46	7 /spyan ras gzigs kyi skor la /	4	ras gzigs kyi skor la 
BO_TZ_Terdzo-OM-P2:47	thugs rje chen po rgyal po lugs phyag bzhi pa /	4	thugs rje chen po rgyal po lugs phyag bzhi ba 
BO_TZ_Terdzo-OM-P2:48	rgyal po lugs kyi bcu gcig zhal /	4	rgyal po lugs kyi chu gcig zhal 
BO_TZ_Terdzo-OM-P2:49	rgyal ba rgya mtshho bde gshegs bzhi sgril gyi sgrub thabs rnams so /	4	rgyal ba rgya mtshho bde gshegs bzhi sgril gyi sgrub thabs rnams so 
BO_TZ_Terdzo-OM-P2:50	7 /'jam dpal gshin rje'i skor la /	5	dpal gshin rje skor la 
BO_TZ_Terdzo-OM-P2:51	tshhe bdag yang zlog me'i spu gri'i rnon po nang gcod kyi dbang bka'o /	5	tshhe bdag yang zlog me spu gri rnon po nang gcod kyi dbang bka 
BO_TZ_Terdzo-OM-P2:52	7 /rta mgrin gyi skor la /	5	mgrin gyi skor la 
BO_TZ_Terdzo-OM-P2:53	rta mgrin gsang sgrub shangs lugs /	5	rta mgrin gsang sgrub shangs lugs 
BO_TZ_Terdzo-OM-P2:54	nyang gter rta nag lcags ral can /	5	nyang gter rta nag lcags ral can 
BO_TZ_Terdzo-OM-P2:55	chos dbang lugs rta nag gi sgrub thabs rnams so /	5	chos dbang lugs rta nag gi sgrub thabs rnams so 
BO_TZ_Terdzo-OM-P2:56	7 /phyag rdor gyi skor la /	5	rdar gyi skor la 
BO_TZ_Terdzo-OM-P2:57	las 'brel rtshal gyi phyag rdor dregs 'dul bum pa dang gtor ma'i las tshhogs la brten pa /   rdor gling dang pad gling chu bo gcig 'dres /	5	las brel rtshal gyi phyag rdar dregs dul bum ba dang thor ma las tshhogs la rten ba rdar gling dang pad gling chu bo gcig dre 
BO_TZ_Terdzo-OM-P2:58	byang chub gling pa'i phyag rdor gtum po drag po /	5	byang chub gling ba phyag rdar thum po drag po 
BO_TZ_Terdzo-OM-P2:59	grwa pa'i gter ma phyag rdor khang brtshegs kyi sgrub thabs rnams so /	5	grwa ba gter ma phyag rdar khang brtshegs kyi sgrub thabs rnams so 
BO_TZ_Terdzo-OM-P2:60	7 /phag mo'i skor la /	6	mo skor la 
BO_TZ_Terdzo-OM-P2:61	nyang gter mkha' 'gro chen mor grags pa phag mo zhal gnyis ma /	6	nyang gter mkha gro chen mor grags ba phag mo zhal gnyis ma 
BO_TZ_Terdzo-OM-P2:62	rdo rje phag mo don grub ma /	6	rdo rje phag mo don grub ma 
BO_TZ_Terdzo-OM-P2:63	phag mo dbu bcad ma /	6	phag mo dbu gcod ma 
BO_TZ_Terdzo-OM-P2:64	khros nag gi sgrub thabs rnams so /	6	khro nag gi sgrub thabs rnams so 
BO_TZ_Terdzo-OM-P2:65	7 /shes rab kyi lha'i skor la /	6	rab kyi lha skor la 
BO_TZ_Terdzo-OM-P2:66	ma ti lugs kyi 'jam dpal dkar po /	6	ma ti lugs kyi jam dpal dkar po 
BO_TZ_Terdzo-OM-P2:67	dam pa sangs rgyas kyi lugs 'jam dpal smra seng /	6	dam ba sangs rgya kyi lugs jam dpal smra seng 
BO_TZ_Terdzo-OM-P2:68	'phags ma dbyangs can ma'i sgrub thabs rnams so /	6	phag ma dbyangs can ma sgrub thabs rnams so 
BO_TZ_Terdzo-OM-P2:69	7 /phrin las kyi lha'i skor la /	6	las kyi lha skor la 
BO_TZ_Terdzo-OM-P2:70	rnam 'joms sangs rgyas gsang ba'i lugs /	7	rnam joms sangs rgya gsang ba lugs 
BO_TZ_Terdzo-OM-P2:71	rnam 'joms ba ri lugs /	7	rnam joms ba ri lugs 
BO_TZ_Terdzo-OM-P2:72	chos dbang lugs kyi drang srong lok+t+ri pa la /	7	chos dbang lugs kyi dren srong lok+t+ri ba la 
BO_TZ_Terdzo-OM-P2:73	rin chen gling pa'i na ga rak+sha'i sgrub thabs rnams so /	7	rin chen gling ba na ga rak+sha sgrub thabs rnams so 
BO_TZ_Terdzo-OM-P2:74	7 /bstan srung mgon po'i skor la /	7	srung mgon po skor la 
BO_TZ_Terdzo-OM-P2:75	dpal mgon legs ldan tshhogs kyi bdag po /	7	dpal mgon legs ldan tshhogs kyi bdag po 
BO_TZ_Terdzo-OM-P2:76	nyang gter dpal mgon phyag bzhi pa /	7	nyang gter dpal mgon phyag bzhi ba 
BO_TZ_Terdzo-OM-P2:77	mgon po dkar po'i tshhe dbang /	7	mgon po dkar po tshhe dbang 
BO_TZ_Terdzo-OM-P2:78	chos dbang lugs kyi ma ning /   'di la rdor gling rata gling pad gling 'ja' tshhon rnams chu bo gcig 'dres /	7	chos dbang lugs kyi ma ning di la rdar gling rata gling pad gling ja tshhon rnams chu bo gcig dre 
BO_TZ_Terdzo-OM-P2:79	gnubs lugs kyi dpal mgon stag zhon /	7	gnubs lugs kyi dpal mgon stag zhon 
BO_TZ_Terdzo-OM-P2:80	gnubs lugs kyi mgon po beng gi sgrub thabs rnams so /	8	gnubs lugs kyi mgon po beng gi sgrub thabs rnams so 
BO_TZ_Terdzo-OM-P2:81	7 /bstan srung sna tshhogs pa'i skor la /	8	srung sna tshhogs ba skor la 
BO_TZ_Terdzo-OM-P2:82	ye shes ma mo e ka dza ti sde bdun gyi sbrags sgrub /	8	ye shes ma mo e ka dza ti sde bdun gyi sbrag sgrub 
BO_TZ_Terdzo-OM-P2:83	snying thig ma mo e ka dza ti gtsho rkyang /	8	snying thig ma mo e ka dza ti gtsho rkyang 
BO_TZ_Terdzo-OM-P2:84	re ti rang byung ma bka' gter gnyis ldan /	8	re ti rang byung ma bka gter gnyis ldan 
BO_TZ_Terdzo-OM-P2:85	nyang gter gshog rgod ma /	8	nyang gter gshog rgod ma 
BO_TZ_Terdzo-OM-P2:86	las 'brel lugs lha mo srog sgrub ma /	8	las brel lugs lha mo srog sgrub ma 
BO_TZ_Terdzo-OM-P2:87	las 'brel lugs gza' rgod dug gi spu gri /	8	las brel lugs gza rgod dug gi spu gri 
BO_TZ_Terdzo-OM-P2:88	las 'brel lugs gnod sbyin bshan pa dmar nag	8	las brel lugs gnod sbyin bshan ba dmar nag 
BO_TZ_Terdzo-OM-P2:89	/rdor legs kyi sgrub thabs   byang gter dang rat+na'i /gter brgyud gnyis ldan /	8	legs kyi sgrub thabs byang gter dang rat+na brgyud gnyis ldan 
BO_TZ_Terdzo-OM-P2:90	rgyal sras legs ldan pa'i gter byon zhing skyong seng gdong can /	9	rgyal sras legs ldan ba gter byon zhing skyong seng gdong can 
BO_TZ_Terdzo-OM-P2:91	nyang gter dur khrod ma mo /	9	nyang gter dur khrod ma mo 
BO_TZ_Terdzo-OM-P2:92	chos dbang gi brtan ma bcu gnyis /	9	chos dbang gi brtan ma chu gnyis 
BO_TZ_Terdzo-OM-P2:93	nyang gter dkor bdag pe ha ra'i sgrub thabs rnams so /	9	nyang gter dkor bdag pe ha ra sgrub thabs rnams so 
BO_TZ_Terdzo-OM-P2:94	7 /nor lha'i skor la /	9	lha skor la 
BO_TZ_Terdzo-OM-P2:95	rnam sras   gnyal pa nyi she'i gter ma /phyi sgrub ser chen sprin gseb ma dang / nang sgrub mdung dmar can rta sngon ma /	9	rnam sras gnyal ba nyi she gter ma sgrub ser chen sprin gseb ma dang nang sgrub mdung dmar can rta sngon ma 
BO_TZ_Terdzo-OM-P2:96	gnubs lugs /   gsang sgrub drag po rta sngon ma /	9	gnubs lugs gsang sgrub drag po rta sngon ma 
BO_TZ_Terdzo-OM-P2:97	yang gsang phyag mtshhan bzhi pa /	9	yang gsang phyag mtshhan bzhi ba 
BO_TZ_Terdzo-OM-P2:98	grwa mngon gnod sbyin zhang blon rdo rje bdud 'dul /	9	grwa mngon gnod sbyin zhang blon rdo rje bdud dul 
BO_TZ_Terdzo-OM-P2:99	grwa mngon dzam dmar chags pa rdo rje /	9	grwa mngon dzam dmar chags ba rdo rje 
BO_TZ_Terdzo-OM-P2:100	las 'brel lha chen dbang phyug chen po'i sgrub thabs rnams so /	10	las brel lha chen dbang phyug chen po sgrub thabs rnams so 
BO_TZ_Terdzo-OM-P2:101	/de dag las thog mar bla ma gsang 'dus kyi zlum po bzhi dbang dang / drag po bde 'dus dang / 'jam dkar /	10	dag las thogs mar bla ma gsang du kyi zlum po bzhi dbang dang drag po bde du dang jam dkar 
BO_TZ_Terdzo-OM-P2:102	legs ldan sogs mtshhams sbyor tshhig sna bsrings pa rnams dang / sde tshhan re nas sgrub thabs dbang chog bcas pa re re tsham re thog mar blo la nges par bya'o //	10	legs ldan sogs mtshhams sbyor tshhig sna bsrings ba rnams dang sde tshhan re nas sgrub thabs dbang chog cha ba re re tsham re thogs mar blo la nges ba byed 
BO_TZ_Terdzo-OM-P2:103	de ltar le tshhan drug cu la brgyud pa'i bka' srol dang cho ga'i khyad par las nang gses su phye bas drug cu rtsha bdun no //	10	de ltar le tshhan drug cu la brgyud ba bka srol dang cho ga khyad ba las nang gses su byed ba drug cu rtsha bdun no 
BO_TZ_Terdzo-OM-P2:104	de rnams las 'jam dkar dang / 'jam dpal smra seng /	10	de rnams las jam dkar dang jam dpal smra seng 
BO_TZ_Terdzo-OM-P2:105	dbyangs can ma /	10	dbyangs can ma 
BO_TZ_Terdzo-OM-P2:106	rnam 'joms rigs gnyis rnams ni gsar ma las brgyud pa yin zhing /	10	rnam joms rigs gnyis rnams ni gsar ma las brgyud ba yin zhing 
BO_TZ_Terdzo-OM-P2:107	drag po 'o bran lugs /	10	drag po mang bran lugs 
BO_TZ_Terdzo-OM-P2:108	tshhe dpag med lung lugs /	10	tshhe dpog med lung lugs 
BO_TZ_Terdzo-OM-P2:109	dpal mgon legs ldan /	10	dpal mgon legs ldan 
BO_TZ_Terdzo-OM-P2:110	rnam sras gsang sgrub drag po rta sngon ma rnams ni snga 'gyur bka' ma dang / stag zhon dang beng rang byung ma rnams ni bka' gter gnyis ldan dang / gzhan rnams ni zab gter sna tshhogs las byung ba'i gdams pa sha stag go	11	rnam sras gsang sgrub drag po rta sngon ma rnams ni snga gyur bka ma dang stag zhon dang beng rang byung ma rnams ni bka gter gnyis ldan dang gzhan rnams ni zab gter sna tshhogs las byung ba doms ba sha stag go 
BO_TZ_Terdzo-OM-P2:111	/de ltar lha'i rigs so so'i dbye ba dang / rgyud sde gong 'og gi rim pa dang / mchog sgrub dang las sgrub kyi dbye ba dang / sngags gsar rnying bka' gter gang du gtogs pa dang / rgyud gzhung gi dngos bstan dang / man ngag gi dbye ba dang /	11	ltar lha rigs so so byed ba dang brgyud sde gong g gi rim ba dang mchog sgrub dang las sgrub kyi byed ba dang sngags gsar rnying bka gter gang du gtogs ba dang brgyud gzhung gi dngos ston dang man ngag gi byed ba dang 
BO_TZ_Terdzo-OM-P2:112	gong du bshad pa ltar byin rlabs sogs slob ma rjes gzung gi bya ba'i khyad par bzhi po de rnams kyi rnam par dbye ba zhib mor nges shing blo mthu thogs pa med pas tshhul 'di la 'jug par bya'o //	11	gong du chad ba ltar byin rlabs sogs slob ma rjes gzung gi byed ba khyad ba bzhi po de rnams kyi rnam ba byed ba zhib mor nges shing blo mthu thogs ba med ba tshhul di la jug ba byed 
BO_TZ_Terdzo-OM-P2:113	rnam 'a~xgyur sna tshhogs yi dam lhas //	11	rnam a~xgyur sna tshhogs yi dam lhas 
BO_TZ_Terdzo-OM-P2:114	gnyis me~xd ye shes gnas lugs don //	11	gnyis me~xd ye shes gnas lugs don 
BO_TZ_Terdzo-OM-P2:115	mtshhon byas rdo~x rje~x 'dzin dbang gi	11	mtshhon byed rdo~x rje~x dzin dbang gi 
BO_TZ_Terdzo-OM-P2:116	/go 'phang sgrub byed myur bde'i skyes //	11	phen sgrub byed myur bde skye 
BO_TZ_Terdzo-OM-P2:117	rtsha gsum lhag pa'i lha rab 'byams kyi sgrub thabs 'dod 'jo'i bum bzang zhes bya ba las spyi chings bshad pa'i le'u tshhan no ///	11	rtsha gsum lhag ba lha rab byam kyi sgrub thabs dod jo bum bzang zhes byed ba las spyi ching chad ba leu tshhan no 
