segmentnr	original	folio	stemmed
BO_TZ_DZOGCHEN-DESUM-P2:0	\u0f01\u0f83: rdzogs pa chen po sde gsum las :	0	\u0f01\u0f83: rdzogs ba chen po sde gsum las 
BO_TZ_DZOGCHEN-DESUM-P2:1	mdo byang rab tu gsal ba bzhugs so :	0	mdo byang rab tu gsal ba bzhugs so 
BO_TZ_DZOGCHEN-DESUM-P2:2	sde gsum spyi skor /	0	sde gsum spyi skor 
BO_TZ_DZOGCHEN-DESUM-P2:3	\u0f88\u0f88\u0f88\u0f88\u0f88\u0f88 na mo gu ru :	0	\u0f88\u0f88\u0f88\u0f88\u0f88\u0f88 na mo gu ru 
BO_TZ_DZOGCHEN-DESUM-P2:4	chos dbyings klong nas snang bzhi mthar phyin sku lnga yongs rdzogs yon tan rgyas pa'i sku :	0	chos dbyings klong nas snang bzhi mthar phyin sku lnga yongs rdzogs yon tan rgya ba sku 
BO_TZ_DZOGCHEN-DESUM-P2:5	'jig rten kun tu grags shing mi slob zung 'jug mngon gyur shri sing :	0	jig rten kun tu grags shing mi slob zung jug mngon gyur shri sing 
BO_TZ_DZOGCHEN-DESUM-P2:6	kun gyi spyi dpal chen por gyur pa bla ma dpal chen he ru ka :	0	kun gyi spyi dpal chen por gyur ba bla ma dpal chen he ru ka 
BO_TZ_DZOGCHEN-DESUM-P2:7	rje btshun chen po bka' drin can gyi bdag nyid de la rtag tu gus phyag 'tshhal :	0	rje btshun chen po bka drin can gyi bdag nyid de la rtag tu gus phyag tshhal 
BO_TZ_DZOGCHEN-DESUM-P2:8	o rgyan pad+ma bdag nyid kyis :	0	o rgyan pad+ma bdag nyid kyis 
BO_TZ_DZOGCHEN-DESUM-P2:9	'gro don byed par sems bskyed de :	0	gro don byed ba sems skyed de 
BO_TZ_DZOGCHEN-DESUM-P2:10	sin+d+hu'i rgya mtshho'i gling nyid du :	1	sin+d+hu rgya mtshho gling nyid du 
BO_TZ_DZOGCHEN-DESUM-P2:11	ngo mtshhar pad+ma'i steng du 'ong :	1	ngo mtshhar pad+ma steng du ng 
BO_TZ_DZOGCHEN-DESUM-P2:12	rgyal ba kun gyis rab tu gnas :	1	rgyal ba kun gyis rab tu gnas 
BO_TZ_DZOGCHEN-DESUM-P2:13	o rgyan rgya gar la sogs pa'i :	1	o rgyan rgya gar la sogs ba 
BO_TZ_DZOGCHEN-DESUM-P2:14	mkhas grub brgya dang rtsha brgyad bsten :	1	mkhas grub brgya dang rtsha brgyad sten 
BO_TZ_DZOGCHEN-DESUM-P2:15	sde snod gsum dang khyad par bzhi'i :	1	sde snod gsum dang khyad ba bzhi 
BO_TZ_DZOGCHEN-DESUM-P2:16	dgongs spyod ma lus lon par byas :	1	dgongs spyod ma lus lon ba byed 
BO_TZ_DZOGCHEN-DESUM-P2:17	man ngag bcud kyi snying por dril :	1	man ngag bcud kyi snying por dril 
BO_TZ_DZOGCHEN-DESUM-P2:18	lta ba dgongs klong mngon gyur pa'i :	1	lta ba dgongs klong mngon gyur ba 
BO_TZ_DZOGCHEN-DESUM-P2:19	ye shes sku can dpal seng la :	1	ye shes sku can dpal seng la 
BO_TZ_DZOGCHEN-DESUM-P2:20	gdams pa'i mthar thug zhus pa'i tshhe :	2	doms ba mthar thug zhus ba tshhe 
BO_TZ_DZOGCHEN-DESUM-P2:21	mi yul kun tu ma grags pa'i :	2	mi yul kun tu ma grags ba 
BO_TZ_DZOGCHEN-DESUM-P2:22	rig rtshal dbang mchog bdag gis thob :	2	rig rtshal dbang mchog bdag gis thob 
BO_TZ_DZOGCHEN-DESUM-P2:23	de nyid bod du spel ba'i snod :	2	de nyid bod du spel ba snod 
BO_TZ_DZOGCHEN-DESUM-P2:24	gcig kyang ma mchis gab pa'i tshhe :	2	gcig kyang ma mchis gab ba tshhe 
BO_TZ_DZOGCHEN-DESUM-P2:25	mnga' bdag khri srong lde'u btshan dang : mkhas pa'i dbang po bai ro dang : kun las khyad 'phags mtshho rgyal te :	2	mnga bdag khri srong ldeu btshan dang mkhas ba dbang po bai ro dang kun las khyad phag mtshho rgyal te 
BO_TZ_DZOGCHEN-DESUM-P2:26	las can skal ldan gsum gyi ngor :	2	las can skal ldan gsum gyi ngor 
BO_TZ_DZOGCHEN-DESUM-P2:27	shri sim ha'i thugs kyi bcud :	2	shri sim ha thugs kyi bcud 
BO_TZ_DZOGCHEN-DESUM-P2:28	bla ma dgongs pa rnam pa bzhi :	2	bla ma dgongs ba rnam ba bzhi 
BO_TZ_DZOGCHEN-DESUM-P2:29	sbyin te yang tig dgongs nyams bstan :	2	sbyin te yang tig dgongs nyams ston 
BO_TZ_DZOGCHEN-DESUM-P2:30	gzhan yang rje 'bangs mched bdun la :	3	gzhan yang rje bang mched bdun la 
BO_TZ_DZOGCHEN-DESUM-P2:31	dam chos rdzogs chen sde gsum bshad :	3	dam chos rdzogs chen sde gsum chad 
BO_TZ_DZOGCHEN-DESUM-P2:32	da lta shin tu spel phangs pas :	3	da lta shin tu spel phang ba 
BO_TZ_DZOGCHEN-DESUM-P2:33	zab pa thugs kyi gter du sbas :	3	zab ba thugs kyi gter du sbed 
BO_TZ_DZOGCHEN-DESUM-P2:34	nam zhig las can bur 'phrad nas :	3	nam jig las can bur phrad nas 
BO_TZ_DZOGCHEN-DESUM-P2:35	gdams pa sna res grol bar 'gyur :	3	doms ba sna res grol ba gyur 
BO_TZ_DZOGCHEN-DESUM-P2:36	snyan nas snyan du brgyud pa gces :	3	snyan nas snyan du brgyud ba gces 
BO_TZ_DZOGCHEN-DESUM-P2:37	gang zhig 'gro don sgo dbye tsham :	3	gang jig gro don sgo byed tsham 
BO_TZ_DZOGCHEN-DESUM-P2:38	sgrub thabs sna re sbyin par bya :	3	sgrub thabs sna re sbyin ba byed 
BO_TZ_DZOGCHEN-DESUM-P2:39	yongs rdzogs spel ba'i snod med do :	3	yongs rdzogs spel ba snod med do 
BO_TZ_DZOGCHEN-DESUM-P2:40	de phyir mdo byang ma ston cig :	4	de phyir mdo byang ma ston cig 
BO_TZ_DZOGCHEN-DESUM-P2:41	bu yig dkar chag 'dra ru bris :	4	bu yig dkar chag dra ru bri 
BO_TZ_DZOGCHEN-DESUM-P2:42	spyi don tsham las bstan mi bya :	4	spyi don tsham las ston mi byed 
BO_TZ_DZOGCHEN-DESUM-P2:43	sa ma ya :	4	sa ma ya 
BO_TZ_DZOGCHEN-DESUM-P2:44	rgya rgya : man ngag spyi la gces pa'i snying lta bu :	4	rgya rgya man ngag spyi la gces ba snying lta bu 
BO_TZ_DZOGCHEN-DESUM-P2:45	gdams pa'i mthar thug yang zab tshhig bzhi dang : de yang zab la mtshhan gsol mdung tshhug ma :	4	doms ba mthar thug yang zab tshhig bzhi dang de yang zab la mtshhan gsol mdung tshhug ma 
BO_TZ_DZOGCHEN-DESUM-P2:46	grangs la mtshhan gsol ma bu bco brgyad dang : mthar thug mi gsal nam mkha'i zhun ma dang : che ba brjod pa nyi ma klong chub dang : shin tu gsang ba sim ha'i brda la gab :	4	grangs la mtshhan gsol ma bu chos brgyad dang mthar thug mi gsal nam mkha zhun ma dang che ba rjod ba nyi ma klong chub dang shin tu gsang ba sim ha brda la gab 
BO_TZ_DZOGCHEN-DESUM-P2:47	rig 'dzin bla ma'i zab gsang brda bzhi ste :	4	rig dzin bla ma zab gsang brda bzhi ste 
BO_TZ_DZOGCHEN-DESUM-P2:48	shin tu gsang ba snying gi byang bu lags :	4	shin tu gsang ba snying gi byang bu lags 
BO_TZ_DZOGCHEN-DESUM-P2:49	re re tsham las gzhan la spel mi rung :	4	re re tsham las gzhan la spel mi rung 
BO_TZ_DZOGCHEN-DESUM-P2:50	mthar thug bla ma'i sgrub thabs rtsha ba 'di :	5	mthar thug bla ma sgrub thabs rtsha ba di 
BO_TZ_DZOGCHEN-DESUM-P2:51	zab pas nyi zla'i rgya can thugs kyi bcud :	5	zab ba nyi zla rgya can thugs kyi bcud 
BO_TZ_DZOGCHEN-DESUM-P2:52	rang gi nyams len gzhan la ster 'os med :	5	rang gi nyams len gzhan la ster s med 
BO_TZ_DZOGCHEN-DESUM-P2:53	de la dbang ba 'di nyid thon pa'i tshhe :	5	de la dbang ba di nyid thon ba tshhe 
BO_TZ_DZOGCHEN-DESUM-P2:54	lo gcig gam ni yang na lo gsum khongs :	5	lo gcig gam ni yang na lo gsum khongs 
BO_TZ_DZOGCHEN-DESUM-P2:55	skyes bu dpral bar sme ba dmar pos mtshhan :	5	skye bu dpral ba sme ba dmar pos mtshhan 
BO_TZ_DZOGCHEN-DESUM-P2:56	byis pa'i tshhul can de la mtha' nas ster :	5	byis ba tshhul can de la mtha nas ster 
BO_TZ_DZOGCHEN-DESUM-P2:57	gnas kyi nye 'dabs 'di ru shin tu 'byung :	5	gnas kyi nye dabs di ru shin tu byung 
BO_TZ_DZOGCHEN-DESUM-P2:58	rtsha ba'i tshhan bzhi rgyab chos rnam pa bzhi :	5	rtsha ba tshhan bzhi rgyab chos rnam ba bzhi 
BO_TZ_DZOGCHEN-DESUM-P2:59	dpe la ltos phyir ma bu nyid du yod :	5	dpe la ltos phyir ma bu nyid du yod 
BO_TZ_DZOGCHEN-DESUM-P2:60	spyi dang sde gsum rtsha ba'i chos yin la :	6	spyi dang sde gsum rtsha ba chos yin la 
BO_TZ_DZOGCHEN-DESUM-P2:61	brgyud gsum glu yi sde ste rgyab chos bzhi :	6	brgyud gsum glu yi sde ste rgyab chos bzhi 
BO_TZ_DZOGCHEN-DESUM-P2:62	khog phub man ngag mthar thug khungs btshun pa'o :	6	khog bubs man ngag mthar thug khungs btshun ba 
BO_TZ_DZOGCHEN-DESUM-P2:63	'di brgyad kun las rtsha ba'i chos bzhi ni :	6	di brgyad kun las rtsha ba chos bzhi ni 
BO_TZ_DZOGCHEN-DESUM-P2:64	phyi skor sems sde nam mkha'i klong yangs dang : nang skor klong sde nyi ma klong chub dang : gsang skor man ngag 'od zer mtha' yas te :	6	phyi skor sems sde nam mkha klong yangs dang nang skor klong sde nyi ma klong chub dang gsang skor man ngag d zer mtha yas te 
BO_TZ_DZOGCHEN-DESUM-P2:65	phyi skor nam mkha'i klong yangs skor brgyad dang : nang skor nyi ma klong chub skor dgu rnams :	6	phyi skor nam mkha klong yangs skor brgyad dang nang skor nyi ma klong chub skor dgu rnams 
BO_TZ_DZOGCHEN-DESUM-P2:66	slob dpon bai ro tsha nas bod du bsgyur :	6	slob dpon bai ro tsha nas bod du sgyur 
BO_TZ_DZOGCHEN-DESUM-P2:67	'di ni shri sim ha'i thugs bcud de :	6	di ni shri sim ha thugs bcud de 
BO_TZ_DZOGCHEN-DESUM-P2:68	zab la 'dril zhing gzhan la ma bstan pa :	6	zab la dril zhing gzhan la ma ston ba 
BO_TZ_DZOGCHEN-DESUM-P2:69	slob dpon bdag la spel bar bka' gnang med :	6	slob dpon bdag la spel ba bka gnang med 
BO_TZ_DZOGCHEN-DESUM-P2:70	bai ro la ni gnang ba bstshal 'dug pas :	7	bai ro la ni gnang ba bstshal dug ba 
BO_TZ_DZOGCHEN-DESUM-P2:71	ma bur bsdebs te 'di ru bzhag pa 'o :	7	ma bur sdeb te di ru jog ba mang 
BO_TZ_DZOGCHEN-DESUM-P2:72	man ngag skor dgu 'od zer mtha' yas ni :	7	man ngag skor dgu d zer mtha yas ni 
BO_TZ_DZOGCHEN-DESUM-P2:73	pad+ma bdag gis dpal seng nyid la zhus :	7	pad+ma bdag gis dpal seng nyid la zhus 
BO_TZ_DZOGCHEN-DESUM-P2:74	zab pa'i mthar thug 'di ru gdams pa ni :	7	zab ba mthar thug di ru doms ba ni 
BO_TZ_DZOGCHEN-DESUM-P2:75	man ngag nyi shu rtsha drug bstan pa 'o :	7	man ngag nyi shu rtsha drug ston ba mang 
BO_TZ_DZOGCHEN-DESUM-P2:76	phyi skor bla ma sum cu rtsha gcig las :	7	phyi skor bla ma sum cu rtsha gcig las 
BO_TZ_DZOGCHEN-DESUM-P2:77	slob dpon rnams kyi bsgom tshhul khyad par yang :	7	slob dpon rnams kyi bsgom tshhul khyad ba yang 
BO_TZ_DZOGCHEN-DESUM-P2:78	rim pa'i tshhul du bsgrigs par ma byas te :	7	rim ba tshhul du sgrig ba ma byed te 
BO_TZ_DZOGCHEN-DESUM-P2:79	rtsha ba'i bla ma dbus su sgom pa yin :	7	rtsha ba bla ma dbus su sgom ba yin 
BO_TZ_DZOGCHEN-DESUM-P2:80	'gro 'dul bla ma'i sgrub thabs zab pa ni :	8	gro dul bla ma sgrub thabs zab ba ni 
BO_TZ_DZOGCHEN-DESUM-P2:81	yang zab bstan pa'i snying po zhes bya 'o :	8	yang zab ston ba snying po zhes byed mang 
BO_TZ_DZOGCHEN-DESUM-P2:82	'di ni spyi chos yin pas spel yang rung :	8	di ni spyi chos yin ba spel yang rung 
BO_TZ_DZOGCHEN-DESUM-P2:83	'di yi byin rlabs bla ma'i spyi lta bu :	8	di yi byin rlabs bla ma spyi lta bu 
BO_TZ_DZOGCHEN-DESUM-P2:84	khyad par dgongs pa'i rang bzhin nyams bskyang ba :	8	khyad ba dgongs ba rang bzhin nyams skyong ba 
BO_TZ_DZOGCHEN-DESUM-P2:85	glu yi sde tshhogs snga phyi gnyis su brjod :	8	glu yi sde tshhogs snga phyi gnyis su rjod 
BO_TZ_DZOGCHEN-DESUM-P2:86	phyi skor byin rlabs bla ma'i byin rlabs gnyis :	8	phyi skor byin rlabs bla ma byin rlabs gnyis 
BO_TZ_DZOGCHEN-DESUM-P2:87	khrigs su bsdebs nas bskur tshhul bdun gyi shes :	8	khrigs su sdeb nas skur tshhul bdun gyi shes 
BO_TZ_DZOGCHEN-DESUM-P2:88	phyi skor byin rlabs a yig mda' 'phen ma :	8	phyi skor byin rlabs a yig mda phen ma 
BO_TZ_DZOGCHEN-DESUM-P2:89	zla ba'i zhun ma snying gi mun sel yin :	8	zla ba zhun ma snying gi mun sel yin 
BO_TZ_DZOGCHEN-DESUM-P2:90	grol ba'i khrid ni don bzhi'i khongs su rdzogs :	9	grol ba khrid ni don bzhi khongs su rdzogs 
BO_TZ_DZOGCHEN-DESUM-P2:91	sems kyi rang bzhin rtogs par bya ba las :	9	sems kyi rang bzhin rtogs ba byed ba las 
BO_TZ_DZOGCHEN-DESUM-P2:92	stong nyid chos dbyings brdal khyab gdams pa zhes :	9	stong nyid chos dbyings rdal khyab doms ba zhes 
BO_TZ_DZOGCHEN-DESUM-P2:93	de nyid rjes 'brel dgongs pa mthar gsal ba :	9	de nyid rjes brel dgongs ba mthar gsal ba 
BO_TZ_DZOGCHEN-DESUM-P2:94	dgongs pa rang gsal lta ba klong yangs zhes :	9	dgongs ba rang gsal lta ba klong yangs zhes 
BO_TZ_DZOGCHEN-DESUM-P2:95	de yi phyi skor chos tshhan brgyad yin la :	9	de yi phyi skor chos tshhan brgyad yin la 
BO_TZ_DZOGCHEN-DESUM-P2:96	rdo rje dbyings kyi lha tshhogs sgrub pa yang :	9	rdo rje dbyings kyi lha tshhogs sgrub ba yang 
BO_TZ_DZOGCHEN-DESUM-P2:97	shri sim has rgyud las bkral ba'i tshhul :	9	shri sim has brgyud las bkral ba tshhul 
BO_TZ_DZOGCHEN-DESUM-P2:98	rdor dbyings rdo rje rtshe mo 'od gsal zhes :	9	rdar dbyings rdo rje rtshe mo d gsal zhes 
BO_TZ_DZOGCHEN-DESUM-P2:99	yi dam khro bo'i sgrub pa 'di la med :	9	yi dam khro bo sgrub ba di la med 
BO_TZ_DZOGCHEN-DESUM-P2:100	da ni nang skor klong sde skor dgu ni :	10	da ni nang skor klong sde skor dgu ni 
BO_TZ_DZOGCHEN-DESUM-P2:101	rig 'dzin bla ma 'gro 'dul bco lnga yang :	10	rig dzin bla ma gro dul chos lnga yang 
BO_TZ_DZOGCHEN-DESUM-P2:102	rgya gar yul gyi slob dpon chen po rnams :	10	rgya gar yul gyi slob dpon chen po rnams 
BO_TZ_DZOGCHEN-DESUM-P2:103	'gro don phyir du bod kyi yul du 'khrungs :	10	gro don phyir du bod kyi yul du khrung 
BO_TZ_DZOGCHEN-DESUM-P2:104	de yi dbang byas ye shes mtshho rgyal la :	10	de yi dbang byed ye shes mtshho rgyal la 
BO_TZ_DZOGCHEN-DESUM-P2:105	lha sras kyis zhus lha sras gshegs rjes su :	10	lha sras kyis zhus lha sras gshegs rjes su 
BO_TZ_DZOGCHEN-DESUM-P2:106	zur mkhar bza' yis yi ger bkod pa dag :	10	zur mkhar bza yis yi ger bkod ba dag 
BO_TZ_DZOGCHEN-DESUM-P2:107	ngan lam ban+des khrigs su btab pa 'di :	10	ngan lam ban+des khrigs su debs ba di 
BO_TZ_DZOGCHEN-DESUM-P2:108	bla ma'i phrin las dgongs pa 'od gsal zhes :	10	bla ma phrin las dgongs ba d gsal zhes 
BO_TZ_DZOGCHEN-DESUM-P2:109	'di yi byin rlabs bla ma'i spyi skor las :	10	di yi byin rlabs bla ma spyi skor las 
BO_TZ_DZOGCHEN-DESUM-P2:110	grub pa'i tshhul ston bka' babs dbang bskur zhing :	11	grub ba tshhul ston bka bab dbang skur zhing 
BO_TZ_DZOGCHEN-DESUM-P2:111	thugs kyi byin rlabs rdo rje'i glu rnams blang :	11	thugs kyi byin rlabs rdo rje glu rnams blang 
BO_TZ_DZOGCHEN-DESUM-P2:112	zhi ba rdzogs chen ston pa bcu gnyis kyi :	11	zhi ba rdzogs chen ston ba chu gnyis kyi 
BO_TZ_DZOGCHEN-DESUM-P2:113	sgrub pa zab gsal klong yangs zhes bya de :	11	sgrub ba zab gsal klong yangs zhes byed de 
BO_TZ_DZOGCHEN-DESUM-P2:114	gtsho bo chos nyid klong las bskyed pa med :	11	gtsho bo chos nyid klong las skyed ba med 
BO_TZ_DZOGCHEN-DESUM-P2:115	sku gsum don gyi phrin las chen po 'o :	11	sku gsum don gyi phrin las chen po mang 
BO_TZ_DZOGCHEN-DESUM-P2:116	de yi byin rlabs dgongs pa brda bzhi'i dbang :	11	de yi byin rlabs dgongs ba brda bzhi dbang 
BO_TZ_DZOGCHEN-DESUM-P2:117	gsang gsum rdo rje 'bar ba zhes byar brjod :	11	gsang gsum rdo rje bar ba zhes byar rjod 
BO_TZ_DZOGCHEN-DESUM-P2:118	yi dam khro bo mngon rdzogs rgyal po ni :	11	yi dam khro bo mngon rdzogs rgyal po ni 
BO_TZ_DZOGCHEN-DESUM-P2:119	mdo lung chen po'i rgyud las btus pa ste :	11	mdo lung chen po brgyud las thu ba ste 
BO_TZ_DZOGCHEN-DESUM-P2:120	dga' rab rdo rjes mdzad pa'i lugs bzhin du :	12	dga rab rdo rjes mdzad ba lugs bzhin du 
BO_TZ_DZOGCHEN-DESUM-P2:121	shri sim ha'i chos kyi khyad chos so :	12	shri sim ha chos kyi khyad chos so 
BO_TZ_DZOGCHEN-DESUM-P2:122	phrin las nyi ma mtha' yas zhes bya ste :	12	phrin las nyi ma mtha yas zhes byed ste 
BO_TZ_DZOGCHEN-DESUM-P2:123	dbang bskur 'jug pa'i sngon 'gro yan lag bcu :	12	dbang skur jug ba sngon gro yan lag chu 
BO_TZ_DZOGCHEN-DESUM-P2:124	rtsha ba dgu bsgril 'jug cing smin pa'i sgo :	12	rtsha ba dgu sgril jug cing smin ba sgo 
BO_TZ_DZOGCHEN-DESUM-P2:125	mtha' rten yan lag gnyis te nyi shu yin :	12	mtha rten yan lag gnyis te nyi shu yin 
BO_TZ_DZOGCHEN-DESUM-P2:126	dbang gi gter mdzod chen po zhes bya 'o :	12	dbang gi gter mdzod chen po zhes byed mang 
BO_TZ_DZOGCHEN-DESUM-P2:127	khrid kyi byin rlabs brda bzhi bstan pa dang : g.yu sgra snying po'i dgongs bcud ji lta bur :	12	khrid kyi byin rlabs brda bzhi ston ba dang g.yu sgra snying po dgongs bcud ji lta bur 
BO_TZ_DZOGCHEN-DESUM-P2:128	'di ru yi ge btab par byas pa ste :	12	di ru yi ge debs ba byed ba ste 
BO_TZ_DZOGCHEN-DESUM-P2:129	'di ni klong sde'i chos kyi khong snying dag :	12	di ni klong sde chos kyi khong snying dag 
BO_TZ_DZOGCHEN-DESUM-P2:130	dang po khams kyi smad du bai ro yis :	13	dang po khams kyi smad du bai ro yis 
BO_TZ_DZOGCHEN-DESUM-P2:131	mi pham zhes pa'i rgan po zhig la gnang :	13	mi pham zhes ba rgan po jig la gnang 
BO_TZ_DZOGCHEN-DESUM-P2:132	g.yu sgras de yi dus su ma thos te :	13	g.yu sgras de yi dus su ma thos te 
BO_TZ_DZOGCHEN-DESUM-P2:133	slar yang de bzhin bai ro tsha na yi :	13	slar yang de bzhin bai ro tsha na yi 
BO_TZ_DZOGCHEN-DESUM-P2:134	o rgyan bdag dang rje 'bangs mched drug rnams :	13	o rgyan bdag dang rje bang mched drug rnams 
BO_TZ_DZOGCHEN-DESUM-P2:135	ru dam lung pa pha bong nag po'i steng :	13	ru dam lung ba pha bong nag po steng 
BO_TZ_DZOGCHEN-DESUM-P2:136	bzhugs pa'i tshhe na bai ros g.yu sgrar gdams :	13	bzhugs ba tshhe na bai ros g.yu sgrar doms 
BO_TZ_DZOGCHEN-DESUM-P2:137	de yi dus su jo mo mtshho rgyal gyis :	13	de yi dus su jo mo mtshho rgyal gyis 
BO_TZ_DZOGCHEN-DESUM-P2:138	yi ger btab ste gter du sbas par brtsham :	13	yi ger debs ste gter du sbed ba brtsham 
BO_TZ_DZOGCHEN-DESUM-P2:139	khrid kyi dngos gzhi brda bzhi'i sgom tshhul yang :	13	khrid kyi dngos gzhi brda bzhi sgom tshhul yang 
BO_TZ_DZOGCHEN-DESUM-P2:140	lta ba rang sangs klong yangs zhes bya 'o :	14	lta ba rang sangs klong yangs zhes byed mang 
BO_TZ_DZOGCHEN-DESUM-P2:141	rjes 'brel shan 'byed nam mkha'i sgo 'byed ces :	14	rjes brel shan byed nam mkha sgo byed ces 
BO_TZ_DZOGCHEN-DESUM-P2:142	nang skor rim pa dgu po de yis rdzogs :	14	nang skor rim ba dgu po de yis rdzogs 
BO_TZ_DZOGCHEN-DESUM-P2:143	man ngag skor la thog mar pad+ma bdag :	14	man ngag skor la thogs mar pad+ma bdag 
BO_TZ_DZOGCHEN-DESUM-P2:144	rgya gar yul nas dka' ba mang po yis :	14	rgya gar yul nas dka ba mang po yis 
BO_TZ_DZOGCHEN-DESUM-P2:145	mnyes pa gsum gyis slob dpon bsten pa rnams :	14	mnyes ba gsum gyis slob dpon sten ba rnams 
BO_TZ_DZOGCHEN-DESUM-P2:146	thams cad ye shes sku can sha stag ste :	14	thams cad ye shes sku can sha stag ste 
BO_TZ_DZOGCHEN-DESUM-P2:147	de dag sgrub pa'i tshhul ni 'di lta ste :	14	de dag sgrub ba tshhul ni di lta ste 
BO_TZ_DZOGCHEN-DESUM-P2:148	bla ma yongs rdzogs sgom pa'i gseng lam zhes :	14	bla ma yongs rdzogs sgom ba gseng lam zhes 
BO_TZ_DZOGCHEN-DESUM-P2:149	byin rlabs spyi las khyad par mtshhan dang ni :	14	byin rlabs spyi las khyad ba mtshhan dang ni 
BO_TZ_DZOGCHEN-DESUM-P2:150	sku yi rnam pas sngon du skus dbang bskur :	15	sku yi rnam ba sngon du skus dbang skur 
BO_TZ_DZOGCHEN-DESUM-P2:151	gsung la gdams pa thugs la rdo rje'i glu :	15	gsung la doms ba thugs la rdo rje glu 
BO_TZ_DZOGCHEN-DESUM-P2:152	dgongs pa'i nyams skyong bzhi yis rdzogs pa la :	15	dgongs ba nyams skyong bzhi yis rdzogs ba la 
BO_TZ_DZOGCHEN-DESUM-P2:153	dbang bskur dgongs pa mthar phyin zhes bya 'o :	15	dbang skur dgongs ba mthar phyin zhes byed mang 
BO_TZ_DZOGCHEN-DESUM-P2:154	yi dam pad+ma'i snying tig zhi khro gnyis :	15	yi dam pad+ma snying tig zhi khro gnyis 
BO_TZ_DZOGCHEN-DESUM-P2:155	thig le lnga rdzogs 'od zer klong thim zhes :	15	thig le lnga rdzogs d zer klong thim zhes 
BO_TZ_DZOGCHEN-DESUM-P2:156	lta ba klong yangs dbyings kyi rdzong dang ldan :	15	lta ba klong yangs dbyings kyi rdzong dang ldan 
BO_TZ_DZOGCHEN-DESUM-P2:157	rig pa rang byung 'phrang gi sgo lcags tshhul :	15	rig ba rang byung phrangs gi sgo lcags tshhul 
BO_TZ_DZOGCHEN-DESUM-P2:158	rdzong 'phrang dbyer med bde gshegs 'dus pa zhes :	15	rdzong phrangs dbyer med bde gshegs du ba zhes 
BO_TZ_DZOGCHEN-DESUM-P2:159	dbang gi mdo byang spyi blugs zhes bya 'o :	15	dbang gi mdo byang spyi blugs zhes byed mang 
BO_TZ_DZOGCHEN-DESUM-P2:160	zhi khro'i dbang chen rdo rje'i gnas sbyang ngo :	16	zhi khro dbang chen rdo rje gnas sbyong ngo 
BO_TZ_DZOGCHEN-DESUM-P2:161	khrid kyi sngon 'gro spros bcas spros med dang : shin tu spros med rab tu spros med de :	16	khrid kyi sngon gro spros cha spros med dang shin tu spros med rab tu spros med de 
BO_TZ_DZOGCHEN-DESUM-P2:162	zad sar 'khyol ba'i ye shes gseng lam mo :	16	zad sar khyol ba ye shes gseng lam mo 
BO_TZ_DZOGCHEN-DESUM-P2:163	lta ba dngos gzhi shri sim ha yi :	16	lta ba dngos gzhi shri sim ha yi 
BO_TZ_DZOGCHEN-DESUM-P2:164	gdams pa'i gzer bdun sems la btab tshhul ni :	16	doms ba gzer bdun sems la debs tshhul ni 
BO_TZ_DZOGCHEN-DESUM-P2:165	ye shes rig pa'i ral gri zhes bya 'o :	16	ye shes rig ba ral gri zhes byed mang 
BO_TZ_DZOGCHEN-DESUM-P2:166	rjes 'brel lta ba snyan brgyud rnam gsum ni :	16	rjes brel lta ba snyan brgyud rnam gsum ni 
BO_TZ_DZOGCHEN-DESUM-P2:167	gdams pa kun gyi mthar thug spyi tir rdzogs :	16	doms ba kun gyi mthar thug spyi tir rdzogs 
BO_TZ_DZOGCHEN-DESUM-P2:168	ye shes lta ba'i rgyal po zhes bya 'o :	16	ye shes lta ba rgyal po zhes byed mang 
BO_TZ_DZOGCHEN-DESUM-P2:169	'di ni gsang ba'i klong dgu 'di'i mtha' ru :	16	di ni gsang ba klong dgu di mtha ru 
BO_TZ_DZOGCHEN-DESUM-P2:170	man ngag dgongs pa'i zhe phugs btags pa yi :	17	man ngag dgongs ba zhe phugs dogs ba yi 
BO_TZ_DZOGCHEN-DESUM-P2:171	tshhe gcig zung 'jug sku ru 'gyur ba ste :	17	tshhe gcig zung jug sku ru gyur ba ste 
BO_TZ_DZOGCHEN-DESUM-P2:172	gdams pa'i mthar thug 'di 'dra sngon ma bstan :	17	doms ba mthar thug di dra sngon ma ston 
BO_TZ_DZOGCHEN-DESUM-P2:173	chig brgyud gnubs chen mkhar chen rnams la spel :	17	chig brgyud gnubs chen mkhar chen rnams la spel 
BO_TZ_DZOGCHEN-DESUM-P2:174	re zhig sum cu dus kyi mar gsham la :	17	re jig sum cu dus kyi mar gsham la 
BO_TZ_DZOGCHEN-DESUM-P2:175	gdams pa ma bu nam mkha'i klong du mjal :	17	doms ba ma bu nam mkha klong du mjal 
BO_TZ_DZOGCHEN-DESUM-P2:176	phan tshhun gab sprad be ro'i skyes mtha' zhig :	17	phan tshhun gab sprod be ro skye mtha jig 
BO_TZ_DZOGCHEN-DESUM-P2:177	blo gros ming can de la bdag por gtad :	17	blo gros ming can de la bdag por gtod 
BO_TZ_DZOGCHEN-DESUM-P2:178	de la gces pa'i sde drug bstan pa ni :	17	de la gces ba sde drug ston ba ni 
BO_TZ_DZOGCHEN-DESUM-P2:179	lo rgyus snying gi ti ka chen po dang : lung bstan gsal ba'i sgron me gab rgya can :	17	lo rgyus snying gi ti ka chen po dang lung ston gsal ba sgron me gab rgya can 
BO_TZ_DZOGCHEN-DESUM-P2:180	khyad par shin tu gces pa'i snying gi khrag :	18	khyad ba shin tu gces ba snying gi khrag 
BO_TZ_DZOGCHEN-DESUM-P2:181	mkha' 'gro dgongs pa klong gsal las btus pa'i :	18	mkha gro dgongs ba klong gsal las thu ba 
BO_TZ_DZOGCHEN-DESUM-P2:182	phrin las ye shes mkha' 'gro'i dgongs rgyan dang : zab pa yum gyi dbang bskur rnam pa gnyis :	18	phrin las ye shes mkha gro dgongs rgyan dang zab ba yum gyi dbang skur rnam ba gnyis 
BO_TZ_DZOGCHEN-DESUM-P2:183	shin tu gces pas lo gsum khongs dag la :	18	shin tu gces ba lo gsum khongs dag la 
BO_TZ_DZOGCHEN-DESUM-P2:184	lho yi phyogs nas sprel gyi lo pa 'am :	18	lho yi phyogs nas sprel gyi lo ba mang 
BO_TZ_DZOGCHEN-DESUM-P2:185	rta yi lo pa snying gar sme ba dmar :	18	rta yi lo ba snying gar sme ba dmar 
BO_TZ_DZOGCHEN-DESUM-P2:186	byis pa'i tshhul can de nyid bdag por 'gyur :	18	byis ba tshhul can de nyid bdag por gyur 
BO_TZ_DZOGCHEN-DESUM-P2:187	ma 'ongs yab sras gnyis po mjal ba'i tshhe :	18	ma ngs yab sras gnyis po mjal ba tshhe 
BO_TZ_DZOGCHEN-DESUM-P2:188	de dus gnyis pos nyams len byed pa las :	18	de dus gnyis pos nyams len byed ba las 
BO_TZ_DZOGCHEN-DESUM-P2:189	rlung phyogs tsham yang gzhan la bsgrag mi rung :	18	rlung phyogs tsham yang gzhan la sgrog mi rung 
BO_TZ_DZOGCHEN-DESUM-P2:190	bka' yi srung ma dregs pa sde gsum gyi :	19	bka yi srung ma dregs ba sde gsum gyi 
BO_TZ_DZOGCHEN-DESUM-P2:191	phrin las glog gi spu gri ma bu bcas :	19	phrin las glog gi spu gri ma bu cha 
BO_TZ_DZOGCHEN-DESUM-P2:192	mtha' rten tshhe yi gdams pa gsang ba'i lam :	19	mtha rten tshhe yi doms ba gsang ba lam 
BO_TZ_DZOGCHEN-DESUM-P2:193	'chi med bdud rtshi'i sman lung chen mo ste :	19	chi med bdud rtshi sman lung chen mo ste 
BO_TZ_DZOGCHEN-DESUM-P2:194	sbas pa'i gnas mchog chen po'i dkar chag can :	19	sbed ba gnas mchog chen po dkar chag can 
BO_TZ_DZOGCHEN-DESUM-P2:195	phrin las la gces byang bu bcu phrag ste :	19	phrin las la gces byang bu chu phrag ste 
BO_TZ_DZOGCHEN-DESUM-P2:196	chad lhag med par yongs su rdzogs pa 'o :	19	chad lhag med ba yongs su rdzogs ba mang 
BO_TZ_DZOGCHEN-DESUM-P2:197	de nyid sa steng 'byung ba'i bskal pa'i dus :	19	de nyid sa steng byung ba bskal ba dus 
BO_TZ_DZOGCHEN-DESUM-P2:198	rgya yi yul phyogs mun pa 'khrugs pa 'dra :	19	rgya yi yul phyogs mun ba khrugs ba dra 
BO_TZ_DZOGCHEN-DESUM-P2:199	bal bo'i yul ni khrag mtshho khol ba 'dra :	19	bal bo yul ni khrag mtshho khol ba dra 
BO_TZ_DZOGCHEN-DESUM-P2:200	bod kyi yul ni rnga thog sran ma bzhin :	20	bod kyi yul ni rnga thogs sran ma bzhin 
BO_TZ_DZOGCHEN-DESUM-P2:201	stod smad zing zing long long gyur pa na :	20	stod smad zing zing long long gyur ba na 
BO_TZ_DZOGCHEN-DESUM-P2:202	sa gnad shin tu che ba 'bri lung du :	20	sa gnad shin tu che ba bri lung du 
BO_TZ_DZOGCHEN-DESUM-P2:203	kha brag ma yi thugs sgrub chen mo yi :	20	kha brag ma yi thugs sgrub chen mo yi 
BO_TZ_DZOGCHEN-DESUM-P2:204	tshhogs kyi 'khor lo 'bum phrag brtshon pa dang : mkho mthing ma yi bde gshegs 'dus pa yi :	20	tshhogs kyi khor lo bum phrag brtshon ba dang mkho mthing ma yi bde gshegs du ba yi 
BO_TZ_DZOGCHEN-DESUM-P2:205	las kyi sbyor ba'i gzer chen gdab par bya :	20	las kyi sbyor ba gzer chen gdab ba byed 
BO_TZ_DZOGCHEN-DESUM-P2:206	shel phug ma yi bka' brgyad rdzong 'phrang gi :	20	shel bugs ma yi bka brgyad rdzong phrangs gi 
BO_TZ_DZOGCHEN-DESUM-P2:207	bdud rtshi sman gyi sgrub pa byed pa sogs :	20	bdud rtshi sman gyi sgrub ba byed ba sogs 
BO_TZ_DZOGCHEN-DESUM-P2:208	rten 'brel go ma 'gags par bsgrigs pa na :	20	rten brel go ma gag ba sgrig ba na 
BO_TZ_DZOGCHEN-DESUM-P2:209	stod smad kun gyi g.yo 'khrugs cung zhig zhi :	20	stod smad kun gyi g.yo khrugs cung jig zhi 
BO_TZ_DZOGCHEN-DESUM-P2:210	de nas lcags sprel lo yi snga rjes la :	21	de nas lcags sprel lo yi snga rjes la 
BO_TZ_DZOGCHEN-DESUM-P2:211	'khrugs pa'i skabs zhi mu ge'i bskal pa 'byung :	21	khrugs ba skabs zhi mu ge bskal ba byung 
BO_TZ_DZOGCHEN-DESUM-P2:212	spyi rong phyogs su 'bru yi gter kha sbas :	21	spyi rong phyogs su bru yi gter kha sbed 
BO_TZ_DZOGCHEN-DESUM-P2:213	khri sgo'i phyogs su rin chen gter kha sbas :	21	khri sgo phyogs su rin chen gter kha sbed 
BO_TZ_DZOGCHEN-DESUM-P2:214	shod chen bco brgyad gter gyis phyur bur bkang :	21	shod chen chos brgyad gter gyis phyur bur geng 
BO_TZ_DZOGCHEN-DESUM-P2:215	rong mdo rnams su brtan mar mdos bya zhing :	21	rong mdo rnams su brtan mar mdos byed zhing 
BO_TZ_DZOGCHEN-DESUM-P2:216	ma mo rnams kyi drung du mdos chen phul :	21	ma mo rnams kyi drung du mdos chen bul 
BO_TZ_DZOGCHEN-DESUM-P2:217	chu klung chen po bzhi ru klu gta' bsdams :	21	chu klung chen po bzhi ru klu gta sdom 
BO_TZ_DZOGCHEN-DESUM-P2:218	de yis mu ge'i bskal pa cung zad zhi :	21	de yis mu ge bskal ba cung zad zhi 
BO_TZ_DZOGCHEN-DESUM-P2:219	shing stag lo yi snga rjes thams cad la :	21	shing stag lo yi snga rjes thams cad la 
BO_TZ_DZOGCHEN-DESUM-P2:220	mu ge'i bskal zhi nad kyi bskal pa 'byung :	22	mu ge bskal zhi nad kyi bskal ba byung 
BO_TZ_DZOGCHEN-DESUM-P2:221	lha ri rtshe lngar sman gyi sgrub pa bya :	22	lha ri rtshe lngar sman gyi sgrub ba byed 
BO_TZ_DZOGCHEN-DESUM-P2:222	seng ge rdzong gsum sman gyi gter chen sbas :	22	seng ge rdzong gsum sman gyi gter chen sbed 
BO_TZ_DZOGCHEN-DESUM-P2:223	dbus gtshang khams la sman gyi 'gyed chen bya :	22	dbus gtshang khams la sman gyi gyed chen byed 
BO_TZ_DZOGCHEN-DESUM-P2:224	chu sprel lo la stod smad mtha' 'ur 'drog :	22	chu sprel lo la stod smad mtha ur drog 
BO_TZ_DZOGCHEN-DESUM-P2:225	bsam yas mthil du bde gshegs 'dus pa sgrubs :	22	bsam yas mthil du bde gshegs du ba sgrubs 
BO_TZ_DZOGCHEN-DESUM-P2:226	yongs rdzogs phug tu phur pa'i las sbyor bya :	22	yongs rdzogs bugs tu phur ba las sbyor byed 
BO_TZ_DZOGCHEN-DESUM-P2:227	ri bo bkra bzang 'dabs su mchod rten bzhengs :	22	ri bo bkra bzang dabs su mchod rten bzhengs 
BO_TZ_DZOGCHEN-DESUM-P2:228	de yis stod smad g.yo 'khrugs cung zhig zhi :	22	de yis stod smad g.yo khrugs cung jig zhi 
BO_TZ_DZOGCHEN-DESUM-P2:229	shing sprel lo la lha sa'i mthil dag tu :	22	shing sprel lo la lha sa mthil dag tu 
BO_TZ_DZOGCHEN-DESUM-P2:230	gtam ngan lha mi'i gnas su grags pa 'byung :	23	dam ngan lha mi gnas su grags ba byung 
BO_TZ_DZOGCHEN-DESUM-P2:231	de la phan phyir gtshang gi phung po cher :	23	de la phan phyir gtshang gi phung po cher 
BO_TZ_DZOGCHEN-DESUM-P2:232	bde gshegs 'dus pa'i sgrub chen lan gsum bya :	23	bde gshegs du ba sgrub chen lan gsum byed 
BO_TZ_DZOGCHEN-DESUM-P2:233	lha sa'i mthil du rdo rje 'dzin rnams kyis :	23	lha sa mthil du rdo rje dzin rnams kyis 
BO_TZ_DZOGCHEN-DESUM-P2:234	nga yi sgrub pa bar chad kun sel gyi :	23	nga yi sgrub ba ba chad kun sel gyi 
BO_TZ_DZOGCHEN-DESUM-P2:235	sgrub pa las sbyor mtha' rdzogs yang yang bya :	23	sgrub ba las sbyor mtha rdzogs yang yang byed 
BO_TZ_DZOGCHEN-DESUM-P2:236	me bya lo la stod smad thams cad du :	23	me byed lo la stod smad thams cad du 
BO_TZ_DZOGCHEN-DESUM-P2:237	tshi tshi dz+wa la'i nad kyis zin pa'i dus :	23	tshi tshi dz+wa la nad kyis zin ba dus 
BO_TZ_DZOGCHEN-DESUM-P2:238	bsam yas mchims phur gnas chen byin 'beb bya :	23	bsam yas mchims phur gnas chen byin beb byed 
BO_TZ_DZOGCHEN-DESUM-P2:239	bod kyi mtshho chen lnga la klu gta' bsdam :	23	bod kyi mtshho chen lnga la klu gta sdom 
BO_TZ_DZOGCHEN-DESUM-P2:240	lcags khyi lo la stod smad kun nas 'khrugs :	24	lcags khyi lo la stod smad kun nas khrugs 
BO_TZ_DZOGCHEN-DESUM-P2:241	bod kyi yul kun sil bur 'thor ba'i tshhe :	24	bod kyi yul kun sil bur thor ba tshhe 
BO_TZ_DZOGCHEN-DESUM-P2:242	smad kyi phyogs nas rdo rje'i ming can ni :	24	smad kyi phyogs nas rdo rje ming can ni 
BO_TZ_DZOGCHEN-DESUM-P2:243	stag gi lo pa lho nas glog ltar 'khyugs :	24	stag gi lo ba lho nas glog ltar khyugs 
BO_TZ_DZOGCHEN-DESUM-P2:244	sbas pa'i yul phye 'gro ba dbugs dbyung byed :	24	sbed ba yul byed gro ba dbugs byin byed 
BO_TZ_DZOGCHEN-DESUM-P2:245	bod yul bde skyid 'byung 'gyur de tsham las :	24	bod yul bde skyid byung gyur de tsham las 
BO_TZ_DZOGCHEN-DESUM-P2:246	zhib par seng brag kha byang chen mor ltos :	24	zhib ba seng brag kha byang chen mor ltos 
BO_TZ_DZOGCHEN-DESUM-P2:247	'di nyid sa steng byung ba tsham gyis ni :	24	di nyid sa steng byung ba tsham gyis ni 
BO_TZ_DZOGCHEN-DESUM-P2:248	mon brag dkar po brag gi gter kha thon :	24	mon brag dkar po brag gi gter kha thon 
BO_TZ_DZOGCHEN-DESUM-P2:249	shin tu gces pa'i lung byang sde bdun ltar :	24	shin tu gces ba lung byang sde bdun ltar 
BO_TZ_DZOGCHEN-DESUM-P2:250	bod kyi sa gnas thams cad gso ba dang : bod dang bod kyi me btsha' nyams pa rnams :	25	bod kyi sa gnas thams cad gso ba dang bod dang bod kyi me btsha nyams ba rnams 
BO_TZ_DZOGCHEN-DESUM-P2:251	tshhul bzhin gsos na drug cu'i skor gsum la :	25	tshhul bzhin gsos na drug cu skor gsum la 
BO_TZ_DZOGCHEN-DESUM-P2:252	rgyal ba'i bstan pa bod kyi bde skyid gnas :	25	rgyal ba ston ba bod kyi bde skyid gnas 
BO_TZ_DZOGCHEN-DESUM-P2:253	zhes pa'i mdo byang legs par bstan pa 'di :	25	zhes ba mdo byang legs ba ston ba di 
BO_TZ_DZOGCHEN-DESUM-P2:254	mtshho rgyal khyod kyis gsang ba'i yi ger thobs :	25	mtshho rgyal khyod kyis gsang ba yi ger thobs 
BO_TZ_DZOGCHEN-DESUM-P2:255	ma 'ongs las 'phro can dang 'phrad par shog :	25	ma ngs las phro can dang phrad ba shog 
BO_TZ_DZOGCHEN-DESUM-P2:256	sa ma ya :	25	sa ma ya 
BO_TZ_DZOGCHEN-DESUM-P2:257	rgya rgya : gter rgya :	25	rgya rgya gter rgya 
BO_TZ_DZOGCHEN-DESUM-P2:258	sbas rgya : zab rgya :sprul pa'i gter chen mchog gyur gling pas bde chen pad+ma shel phug gi gnam khung nas spyan drangs pa'i shog ser las gtan la phab rim bzhin mtshho skyes bla ma dgyes pa'i 'bangs mkhyen brtshe'i dbang pos bris pa dge legs 'phel /	25	sbed rgya zab rgya :sprul ba gter chen mchog gyur gling ba bde chen pad+ma shel bugs gi gnam khung nas spyan drangs ba shog ser las gtan la bebs rim bzhin mtshho skye bla ma dgyes ba bang mkhyen brtshe dbang pos bri ba dge legs phel 
BO_TZ_DZOGCHEN-DESUM-P2:259	zhus so /// /	25	zhus so 
