segmentnr	original	folio	stemmed
BO_TZ_DZOGCHEN-DESUM-P16:0	bai ro tsha na'i thugs thig rdzogs chen sde gsum gter srung gtor 'bul rgyun khyer bzhugs so //	0	bai ro tsha na thugs thig rdzogs chen sde gsum gter srung thor bul rgyun khyer bzhugs so 
BO_TZ_DZOGCHEN-DESUM-P16:1	na mo gu ru d+he wa d+ha ki ni ye /	0	na mo gu ru d+he wa d+ha ki ni ye 
BO_TZ_DZOGCHEN-DESUM-P16:2	rdzogs chen sde gsum gter srung bya ra dkar dmar sngo gsum la gtor ma 'bul bar 'dod na /	0	rdzogs chen sde gsum gter srung byed ra dkar dmar sngo gsum la thor ma bul ba dod na 
BO_TZ_DZOGCHEN-DESUM-P16:3	'bras bshos dkar po /	0	bras bshos dkar po 
BO_TZ_DZOGCHEN-DESUM-P16:4	sha khrag gi dmar gtor /	0	sha khrag gi dmar thor 
BO_TZ_DZOGCHEN-DESUM-P16:5	dkar gsum gyi klu bshos rgyan ldan bshams /	0	dkar gsum gyi klu bshos rgyan ldan bshams 
BO_TZ_DZOGCHEN-DESUM-P16:6	ram yam kham gis bsang /	0	ram yam kham gis bsang 
BO_TZ_DZOGCHEN-DESUM-P16:7	rin po che'i snod yangs shing rgya che ba'i nang du gtor ma kha dog dri ro phun sum tshhogs pa'i bdud rtshi'i rgya mtshho chen por gyur /	0	rin po che snod yangs shing rgya che ba nang du thor ma kha dog dri ro phun sum tshhogs ba bdud rtshi rgya mtshho chen por gyur 
BO_TZ_DZOGCHEN-DESUM-P16:8	a+o~m ahhu~m ha ho hrih	0	a+o~m ahhu~m ha ho hrih 
BO_TZ_DZOGCHEN-DESUM-P16:9	lan gsum gyis brlabs /	0	lan gsum gyis brlabs 
BO_TZ_DZOGCHEN-DESUM-P16:10	rang gi thugs ka'i sa bon las byung ba'i 'od zer gyis gter gyi bdag po 'khor dang bcas pa spyan drangs par gyur /	1	rang gi thugs ka sa bon las byung ba d zer gyis gter gyi bdag po khor dang cha ba spyan drangs ba gyur 
BO_TZ_DZOGCHEN-DESUM-P16:11	rnga gling rol mo dang bcas pas spyan drang ba ni /	1	rnga gling rol mo dang cha ba spyan dren ba ni 
BO_TZ_DZOGCHEN-DESUM-P16:12	hu~m/ sngon tshhe pad+ma 'byung gnas spyan snga ru //	1	sngon tshhe pad+ma byung gnas spyan snga ru 
BO_TZ_DZOGCHEN-DESUM-P16:13	zab gter srung mar zhal bzhes dam tshhig can //	1	zab gter srung mar zhal bzhes dam tshhig can 
BO_TZ_DZOGCHEN-DESUM-P16:14	mthu chen gter gyi bdag po chen po rnams //	1	mthu chen gter gyi bdag po chen po rnams 
BO_TZ_DZOGCHEN-DESUM-P16:15	rang rang g.yog 'khor bcas pa 'dir gshegs shig	1	rang rang g.yog khor cha ba dir gshegs shig 
BO_TZ_DZOGCHEN-DESUM-P16:16	/ni d+hi pa tihsa pa ri wa ra badzra sa ma dzah	1	d+hi ba tihsa ba ri wa ra badzra sa ma dzah 
BO_TZ_DZOGCHEN-DESUM-P16:17	ni d+hi pa tihsa pa ri wa ra ar+g+ham sogs nas /	1	ni d+hi ba tihsa ba ri wa ra ar+g+ham sogs nas 
BO_TZ_DZOGCHEN-DESUM-P16:18	shab+da pra titsh+tshha swa ha/	1	shab+da pra titsh+tshha swa 
BO_TZ_DZOGCHEN-DESUM-P16:19	gtor ma 'bul ba ni /	1	thor ma bul ba ni 
BO_TZ_DZOGCHEN-DESUM-P16:20	ni d+hi pa tihde wa ra dza shu la ra dza na ga ra dza sa pa ri wa ra i dam ba lim ta kha kha kha hi kha hi /	2	ni d+hi ba tihde wa ra dza shu la ra dza na ga ra dza sa ba ri wa ra i dam ba lim ta kha kha kha hi kha hi 
BO_TZ_DZOGCHEN-DESUM-P16:21	ma ha pany+tsha a mr-ita kha hi /	2	ma ha pany+tsha a mr-ita kha hi 
BO_TZ_DZOGCHEN-DESUM-P16:22	ma ha rak+ta kha hi /	2	ma ha rak+ta kha hi 
BO_TZ_DZOGCHEN-DESUM-P16:23	zhes mchod pa dang sman gtor rak+ta rnams 'bul /	2	zhes mchod ba dang sman thor rak+ta rnams bul 
BO_TZ_DZOGCHEN-DESUM-P16:24	zab gter srung ma'i dbang po lha btshan klu yi rgyal po 'khor dang bcas pa rnams kyis mchod pa dam pa 'di bzhes la /	2	zab gter srung ma dbang po lha btshan klu yi rgyal po khor dang cha ba rnams kyis mchod ba dam ba di bzhes la 
BO_TZ_DZOGCHEN-DESUM-P16:25	sangs rgyas kyi bstan pa srungs /	2	sangs rgya kyi ston ba srungs 
BO_TZ_DZOGCHEN-DESUM-P16:26	dkon mchog gi dbu 'phang bstod /	2	dkon(d) mchog gi dbu phen bstod 
BO_TZ_DZOGCHEN-DESUM-P16:27	dge 'dun dang chos kyi rgyal srid skyongs /	2	dge dun dang chos kyi rgyal srid skyongs 
BO_TZ_DZOGCHEN-DESUM-P16:28	'jig rten gyi rgud pa sol /	2	jig rten gyi rgud ba sol 
BO_TZ_DZOGCHEN-DESUM-P16:29	sems can gyi phan bde spel /	2	sems can gyi phan bde spel 
BO_TZ_DZOGCHEN-DESUM-P16:30	rnal 'byor pa rnams kyi sdongs grogs mdzod /	3	rnal byor ba rnams kyi sdongs grogs mdzod 
BO_TZ_DZOGCHEN-DESUM-P16:31	sngags 'chang rnams kyi 'phrin las sgrubs /	3	sngags chang rnams kyi phrin las sgrubs 
BO_TZ_DZOGCHEN-DESUM-P16:32	sdang ba'i dgra thul /	3	sdang ba dgra thul 
BO_TZ_DZOGCHEN-DESUM-P16:33	gnod pa'i bgegs choms /	3	gnod ba bgegs choms 
BO_TZ_DZOGCHEN-DESUM-P16:34	khyad par dam tshhig 'dir 'dus pa rnams kyi phyi nang gsang ba'i 'gal rkyen zhi ba dang / mthun rkyen smon pa'i legs tshhogs thams cad 'phel zhing rgyas pa dang / mchog dang thun mong gi dngos grub ma lus pa myur du 'grub pa'i phrin las mdzod cig	3	khyad ba dam tshhig dir du ba rnams kyi phyi nang gsang ba gal rkyen zhi ba dang mthun rkyen smon ba legs tshhogs thams cad phel zhing rgya ba dang mchog dang thun mong gi dngos grub ma lus ba myur du grub ba phrin las mdzod cig 
BO_TZ_DZOGCHEN-DESUM-P16:35	/bstod cing phrin las gsol ba ni /	3	cing phrin las gsol ba ni 
BO_TZ_DZOGCHEN-DESUM-P16:36	kyai : lha yul de ni shel mkhar du :	3	kyai lha yul de ni shel mkhar du 
BO_TZ_DZOGCHEN-DESUM-P16:37	gsal ba'i 'od las lha yi rgyal :	3	gsal ba d las lha yi rgyal 
BO_TZ_DZOGCHEN-DESUM-P16:38	shel rmog shel khrab 'od du 'tshher :	3	shel rmog shel khrab d du tshher 
BO_TZ_DZOGCHEN-DESUM-P16:39	dar 'phru dar mdung sprin ltar bskyod :	3	dar phru dar mdung sprin ltar skyod 
BO_TZ_DZOGCHEN-DESUM-P16:40	gser gyi 'khor lo nyi ltar shar :	4	gser gyi khor lo nyi ltar char 
BO_TZ_DZOGCHEN-DESUM-P16:41	chu shel nor bu zla ltar gsal :	4	chu shel nor bu zla ltar gsal 
BO_TZ_DZOGCHEN-DESUM-P16:42	gnam rta dkar po mgyogs 'gro 'chibs :	4	gnam rta dkar po mgyog gro chibs 
BO_TZ_DZOGCHEN-DESUM-P16:43	lha sman lha dmag 'bum gyis bskor :	4	lha sman lha dmag bum gyis skor 
BO_TZ_DZOGCHEN-DESUM-P16:44	'bras bshos rgyan ldan 'di bzhes la :	4	bras bshos rgyan ldan di bzhes la 
BO_TZ_DZOGCHEN-DESUM-P16:45	dkar phyogs skyong zhing bstan pa spel :	4	dkar phyogs skyong zhing ston ba spel 
BO_TZ_DZOGCHEN-DESUM-P16:46	kyai : btshan yul zangs thang dmar po na :	4	kyai btshan yul zangs thang dmar po na 
BO_TZ_DZOGCHEN-DESUM-P16:47	zangs ri rtshe dgu'i pho brang nas :	4	zangs ri rtshe dgu pho brang nas 
BO_TZ_DZOGCHEN-DESUM-P16:48	btshan rgyal bskal pa'i me ltar 'bar :	4	btshan rgyal bskal ba me ltar bar 
BO_TZ_DZOGCHEN-DESUM-P16:49	mdung dmar zhags pa glog ltar 'khyugs :	4	mdung dmar zhags ba glog ltar khyugs 
BO_TZ_DZOGCHEN-DESUM-P16:50	bswe khrab zangs rmog ya la la :	5	bswe khrab zangs rmog ya la la 
BO_TZ_DZOGCHEN-DESUM-P16:51	rta dmar rlung gshog dgong mo 'grim :	5	rta dmar rlung gshog dgong mo grim 
BO_TZ_DZOGCHEN-DESUM-P16:52	btshan dmag shan pa 'bum gyis bskor :	5	btshan dmag shan ba bum gyis skor 
BO_TZ_DZOGCHEN-DESUM-P16:53	sha khrag dmar gyi gtor ma bzhes :	5	sha khrag dmar gyi thor ma bzhes 
BO_TZ_DZOGCHEN-DESUM-P16:54	nag phyogs sgrol la bstan pa srungs :	5	nag phyogs sgrol la ston ba srungs 
BO_TZ_DZOGCHEN-DESUM-P16:55	kyai : klu yul rgya mtshho steng sngon nas :	5	kyai klu yul rgya mtshho steng sngon nas 
BO_TZ_DZOGCHEN-DESUM-P16:56	klu rgyal dkar la sngo ba'i mdangs :	5	klu rgyal dkar la sngo ba mdangs 
BO_TZ_DZOGCHEN-DESUM-P16:57	yid 'ong khye 'u gzhon nu'i tshhul :	5	yid ng khye u gzhon nu tshhul 
BO_TZ_DZOGCHEN-DESUM-P16:58	dar gyi na bza' rin chen brgyan :	5	dar gyi na bza rin chen rgyan 
BO_TZ_DZOGCHEN-DESUM-P16:59	sbrul mjug g.yas 'khyil klu rta 'chibs :	5	sbrul mjug g.yas khyil klu rta chibs 
BO_TZ_DZOGCHEN-DESUM-P16:60	yid bzhin nor bu gter bum 'dzin :	6	yid bzhin nor bu gter bum dzin 
BO_TZ_DZOGCHEN-DESUM-P16:61	klu sman klu phran 'bum gyis bskor :	6	klu sman klu phran bum gyis skor 
BO_TZ_DZOGCHEN-DESUM-P16:62	dkar gsum bdud rtshi'i gtor ma bzhes :	6	dkar gsum bdud rtshi thor ma bzhes 
BO_TZ_DZOGCHEN-DESUM-P16:63	snying po'i rnal 'byor thams cad la :	6	snying po rnal byor thams cad la 
BO_TZ_DZOGCHEN-DESUM-P16:64	longs spyod dngos grub char ltar phob :	6	longs spyod dngos grub char ltar phob 
BO_TZ_DZOGCHEN-DESUM-P16:65	ces brjod la gtor ma phyi rol tu 'bul /	6	ces rjod la thor ma phyi rol tu bul 
BO_TZ_DZOGCHEN-DESUM-P16:66	sarba b+hu ta gatsh+tshhas rang gnas su gshegs /	6	sarba b+hu ta gatsh+tshhas rang gnas su gshegs 
BO_TZ_DZOGCHEN-DESUM-P16:67	zhes gter gzhung sor bzhag la spyi 'gro'i kha skong phran bus brgyan te 'chi med bstan gnyis g.yung drung gling pas dge slong kun dga' rgyan mtshhan thugs bzhed ltar bgyis pa dge legs 'phel ///	6	zhes gter gzhung sor jog la spyi gro kha skong phran bud rgyan te chi med ston gnyis g.yung drung gling ba dge slong kun dga rgyan mtshhan thugs bzhed ltar bgyid ba dge legs phel 
