segmentnr	original	folio	stemmed
BO_TZ_PEMA-SANGTHIG-P15:0	@#// pad+ma gsang ba'i thig le'i rtsha rgyud pad+ma zab pa'i bsdus 'grel pad+mo'i drwa ba bzhugs so //	0	pad+ma gsang ba thig le rtsha brgyud pad+ma zab ba sdud grel pad+mo drwa ba bzhugs so 
BO_TZ_PEMA-SANGTHIG-P15:1	bcom ldan 'das bde ba chen po ye shes rdo rje tshhe dpag tu med pa la phyag 'tshhal lo //	0	joms ldan da bde ba chen po ye shes rdo rje tshhe dpog tu med ba la phyag tshhal lo 
BO_TZ_PEMA-SANGTHIG-P15:2	rtsha rgyud pad+ma zab pa'i bsdus don rnam par 'grel ba la /	0	rtsha brgyud pad+ma zab ba sdud don rnam ba grel ba la 
BO_TZ_PEMA-SANGTHIG-P15:3	spyir rgyud 'di snga 'gyur rnying ma yin la de la yang theg pa rim pa dgu'i rnam par gzhag pa las 'di ni nang gi rgyud sde a ti'i ma ha ltar du bshad pa yin /	0	spyir brgyud di snga gyur rnying ma yin la de la yang theg ba rim ba dgu rnam ba jog ba las di ni nang gi brgyud sde a ti ma ha ltar du chad ba yin 
BO_TZ_PEMA-SANGTHIG-P15:4	de yang gsang snying las /	0	de yang gsang snying las 
BO_TZ_PEMA-SANGTHIG-P15:5	rab la mtshhan bstan 'bring la dbye //	0	rab la mtshhan ston bring la byed 
BO_TZ_PEMA-SANGTHIG-P15:6	tha mar 'bru gnyer bkral ba 'o //	0	tha mar bru gnyer bkral ba mang 
BO_TZ_PEMA-SANGTHIG-P15:7	zhes gsungs pa ltar dbang po rab 'bring tha gsum dang / 'khor la gdams shing bstan pa gtad pa bzhi las /	0	zhes gsungs ba ltar dbang po rab bring tha gsum dang khor la doms shing ston ba gtod ba bzhi las 
BO_TZ_PEMA-SANGTHIG-P15:8	rtsha ba'i dang po dbang po rab la mtshhan bstan pa'i sgo nas bshad na /	0	rtsha ba dang po dbang po rab la mtshhan ston ba sgo nas chad na 
BO_TZ_PEMA-SANGTHIG-P15:9	o rgyan mkha' 'gro'i skad du dang bod skad gnyis las /	0	o rgyan mkha gro skad du dang bod skad gnyis las 
BO_TZ_PEMA-SANGTHIG-P15:10	dang po o rgyan mkha' 'gro'i skad du :	1	dang po o rgyan mkha gro skad du 
BO_TZ_PEMA-SANGTHIG-P15:11	dak+ki dz+yish+tha badzra ka ri na ma :	1	dak+ki dz+yish+tha badzra ka ri na ma 
BO_TZ_PEMA-SANGTHIG-P15:12	gnyis pa bod skad du :	1	gnyis ba bod skad du 
BO_TZ_PEMA-SANGTHIG-P15:13	pad+ma zab pa rtsha ba'i rgyud zhes pa ste /	1	pad+ma zab ba rtsha ba brgyud zhes ba ste 
BO_TZ_PEMA-SANGTHIG-P15:14	de yang pad+ma ni ma chags dri ma bral ba ste 'khor 'das kyi spyi gzhi rang gi rig pa grol 'khrul gyi mtshhan ma las 'das pa /	1	de yang pad+ma ni ma chags dri ma bral ba ste khor da kyi spyi gzhi rang gi rig ba grol khrul gyi mtshhan ma las da ba 
BO_TZ_PEMA-SANGTHIG-P15:15	gzhi yi gnas skabs de ltar yin yang lam dus su sgrib pa rnam pa gsum gyis bsgribs pa rnams lam rim pa gnyis la brten nas sbyong bas zab pa ste /	1	gzhi yi gnas skabs de ltar yin yang lam dus su sgrib ba rnam ba gsum gyis sgrib ba rnams lam rim ba gnyis la rten nas sbyong ba zab ba ste 
BO_TZ_PEMA-SANGTHIG-P15:16	de kho na nyid kyi gnas lugs rang gis mngon sum du rtogs par 'gyur ba'i thabs khyad du 'phags pa ni 'dir bshad bya yin zhing /	1	de kho na nyid kyi gnas lugs rang gis mngon sum du rtogs ba gyur ba thabs khyad du phag ba ni dir chad byed yin zhing 
BO_TZ_PEMA-SANGTHIG-P15:17	rtsha ba'i rgyud 'di las rim pa gnyis sogs gsang sngags kyi rgyud sde rnams 'phro bar 'gyur la /	1	rtsha ba brgyud di las rim ba gnyis sogs gsang sngags kyi brgyud sde rnams phro ba gyur la 
BO_TZ_PEMA-SANGTHIG-P15:18	'dir de dag gi don tshhang la ma nor ba ston pa yin pas na de skad do //	1	dir de dag gi don tshhang la ma nor ba ston ba yin ba na de skad do 
BO_TZ_PEMA-SANGTHIG-P15:19	//rtsha ba'i gnyis pa dbang po 'bring la spyi don rnam par dbye ba'i sgo nas bshad na /	1	ba gnyis ba dbang po bring la spyi don rnam ba byed ba sgo nas chad na 
BO_TZ_PEMA-SANGTHIG-P15:20	de la yang rgyud 'byung ba'i rgyu gleng gzhi dang / rkyen gleng bslang ba gnyis las /	2	de la yang brgyud byung ba rgyu gleng gzhi dang rkyen gleng bslang ba gnyis las 
BO_TZ_PEMA-SANGTHIG-P15:21	dang po gleng gzhi la yang phyag 'tshhal ba dang / gleng gzhi dngos so //	2	dang po gleng gzhi la yang phyag tshhal ba dang gleng gzhi dngos so 
BO_TZ_PEMA-SANGTHIG-P15:22	dang po ni /	2	dang po ni 
BO_TZ_PEMA-SANGTHIG-P15:23	bcom ldan 'das sogs nas /	2	joms ldan da sogs nas 
BO_TZ_PEMA-SANGTHIG-P15:24	phyag 'tshhal lo :	2	phyag tshhal lo 
BO_TZ_PEMA-SANGTHIG-P15:25	rang gis rang rig mjal ba'i phyir phyag 'tshhal ba /	2	rang gis rang rig mjal ba phyir phyag tshhal ba 
BO_TZ_PEMA-SANGTHIG-P15:26	de yang rtag chad sogs mu bzhi'i mtha' ma lus pa dang bral zhing nyon mongs 'chi bdag lha bu phung po'i bdud bzhi dang skye rga na 'chi sogs bcom pa /	2	de yang rtag chad sogs mu bzhi mtha ma lus ba dang bral zhing nyon mongs chi bdag lha bu phung po bdud bzhi dang skye rga na chi sogs joms ba 
BO_TZ_PEMA-SANGTHIG-P15:27	stobs bcu mi 'jigs bzhi sogs dang sku lnga gsung lnga thugs lnga yon tan lnga phrin las lnga ste 'bras bu'i chos /	2	stobs chu mi jigs bzhi sogs dang sku lnga gsung lnga thugs lnga yon tan lnga phrin las lnga ste bras bu chos 
BO_TZ_PEMA-SANGTHIG-P15:28	longs spyod rdzogs dang kha sbyor bde chen rang bzhin med /	2	longs spyod rdzogs dang kha sbyor bde chen rang bzhin med 
BO_TZ_PEMA-SANGTHIG-P15:29	snying rjes yongs gang rgyun mi chad dang 'gog med pa sogs sangs rgyas kyi yon tan dang ldan zhing /	2	snying rjes yongs gang rgyun mi chad dang gog med ba sogs sangs rgya kyi yon tan dang ldan zhing 
BO_TZ_PEMA-SANGTHIG-P15:30	zag bcas nye bar len pa'i phung po'i rgyun dang rnam par rtog pa'i mtshhan ma las ring du 'das pa /	3	zag cha nye ba len ba phung po rgyun dang rnam ba rtogs ba mtshhan ma las ring du da ba 
BO_TZ_PEMA-SANGTHIG-P15:31	de lta bu'i rang byung gi rig pa de la 'khor 'das kyi chos su brtags pa'i dri ma dang bral bas pad+ma /	3	de lta bu rang byung gi rig ba de la khor da kyi chos su rtog ba dri ma dang bral ba pad+ma 
BO_TZ_PEMA-SANGTHIG-P15:32	rig pa lha yi phyag rgyar shar pa la sku mdun dang rgyab med pas na kun tu zhal te /	3	rig ba lha yi phyag rgyar char ba la sku mdun dang rgyab med ba na kun tu zhal te 
BO_TZ_PEMA-SANGTHIG-P15:33	de yi rang ngo rang gis shes pa la phyag 'tshhal lo zhes ming du btags pa'o //	3	de yi rang ngo rang gis shes ba la phyag tshhal lo zhes ming du dogs ba 
BO_TZ_PEMA-SANGTHIG-P15:34	gnyis pa gleng gzhi dngos la phun sum tshhogs pa bzhi las /	3	gnyis ba gleng gzhi dngos la phun sum tshhogs ba bzhi las 
BO_TZ_PEMA-SANGTHIG-P15:35	'di skad bdag gis sogs nas /	3	di skad bdag gis sogs nas 
BO_TZ_PEMA-SANGTHIG-P15:36	tshhogs thams cad kyis :	3	tshhogs thams cad kyis 
BO_TZ_PEMA-SANGTHIG-P15:37	dus gsum gyi mtshhan ma las 'das pa'i dus phun sum tshhogs par /	3	dus gsum gyi mtshhan ma las da ba dus phun sum tshhogs ba 
BO_TZ_PEMA-SANGTHIG-P15:38	rgya gar yang ma chad phyogs gang du yang ma lhung yangs dog mtho dman gyi 'dzin pa dang bral ba dbyings stong pa nyid rdo rje btshun mo'i b+ha gar /	3	rgya gar yang ma chad phyogs gang du yang ma lhung yangs dog mtho dman gyi dzin ba dang bral ba dbyings stong ba nyid rdo rje btshun mo b+ha gar 
BO_TZ_PEMA-SANGTHIG-P15:39	dus gsum gyi rgyal ba thams cad gsang ba chen po'i rol pas snyoms par zhugs pa'i gnas phun sum tshhogs par /	3	dus gsum gyi rgyal ba thams cad gsang ba chen po rol ba snyom ba jug ba gnas phun sum tshhogs ba 
BO_TZ_PEMA-SANGTHIG-P15:40	gong du bshad pa lta bu'i bcom ldan 'das de nyid 'pho 'gyur gyi mtshhan ma dang bral ba'i bde ba'i ye shes te de ni rdo rje'i chos bdun gyi sgras mtshhon du rung ba /	4	gong du chad ba lta bu joms ldan da de nyid pho gyur gyi mtshhan ma dang bral ba bde ba ye shes te de ni rdo rje chos bdun gyi sgras mtshhon du rung ba 
BO_TZ_PEMA-SANGTHIG-P15:41	skye 'chi bgres rgud dang bral zhing sangs rgyas dang sems can rgyun gcig pa'i bdag nyid yin pas na tshhe dpag tu med pa ste de nyid dbyings dang ye shes gnyis med kyi tshhul gyis rang gi rig ma dang snyoms par zhugs pa'i dga' ba chen po rgyun	4	skye chi bgres rgud dang bral zhing sangs rgya dang sems can rgyun gcig ba bdag nyid yin ba na tshhe dpog tu med ba ste de nyid dbyings dang ye shes gnyis med kyi tshhul gyis rang gi rig ma dang snyom ba jug ba dga ba chen po rgyun 
BO_TZ_PEMA-SANGTHIG-P15:42	chad pa med pas rtag tu mnyes bzhin bzhugs so zhes pas ston pa phun sum tshhogs pa /	4	chad ba med ba rtag tu mnyes bzhin bzhugs so zhes ba ston ba phun sum tshhogs ba 
BO_TZ_PEMA-SANGTHIG-P15:43	de yi 'khor ni gtsho bo dang dbye ba med kyang rtshal las shar pa'i dga' ba bzhi'i rang mdangs sgeg mo ma sogs dang / dga' ba'i ngo bo stong pa bzhi'i rang bzhin can gyi me tog ma sogs te /	4	de yi khor ni gtsho bo dang byed ba med kyang rtshal las char ba dga ba bzhi rang mdangs sgeg mo ma sogs dang dga ba ngo bo stong ba bzhi rang bzhin can gyi me tog ma sogs te 
BO_TZ_PEMA-SANGTHIG-P15:44	de dag kyang rang rang gi ngo bo bde ba dang stong pa gnyis su med pa'i ye shes kyis lus sems yongs su myos bzhin pa'i 'khor gyi tshhogs te /	4	de dag kyang rang rang gi ngo bo bde ba dang stong ba gnyis su med ba ye shes kyis lus sems yongs su myos bzhin ba khor gyi tshhogs te 
BO_TZ_PEMA-SANGTHIG-P15:45	de dag gis kyang bcom ldan 'das kyi sku la zag med bde ba chen po'i mchod pa rgyun mi chad par 'bul ba ni 'khor phun sum tshhogs pa /	4	de dag gis kyang joms ldan da kyi sku la zag med bde ba chen po mchod ba rgyun mi chad ba bul ba ni khor phun sum tshhogs ba 
BO_TZ_PEMA-SANGTHIG-P15:46	chos phun sum tshhogs pa ni de lta bu'i 'khor gyi tshhogs rnams kyis rkyen gleng bslangs pa la brten nas rgyud gsung ba ste /	4	chos phun sum tshhogs ba ni de lta bu khor gyi tshhogs rnams kyis rkyen gleng bslangs ba la rten nas brgyud gsung ba ste 
BO_TZ_PEMA-SANGTHIG-P15:47	gnyis pa rkyen gleng bslang ba chos phun tshhogs de la yang gzung 'dzin rang bzhin med par bstan pa'i phyir gleng bslang ba ni /	4	gnyis ba rkyen gleng bslang ba chos phun tshhogs de la yang gzung dzin rang bzhin med ba ston ba phyir gleng bslang ba ni 
BO_TZ_PEMA-SANGTHIG-P15:48	bcom ldan 'das kyi sogs nas /	4	joms ldan da kyi sogs nas 
BO_TZ_PEMA-SANGTHIG-P15:49	glu blangs pa ni :	4	glu blangs ba ni 
BO_TZ_PEMA-SANGTHIG-P15:50	e ma ho :	5	e ma ho 
BO_TZ_PEMA-SANGTHIG-P15:51	zhes ngo mtshhar ba'i ched du brjod pa sngon du 'gro bas /	5	zhes ngo mtshhar ba ched du rjod ba sngon du gro ba 
BO_TZ_PEMA-SANGTHIG-P15:52	sangs rgyas thams cad kun gyi sku gsung thugs kyi gsang ba rmad du byung ba'i mchog	5	sangs rgya thams cad kun gyi sku gsung thugs kyi gsang ba rmad du byung ba mchog 
BO_TZ_PEMA-SANGTHIG-P15:53	/mtshhan rtog gis mi phyed pas rdo rje nyon mongs gzung 'dzin gyi nad 'joms pas bdud rtshi rtag chad la sogs blo yi dri ma dang bral ba ste med pa /	5	rtogs gis mi phyed ba rdo rje nyon mongs gzung dzin gyi nad joms ba bdud rtshi rtag chad la sogs blo yi dri ma dang bral ba ste med ba 
BO_TZ_PEMA-SANGTHIG-P15:54	de kho na nyid sangs rgyas kyi dgongs nyams yang dag pa'i ye shes kyi ngo bo stong pa nyid la /	5	de kho na nyid sangs rgya kyi dgongs nyams yang dag ba ye shes kyi ngo bo stong ba nyid la 
BO_TZ_PEMA-SANGTHIG-P15:55	mchog tu mi 'gyur ba'i bde ba chen po rig pa'i ye shes rang gi nang nas sam stong pa'i dbyings las rang shar pa ste skyes pa /	5	mchog tu mi gyur ba bde ba chen po rig ba ye shes rang gi nang nas sam stong ba dbyings las rang char ba ste skye ba 
BO_TZ_PEMA-SANGTHIG-P15:56	de lta bu'i bde stong gnyis su med pa'i ye shes kyis /	5	de lta bu bde stong gnyis su med ba ye shes kyis 
BO_TZ_PEMA-SANGTHIG-P15:57	'pho 'gyur gyi dri ma dang bral ba'i chos kyi bdud rtshi ma rtogs pa'i 'gro ba lam rgyud lngar 'khyams pa'i sems can thams cad kyi rgyud yongs su gang ba'i dngos grub stshol cig pa'o //	5	pho gyur gyi dri ma dang bral ba chos kyi bdud rtshi ma rtogs ba gro ba lam brgyud lngar khyam ba sems can thams cad kyi brgyud yongs su gang ba dngos grub stshol cig ba 
BO_TZ_PEMA-SANGTHIG-P15:58	zhes 'khor gyis zhus pas brtshe ba'i thugs rje skyes te chos gsung ba'i phyir lan du bka' bstshal ba la yang 'dzin sems rang bzhin med par bstan pa dang / gzung yul lha yi 'khor lor bstan pa gnyis las /	5	zhes khor gyis zhus ba brtshe ba thugs rje skye te chos gsung ba phyir lan du bka bstshal ba la yang dzin sems rang bzhin med ba ston ba dang gzung yul lha yi khor lor ston ba gnyis las 
BO_TZ_PEMA-SANGTHIG-P15:59	dang po ni /	5	dang po ni 
BO_TZ_PEMA-SANGTHIG-P15:60	e ma ho :	6	e ma ho 
BO_TZ_PEMA-SANGTHIG-P15:61	ye nas sogs nas /	6	ye nas sogs nas 
BO_TZ_PEMA-SANGTHIG-P15:62	thabs kyis chod :	6	thabs kyis chod 
BO_TZ_PEMA-SANGTHIG-P15:63	e ma ho :	6	e ma ho 
BO_TZ_PEMA-SANGTHIG-P15:64	zhes dgyes pa'i dbug dbyung ba sngon du 'gro bas /	6	zhes dgyes ba bugs byin ba sngon du gro ba 
BO_TZ_PEMA-SANGTHIG-P15:65	ye nas gsang ba ste lhan cig skyes pa'i ma rig pas bsgribs te don dam pa'i bden pa ma mthong /	6	ye nas gsang ba ste lhan cig skye ba ma rig ba sgrib te don dam ba bden ba ma mthong 
BO_TZ_PEMA-SANGTHIG-P15:66	kun brtags kyi ma rig pas bsgribs te kun rdzob kyi bden pa ma mthong /	6	kun rtog kyi ma rig ba sgrib te kun rdzob kyi bden ba ma mthong 
BO_TZ_PEMA-SANGTHIG-P15:67	snang stong dbyer med ma shes pa ngo bo nyid kyis gsang ba /	6	snang stong dbyer med ma shes ba ngo bo nyid kyis gsang ba 
BO_TZ_PEMA-SANGTHIG-P15:68	yul dang yul can tha dad du bzung bas don dam yid dpyod dang bral bar ma rtogs pas shin tu gsang ba ste /	6	yul dang yul can tha dad du bzung ba don dam yid dpyod dang bral ba ma rtogs ba shin tu gsang ba ste 
BO_TZ_PEMA-SANGTHIG-P15:69	de ltar sus kyang ma mthong ba'i sangs rgyas kyi de kho na nyid mngon sum du rtogs par byed pa'i thabs chos kyi sgo bstan pa la yang /	6	de ltar sus kyang ma mthong ba sangs rgya kyi de kho na nyid mngon sum du rtogs ba byed ba thabs chos kyi sgo ston ba la yang 
BO_TZ_PEMA-SANGTHIG-P15:70	ming tshhig sogs brjod pa'i yul las 'das shing rang gi rang bzhin 'di lta bu'o zhes sus kyang mtshhon du med pa'i bdag nyid can /	7	ming tshhig sogs rjod ba yul las da shing rang gi rang bzhin di lta bu zhes sus kyang mtshhon du med ba bdag nyid can 
BO_TZ_PEMA-SANGTHIG-P15:71	so so rang rig pa'i ye shes kyi rtshal sna tshhogs su spros pa rnams kyang 'gag pa'i mtha' dang bral zhing /	7	so so rang rig ba ye shes kyi rtshal sna tshhogs su spros ba rnams kyang gag ba mtha dang bral zhing 
BO_TZ_PEMA-SANGTHIG-P15:72	rtshal sna tshhogs su spros pa de dag kyang mtshhan rtog gi cha las yang dag par 'das pa /	7	rtshal sna tshhogs su spros ba de dag kyang mtshhan rtogs gi cha las yang dag ba da ba 
BO_TZ_PEMA-SANGTHIG-P15:73	spro bar bya ba dang spro bar byed po so sor dbye ba'i chos ye nas dben pa ste med pa /	7	spro ba byed ba dang spro ba byed po so sor byed ba chos ye nas dben ba ste med ba 
BO_TZ_PEMA-SANGTHIG-P15:74	'phros pa'i rang bzhin nam snang cha de la yang brda' 'am tha snyad du btags pa'i chos 'di 'o zhes dus gsum gyi rgyal bas kyang mtshhon pa'i yul las 'das pa ste med /	7	phro ba rang bzhin nam snang cha de la yang brda mang tha snyad du dogs ba chos di mang zhes dus gsum gyi rgyal ba kyang mtshhon ba yul las da ba ste med 
BO_TZ_PEMA-SANGTHIG-P15:75	rtshal sna tshhogs 'phros pa de dag kyang 'dir gnas so zhes sam 'di nyid yin no zhes brtag tu med cing /	7	rtshal sna tshhogs phro ba de dag kyang dir gnas so zhes sam di nyid yin no zhes rtog tu med cing 
BO_TZ_PEMA-SANGTHIG-P15:76	de bzhin du mthar 'gag pa dang 'gags pa'i yul 'di na'o zhes ye nas dben pa ste med la /	7	de bzhin du mthar gag ba dang gag ba yul di na zhes ye nas dben ba ste med la 
BO_TZ_PEMA-SANGTHIG-P15:77	de lta bu'i sems kyi rang bzhin de med pa phyal bar chad pa yang ma yin te sangs rgyas nas sems can gyi bar rgyu gcig pa rdo rje lta bu'i rgyud dngos po'i gshis la mtshhan mas gzhom par mi nus pa mchog tu mi 'gyur ba'i bde ba	7	de lta bu sems kyi rang bzhin de med ba phyal ba chad ba yang ma yin te sangs rgya nas sems can gyi ba rgyu gcig ba rdo rje lta bu brgyud dngos po gshis la mtshhan mas joms ba mi nus ba mchog tu mi gyur ba bde ba 
BO_TZ_PEMA-SANGTHIG-P15:78	chen po rdo rje'i ye shes che ni /	7	chen po rdo rje ye shes che ni 
BO_TZ_PEMA-SANGTHIG-P15:79	sangs rgyas nyid kyis kyang nyid las gzhan du gyur pa'i chos rdul tsham yang mi brnyes pa ste ma gzigs shing /	7	sangs rgya nyid kyis kyang nyid las gzhan du gyur ba chos rdul tsham yang mi brnyes ba ste ma gzigs shing 
BO_TZ_PEMA-SANGTHIG-P15:80	rang gi rang rig dri ma med pa 'di nyid chos kyi sku zhes sgras brjod pa tsham yin la /	8	rang gi rang rig dri ma med ba di nyid chos kyi sku zhes sgras rjod ba tsham yin la 
BO_TZ_PEMA-SANGTHIG-P15:81	rig pa skad cig ma gcig la 'khor 'das kyi chos thams cad rdzogs pa la e ma ho zhes ngo mtshhar ba'i bdag nyid can de ltar yin yang /	8	rig ba skad cig ma gcig la khor da kyi chos thams cad rdzogs ba la e ma ho zhes ngo mtshhar ba bdag nyid can de ltar yin yang 
BO_TZ_PEMA-SANGTHIG-P15:82	sems can thams cad glo bur gyi dri mas bsgribs te gong du bshad pa ltar ngo bo nyid kyis gsang bar gyur pa ste /	8	sems can thams cad glo bur gyi dri mas sgrib te gong du chad ba ltar ngo bo nyid kyis gsang ba gyur ba ste 
BO_TZ_PEMA-SANGTHIG-P15:83	skye 'gag gnas pa gsum dang bral ba'i gnyug ma'i de kho na nyid kyi gnas lugs ma rtogs pas rang gsang thabs kyis chod pa'i bdag nyid can yin no zhes bstan pa'o //	8	skye gag gnas ba gsum dang bral ba gnyug ma de kho na nyid kyi gnas lugs ma rtogs ba rang gsang thabs kyis chod ba bdag nyid can yin no zhes ston ba 
BO_TZ_PEMA-SANGTHIG-P15:84	don gnyis pa gzung yul lha yi 'khor lor bstan pa le rjes dang bcas pa ni /	8	don gnyis ba gzung yul lha yi khor lor ston ba le rjes dang cha ba ni 
BO_TZ_PEMA-SANGTHIG-P15:85	sangs rgyas chos khams sogs nas /	8	sangs rgya chos khams sogs nas 
BO_TZ_PEMA-SANGTHIG-P15:86	dang po rdzogs so :	8	dang po rdzogs so 
BO_TZ_PEMA-SANGTHIG-P15:87	de ltar nang 'dzin pa'i sems gzhi med rtsha bral de ltar yin yang /	8	de ltar nang dzin ba sems gzhi med rtsha bral de ltar yin yang 
BO_TZ_PEMA-SANGTHIG-P15:88	phyi gzung ba'i yul dang phung po lngas bsdus pa'i chos thams cad bden grub zhig go snyam na ma yin te /	8	phyi gzung ba yul dang phung po lngas sdud ba chos thams cad bden grub jig go snyam na ma yin te 
BO_TZ_PEMA-SANGTHIG-P15:89	'di ltar snang ba thams cad rab rib can gyi mig la skra shad mthong ba ltar log snang kho na las /	8	di ltar snang ba thams cad rab rib can gyi mig la skra shad mthong ba ltar log snang kho na las 
BO_TZ_PEMA-SANGTHIG-P15:90	don du sangs rgyas thams cad kyi snang ngor gzung yul phyi nang chos khams thams cad ye nas rnam par dag pa'i bdag nyid can te /	9	don du sangs rgya thams cad kyi snang ngor gzung yul phyi nang chos khams thams cad ye nas rnam ba dag ba bdag nyid can te 
BO_TZ_PEMA-SANGTHIG-P15:91	'byung lngas bsdus pa'i snod kyi 'jig rten 'di dag kyang /	9	byung lngas sdud ba snod kyi jig rten di dag kyang 
BO_TZ_PEMA-SANGTHIG-P15:92	sa sangs rgyas spyan ma /	9	sa sangs rgya spyan ma 
BO_TZ_PEMA-SANGTHIG-P15:93	chu ma ma ki	9	chu ma ma ki 
BO_TZ_PEMA-SANGTHIG-P15:94	/me gos dkar mo /	9	gos dkar mo 
BO_TZ_PEMA-SANGTHIG-P15:95	rlung dam tshhig sgrol ma /	9	rlung dam tshhig sgrol ma 
BO_TZ_PEMA-SANGTHIG-P15:96	nam mkha' dbyings kyi dbang phyug ma'i yum chen gyi rang bzhin du gnas su dag pas snang yul thams cad mkha' 'gro ma lnga yi rang bzhin yin la /	9	nam mkha dbyings kyi dbang phyug ma yum chen gyi rang bzhin du gnas su dag ba snang yul thams cad mkha gro ma lnga yi rang bzhin yin la 
BO_TZ_PEMA-SANGTHIG-P15:97	nang phung khams lnga yi tshhogs 'di yang sangs rgyas lnga'i bdag nyid gzugs phung mi bskyod pa /	9	nang phung khams lnga yi tshhogs di yang sangs rgya lnga bdag nyid gzugs phung mi skyod ba 
BO_TZ_PEMA-SANGTHIG-P15:98	tshhor ba rin 'byung /	9	tshhor ba rin byung 
BO_TZ_PEMA-SANGTHIG-P15:99	'du shes snang mtha'/	9	du shes snang 
BO_TZ_PEMA-SANGTHIG-P15:100	'du byed don grub /	10	du byed don grub 
BO_TZ_PEMA-SANGTHIG-P15:101	rnam shes rnam par snang mdzad /	10	rnam shes rnam ba snang mdzad 
BO_TZ_PEMA-SANGTHIG-P15:102	mig gi shes pa gnas su dag pa sems dpa' sa snying /	10	mig gi shes ba gnas su dag ba sems dpa sa snying 
BO_TZ_PEMA-SANGTHIG-P15:103	rna ba'i shes pa nam mkha'i snying po /	10	rna ba shes ba nam mkha snying po 
BO_TZ_PEMA-SANGTHIG-P15:104	sna yi shes pa spyan ras gzigs /	10	sna yi shes ba spyan ras gzigs 
BO_TZ_PEMA-SANGTHIG-P15:105	lce'i rnam shes phyag na rdo rje /	10	lce rnam shes phyag na rdo rje 
BO_TZ_PEMA-SANGTHIG-P15:106	mig gi dbang po byams pa /	10	mig gi dbang po byams ba 
BO_TZ_PEMA-SANGTHIG-P15:107	rna dbang sgrib sel /	10	rna dbang sgrib sel 
BO_TZ_PEMA-SANGTHIG-P15:108	sna dbang kun bzang /	10	sna dbang kun bzang 
BO_TZ_PEMA-SANGTHIG-P15:109	lce dbang 'jam dpal /	10	lce dbang jam dpal 
BO_TZ_PEMA-SANGTHIG-P15:110	mig gi yul gzugs su snang ba gnas su dag pa sems ma rdo rje sgeg mo /	11	mig gi yul gzugs su snang ba gnas su dag ba sems ma rdo rje sgeg mo 
BO_TZ_PEMA-SANGTHIG-P15:111	dri gnas dag rdo rje phreng ba ma /	11	dri gnas dag rdo rje phreng ba ma 
BO_TZ_PEMA-SANGTHIG-P15:112	sgra gnas dag glu ma /	11	sgra gnas dag glu ma 
BO_TZ_PEMA-SANGTHIG-P15:113	ro gnas dag gar ma /	11	ro gnas dag gar ma 
BO_TZ_PEMA-SANGTHIG-P15:114	dus 'das pa'i rtog pa gnas su dag pa me tog ma /	11	dus da ba rtogs ba gnas su dag ba me tog ma 
BO_TZ_PEMA-SANGTHIG-P15:115	da lta'i rtog pa gnas dag bdug spos ma /	11	da lta rtogs ba gnas dag bdug spros ma 
BO_TZ_PEMA-SANGTHIG-P15:116	ma 'ongs pa gnas dag mar me ma /	11	ma ngs ba gnas dag mar me ma 
BO_TZ_PEMA-SANGTHIG-P15:117	ma nges pa gnas dag dri chab ma dang / yid byed pa po gnas su dag pa kun tu bzang po /	11	ma nges ba gnas dag dri chab ma dang yid byed ba po gnas su dag ba kun tu bzang po 
BO_TZ_PEMA-SANGTHIG-P15:118	chos bya ba mo gnas su rnam par dag pa kun tu bzang mo ste /	11	chos byed ba mo gnas su rnam ba dag ba kun tu bzang mo ste 
BO_TZ_PEMA-SANGTHIG-P15:119	mdor na gser gyi gling du phyin na sa rdo phal pa mi rnyed pa bzhin /	11	mdor na gser gyi gling du phyin na sa rdo phal ba mi rnyed ba bzhin 
BO_TZ_PEMA-SANGTHIG-P15:120	ye nas rnam par dag pa'i bdag nyid can yin la /	12	ye nas rnam ba dag ba bdag nyid can yin la 
BO_TZ_PEMA-SANGTHIG-P15:121	sgrib pa gsum gyis bsgribs pa'i gang zag ma dag 'khrul pa'i snang ngor ri ra ba khang khyim sogs dang bde sdug kun brtags sna tshhogs pa snang na yang /	12	sgrib ba gsum gyis sgrib ba gang zag ma dag khrul ba snang ngor ri ra ba khang khyim sogs dang bde sdug kun rtog sna tshhogs ba snang na yang 
BO_TZ_PEMA-SANGTHIG-P15:122	don rang gi ngo bo'i cha nas zhib tu dpyad cing brtags na bden grub tu gyur pa rdul tsham yang ma mchis te gtan tshhigs chen po rnam pa bzhis dpyad pas rdzun phugs rang sar rdib nas stong nyid du thag chod cing /	12	don rang gi ngo bo cha nas zhib tu dpyod cing rtog na bden grub tu gyur ba rdul tsham yang ma mchis te gtan tshhigs chen po rnam ba bzhis dpyod ba rdzun phugs rang sar rdib nas stong nyid du thag chod cing 
BO_TZ_PEMA-SANGTHIG-P15:123	stong pa'i dbyings las rang byung lha yi snang cha rang shar ba 'di dag spros pa med pa 'od gsal ba'i bdag nyid do //	12	stong ba dbyings las rang byung lha yi snang cha rang char ba di dag spros ba med ba d gsal ba bdag nyid do 
BO_TZ_PEMA-SANGTHIG-P15:124	zhes gsungs te le'u 'og ma dkyil 'khor gyi 'khor lo rnam par spro ba'i ting nge 'dzin la zhugs so //	12	zhes gsungs te leu g ma dkyil khor gyi khor lo rnam ba spro ba ting nge dzin la jug so 
BO_TZ_PEMA-SANGTHIG-P15:125	'di yan gyis dbang po 'bring gi ngor spyi don rnam par gtan la dbab pa le'u dang po'i don 'grel song ngo //	12	di yan gyis dbang po bring gi ngor spyi don rnam ba gtan la bebs ba leu dang po don grel gro ngo 
BO_TZ_PEMA-SANGTHIG-P15:126	//rtsha ba'i gsum pa dbang po tha mar 'bru gnyer bkral ba'i sgo nas /	12	ba gsum ba dbang po tha mar bru gnyer bkral ba sgo nas 
BO_TZ_PEMA-SANGTHIG-P15:127	'bras bu yongs shes kyi rgyud don dngos bshad pa la dbang bzhi'i lam dang 'brel ba'i rnal 'byor bstan pa las /	12	bras bu yongs shes kyi brgyud don dngos chad ba la dbang bzhi lam dang brel ba rnal byor ston ba las 
BO_TZ_PEMA-SANGTHIG-P15:128	dang po bum dbang dang 'brel ba'i bskyed pa'i rnal 'byor bshad pa la /	12	dang po bum dbang dang brel ba skyed ba rnal byor chad ba la 
BO_TZ_PEMA-SANGTHIG-P15:129	bskyed rim gyi rnam gzhag spyir bstan pa /	12	skyed rim gyi rnam jog spyir ston ba 
BO_TZ_PEMA-SANGTHIG-P15:130	lha yi 'khor lo rten dang brten pa'i rnal 'byor bshad pa /	13	lha yi khor lo rten dang rten ba rnal byor chad ba 
BO_TZ_PEMA-SANGTHIG-P15:131	bsnyen sgrub yan lag bzhi'i chings bstan pa /	13	snyen sgrub yan lag bzhi ching ston ba 
BO_TZ_PEMA-SANGTHIG-P15:132	mthar phyin pas thun mong gi dngos grub sgrub pa'i tshhul rjes 'brel bcas so //	13	mthar phyin ba thun mong gi dngos grub sgrub ba tshhul rjes brel cha so 
BO_TZ_PEMA-SANGTHIG-P15:133	dang po la mdor bstan dang rgyas bshad do //	13	dang po la mdor ston dang rgya chad do 
BO_TZ_PEMA-SANGTHIG-P15:134	dang po ni /	13	dang po ni 
BO_TZ_PEMA-SANGTHIG-P15:135	slar yang dgyes pa sogs nas /	13	slar yang dgyes ba sogs nas 
BO_TZ_PEMA-SANGTHIG-P15:136	rnal 'byor bsgom :	13	rnal byor bsgom 
BO_TZ_PEMA-SANGTHIG-P15:137	e ma ho :	13	e ma ho 
BO_TZ_PEMA-SANGTHIG-P15:138	zhes pas dgyes pa'i dbugs dbyung nas /	13	zhes ba dgyes ba dbugs byin nas 
BO_TZ_PEMA-SANGTHIG-P15:139	le'u gong mar 'khor 'das snod bcud kyis bsdus pa'i chos thams cad dag pa lha yi rol par bstan na yang /	13	leu gong mar khor da snod bcud kyis sdud ba chos thams cad dag ba lha yi rol ba ston na yang 
BO_TZ_PEMA-SANGTHIG-P15:140	blo dman pa'i gang zag tha mal pa rnams kyi ngor log pa'i zhen snang 'di dag sbyang ba'i phyir rim pa gnyis las dang po bskyed pa'i rnal 'byor bsgom par bya'o //	14	blo dman ba gang zag tha mal ba rnams kyi ngor log ba zhen snang di dag sbyong ba phyir rim ba gnyis las dang po skyed ba rnal byor bsgom ba byed 
BO_TZ_PEMA-SANGTHIG-P15:141	zhes pas bstan /	14	zhes ba ston 
BO_TZ_PEMA-SANGTHIG-P15:142	gnyis pa rgyas bshad la /	14	gnyis ba rgya chad la 
BO_TZ_PEMA-SANGTHIG-P15:143	mngal skyes la sogs sogs nas /	14	mngal skye la sogs sogs nas 
BO_TZ_PEMA-SANGTHIG-P15:144	rnam grol pa :	14	rnam grol ba 
BO_TZ_PEMA-SANGTHIG-P15:145	de yang spyir mngal skyes kyi 'dzin pa sbyang ba'i phyir cho ga gsum bskyed de sa bon dang phyag mtshhan de las sku bskyed pa dang / drod gsher skyes kyi 'dzin pa sbyang phyir sa bon las 'od zer 'phro 'du byed de bskyed pa /	14	de yang spyir mngal skye kyi dzin ba sbyong ba phyir cho ga gsum skyed de sa bon dang phyag mtshhan de las sku skyed ba dang drod gsher skye kyi dzin ba sbyong phyir sa bon las d zer phro du byed de skyed ba 
BO_TZ_PEMA-SANGTHIG-P15:146	sgong skyes sbyang phyir dang po rgyu yi he ru ka de yongs su gyur pa las 'bras bu'i he ru ka bskyed pa /	14	sgongs skye sbyong phyir dang po rgyu yi he ru ka de yongs su gyur ba las bras bu he ru ka skyed ba 
BO_TZ_PEMA-SANGTHIG-P15:147	brdzus skyes sbyang phyir skad cig dran rdzogs su sgom pa ste ting nge 'dzin rnam pa bzhi'am /	14	brdzus skye sbyong phyir skad cig dran rdzogs su sgom ba ste ting nge dzin rnam ba bzhi 
BO_TZ_PEMA-SANGTHIG-P15:148	de nyid bzhir phye ba dag yod cing /	14	de nyid bzhir byed ba dag yod cing 
BO_TZ_PEMA-SANGTHIG-P15:149	gang ltar yang kun rdzob dang don dam pa'i bden pas bsdus pa'i chos thams cad ye nas rnam par dag pa lhag pa'i chos sku chen po'i rang bzhin stong pa chen po'i rnal 'byor la gnas pa de bzhin nyid kyi ting nge 'dzin te /	14	gang ltar yang kun rdzob dang don dam ba bden ba sdud ba chos thams cad ye nas rnam ba dag ba lhag ba chos sku chen po rang bzhin stong ba chen po rnal byor la gnas ba de bzhin nyid kyi ting nge dzin te 
BO_TZ_PEMA-SANGTHIG-P15:150	'di la gnas pas mar 'chi ba'i srid pa sbyong /	15	di la gnas ba mar chi ba srid ba sbyong 
BO_TZ_PEMA-SANGTHIG-P15:151	yar chos sku'i yon tan rdzogs par byed /	15	yar chos sku yon tan rdzogs ba byed 
BO_TZ_PEMA-SANGTHIG-P15:152	bar stong nyid snying rje sgom pa'i lam smin par byed /	15	ba stong nyid snying rje sgom ba lam smin ba byed 
BO_TZ_PEMA-SANGTHIG-P15:153	stong pa nyid de lta bu'i don ma rtogs pa'i nam mkha' mnyam pa'i 'gro ba la dmigs pa med pa'i snying rje chen po sgyu ma lta bu'i tshhul can kun tu snang ba'i ting nge 'dzin bsgoms pas mar bar do'i srid pa sbyong /	15	stong ba nyid de lta bu don ma rtogs ba nam mkha mnyam ba gro ba la dmigs ba med ba snying rje chen po sgyu ma lta bu tshhul can kun tu snang ba ting nge dzin sgom ba mar ba do srid ba sbyong 
BO_TZ_PEMA-SANGTHIG-P15:154	yar longs sku'i yon tan rdzogs /	15	yar longs sku yon tan rdzogs 
BO_TZ_PEMA-SANGTHIG-P15:155	bar snying rje sgyu ma lta bu'i lam smin par byed /	15	ba snying rje sgyu ma lta bu lam smin ba byed 
BO_TZ_PEMA-SANGTHIG-P15:156	stong nyid dang snying rje zung du 'jug pa'i ngang las sa bon sgom pa rgyu yi ting nge 'dzin te /	15	stong nyid dang snying rje zung du jug ba ngang las sa bon sgom ba rgyu yi ting nge dzin te 
BO_TZ_PEMA-SANGTHIG-P15:157	'dis mar skye ba'i srid pa sbyong /	15	dis mar skye ba srid ba sbyong 
BO_TZ_PEMA-SANGTHIG-P15:158	yar sangs rgyas sprul sku'i yon tan rdzogs /	15	yar sangs rgya sprul sku yon tan rdzogs 
BO_TZ_PEMA-SANGTHIG-P15:159	bar stong nyid snying rje zung 'jug sgyu ma lta bu'i lam sgom pa smin par byed /	15	ba stong nyid snying rje zung jug sgyu ma lta bu lam sgom ba smin ba byed 
BO_TZ_PEMA-SANGTHIG-P15:160	des na skye 'chi bar do la sogs pa'i 'dzin pa sbyang phyir cho ga gsum gyi ting 'dzin bsgom par bya zhing /	16	des na skye chi ba do la sogs ba dzin ba sbyong phyir cho ga gsum gyi ting dzin bsgom ba byed zhing 
BO_TZ_PEMA-SANGTHIG-P15:161	mdor na bskyed rim gyi grub mtha' snod dang bcud kyis bsdus pa'i chos 'di dag thams cad /	16	mdor na skyed rim gyi grub mtha snod dang bcud kyis sdud ba chos di dag thams cad 
BO_TZ_PEMA-SANGTHIG-P15:162	snod 'byung ba lnga yum lnga /	16	snod byung ba lnga yum lnga 
BO_TZ_PEMA-SANGTHIG-P15:163	bcud phung po lnga rgyal ba yab lnga /	16	bcud phung po lnga rgyal ba yab lnga 
BO_TZ_PEMA-SANGTHIG-P15:164	rgyud rnam shes tshhogs brgyad ye shes lngar dag pa gsum gyi rang bzhin te /	16	brgyud rnam shes tshhogs brgyad ye shes lngar dag ba gsum gyi rang bzhin te 
BO_TZ_PEMA-SANGTHIG-P15:165	spros pa phyogs re ba chod pa rnam grangs pa'i don dam dang spros pa thams cad chod pa rnam grangs ma yin pa'i don dam gnyis skye med du mnyam /	16	spros ba phyogs re ba chod ba rnam grangs ba don dam dang spros ba thams cad chod ba rnam grangs ma yin ba don dam gnyis skye med du mnyam 
BO_TZ_PEMA-SANGTHIG-P15:166	yang dag dang log pa'i kun rdzob gnyis ka sgyu ma lta bu'i ngang du mnyam /	16	yang dag dang log ba kun rdzob gnyis ka sgyu ma lta bu ngang du mnyam 
BO_TZ_PEMA-SANGTHIG-P15:167	rtag chad kyi mtha' gnyis ka stong nyid du mnyam /	16	rtag chad kyi mtha gnyis ka stong nyid du mnyam 
BO_TZ_PEMA-SANGTHIG-P15:168	dag ma dag gi snang ba gnyis ka lha yi 'khor lor mnyam pa ste /	16	dag ma dag gi snang ba gnyis ka lha yi khor lor mnyam ba ste 
BO_TZ_PEMA-SANGTHIG-P15:169	mnyam gnyis lhag pa'i mnyam gnyis kyis 'khor 'das kyi chos rnams dag pa lha yi dkyil 'khor kun tu bzang po'i zhing khams te phyogs bcu dang stong khams 'jig rten gyi tshhogs thams cad ye nas bden grub tu gyur pa rdul tsham yang dben pa yin la /	16	mnyam gnyis lhag ba mnyam gnyis kyis khor da kyi chos rnams dag ba lha yi dkyil khor kun tu bzang po zhing khams te phyogs chu dang stong khams jig rten gyi tshhogs thams cad ye nas bden grub tu gyur ba rdul tsham yang dben ba yin la 
BO_TZ_PEMA-SANGTHIG-P15:170	de lta bu'i dag pa gsum dang mnyam pa bzhi'i rang bzhin du rnam par dag pa'i chos nyid la rang gi ngo bo ye nas ngang gis rnam par grol pa yin no //	17	de lta bu dag ba gsum dang mnyam ba bzhi rang bzhin du rnam ba dag ba chos nyid la rang gi ngo bo ye nas ngang gis rnam ba grol ba yin no 
BO_TZ_PEMA-SANGTHIG-P15:171	gnyis pa lha yi 'khor lo rten dang brten pa'i rnal 'byor bshad pa ni /	17	gnyis ba lha yi khor lo rten dang rten ba rnal byor chad ba ni 
BO_TZ_PEMA-SANGTHIG-P15:172	yum lnga dag pa'i sogs nas /	17	yum lnga dag ba sogs nas 
BO_TZ_PEMA-SANGTHIG-P15:173	cir yang snang :	17	cir yang snang 
BO_TZ_PEMA-SANGTHIG-P15:174	rgyu yi sa bon hrihyig las 'od zer 'phros /	17	rgyu yi sa bon hrihyig las d zer phro 
BO_TZ_PEMA-SANGTHIG-P15:175	'phags pa rnams la phyi nang gsang ba'i mchod pa phul /	17	phag ba rnams la phyi nang gsang ba mchod ba bul 
BO_TZ_PEMA-SANGTHIG-P15:176	sems can thams cad dus ma yin par 'chi ba'i 'jigs pa bsal /	17	sems can thams cad dus ma yin ba chi ba jigs ba bsal 
BO_TZ_PEMA-SANGTHIG-P15:177	'od zer tshhur 'dus yongs su gyur pa las /	17	d zer tshhur du yongs su gyur ba las 
BO_TZ_PEMA-SANGTHIG-P15:178	nam mkha' rlung me chu sa ste yum lnga dag pa'i 'byung ba rim brtshegs kyi steng du ri rab phyogs kyi kha dog can /	17	nam mkha rlung me chu sa ste yum lnga dag ba byung ba rim brtshegs kyi steng du ri rab phyogs kyi kha dog can 
BO_TZ_PEMA-SANGTHIG-P15:179	de yi steng sna tshhogs rdo rje'i dbus su nor bu chu shel las grub pa'i gzhal yas khang gru bzhi sgo bzhi rta babs bzhi pa /	17	de yi steng sna tshhogs rdo rje dbus su nor bu chu shel las grub ba jal yas khang gru bzhi sgo bzhi rta bab bzhi ba 
BO_TZ_PEMA-SANGTHIG-P15:180	rtshig pa lnga sbrags steng pha gu ser po la rin po che du ma'i phra tshhom mdzes pa /	18	rtshig ba lnga sbrag steng pha gu ser po la rin po che du ma phra tshhom mdzes ba 
BO_TZ_PEMA-SANGTHIG-P15:181	mun khang la mu tig gtsho bor gyur pa'i rin po che du ma'i drwa ba dang drwa ba phyed pa 'phyang ba /	18	mun khang la mu tig gtsho bor gyur ba rin po che du ma drwa ba dang drwa ba phyed ba phyang ba 
BO_TZ_PEMA-SANGTHIG-P15:182	nor bu chu shel las grub pa'i shar bu spyi blugs thur du 'phyang ba lta bu /	18	nor bu chu shel las grub ba char bu spyi blugs thur du phyang ba lta bu 
BO_TZ_PEMA-SANGTHIG-P15:183	dzam bu chu bo'i gser las grub pa'i mda' yab pad+ma'i dbyibs can /	18	dzam bu chu bo gser las grub ba mda yab pad+ma dbyibs can 
BO_TZ_PEMA-SANGTHIG-P15:184	nang ka ba bzhi bzhis btegs pa'i thog gi dbus phyur bur phub pa'i rtsher gser sbyangs las grub pa'i gany+dzi ra rtshe mor lha yi nor bu rin po che 'od zer mtha' yas pa 'phro bas brgyan pa /	18	nang ka ba bzhi bzhis degs ba thogs gi dbus phyur bur bubs ba rtsher gser sbyong las grub ba gany+dzi ra rtshe mor lha yi nor bu rin po che d zer mtha yas ba phro ba rgyan ba 
BO_TZ_PEMA-SANGTHIG-P15:185	rta babs kyi g.yas g.yon du bum bzang las thon pa'i dpag bsam gyi shing lo 'bras me tog g.yur du za ba /	18	rta bab kyi g.yas g.yon du bum bzang las thon ba dpog bsam gyi shing lo bras me tog g.yur du za ba 
BO_TZ_PEMA-SANGTHIG-P15:186	rta babs kyi rtsher chos 'khor gdugs dang ri dwags pho mos brgyan pa /	18	rta bab kyi rtsher chos khor gdugs dang ri dwags pho mos rgyan ba 
BO_TZ_PEMA-SANGTHIG-P15:187	sgo dang sgo khyud kyi mtshhams su zla phyed rdo rjes spras pa /	18	sgo dang sgo khyud kyi mtshhams su zla phyed rdo rjes spras ba 
BO_TZ_PEMA-SANGTHIG-P15:188	rtshig pa'i rtsha bar 'dod yon gyi snam bu dmar por rig ma bcu drug mchod rdzas du ma thogs te gnas pa /	18	rtshig ba rtsha ba dod yon gyi snam bu dmar por rig ma chu drug mchod rdzas du ma thogs te gnas ba 
BO_TZ_PEMA-SANGTHIG-P15:189	nang gi khyams phyogs kyi kha dog can /	18	nang gi khyams phyogs kyi kha dog can 
BO_TZ_PEMA-SANGTHIG-P15:190	gzhan yang bkra shis rtags rdzas rgyal srid sna bdun sogs mchod sprin bsam mi khyab pas bskor ba ste /	19	gzhan yang bkra shis rtags rdzas rgyal srid sna bdun sogs mchod sprin bsam mi khyab ba skor ba ste 
BO_TZ_PEMA-SANGTHIG-P15:191	de dag gis kyang mar sems can 'khrul pa'i las snang snod kyi 'jig rten gnas khang nyer spyod 'dod yon la sogs pa'i 'dzin pa sbyong /	19	de dag gis kyang mar sems can khrul ba las snang snod kyi jig rten gnas khang nyer spyod dod yon la sogs ba dzin ba sbyong 
BO_TZ_PEMA-SANGTHIG-P15:192	yar sangs rgyas kyi sar lam byang chub kyi chos so bdun stobs bcu mi 'jigs bzhi ma 'dres pa'i chos bco brgyad sogs sangs rgyas kyi yon tan rnams lhun grub tu yongs su rdzogs /	19	yar sangs rgya kyi sar lam byang chub kyi chos so bdun stobs chu mi jigs bzhi ma dre ba chos chos brgyad sogs sangs rgya kyi yon tan rnams lhun grub tu yongs su rdzogs 
BO_TZ_PEMA-SANGTHIG-P15:193	bar du de lta bu'i lam sgom pa rnams gong nas gong du smin par byed pa ste /	19	ba du de lta bu lam sgom ba rnams gong nas gong du smin ba byed ba ste 
BO_TZ_PEMA-SANGTHIG-P15:194	ye shes chen po'i rtshal yongs su rdzogs pa'i man+da la 'am dkyil 'khor gyi 'khor lo rnam par bsgom par bya'o //	19	ye shes chen po rtshal yongs su rdzogs ba man+da la mang dkyil khor gyi khor lo rnam ba bsgom ba byed 
BO_TZ_PEMA-SANGTHIG-P15:195	de lta bu'i gzhal yas khang gi nang bcud rnam par dag pa lha yi 'khor lo sgom pa'i tshhul yang /	19	de lta bu jal yas khang gi nang bcud rnam ba dag ba lha yi khor lo sgom ba tshhul yang 
BO_TZ_PEMA-SANGTHIG-P15:196	rtog tshhogs brgyad khri bzhi stong ye nas lha yi rol par dag pa'i rigs kyi phyag rgya'am lha yi sku cir yang snang ba ste sna tshhogs sgom pa yin la /	19	rtogs tshhogs brgyad khri bzhi stong ye nas lha yi rol ba dag ba rigs kyi phyag rgya lha yi sku cir yang snang ba ste sna tshhogs sgom ba yin la 
BO_TZ_PEMA-SANGTHIG-P15:197	'di la yang /	19	di la yang 
BO_TZ_PEMA-SANGTHIG-P15:198	dang po rgyu /	19	dang po rgyu 
BO_TZ_PEMA-SANGTHIG-P15:199	de las phyag rgya gcig pa /	19	de las phyag rgya gcig ba 
BO_TZ_PEMA-SANGTHIG-P15:200	de las gtsho 'khor yongs rdzogs te /	20	de las gtsho khor yongs rdzogs te 
BO_TZ_PEMA-SANGTHIG-P15:201	dang po ni /	20	dang po ni 
BO_TZ_PEMA-SANGTHIG-P15:202	dang po rgyu yi sogs nas /	20	dang po rgyu yi sogs nas 
BO_TZ_PEMA-SANGTHIG-P15:203	rgyan du shar :	20	rgyan du char 
BO_TZ_PEMA-SANGTHIG-P15:204	rgyu yi sa bon hrihyig dkar po gsal zhing 'bar ba sgoms /	20	rgyu yi sa bon hrihyig dkar po gsal zhing bar ba sgoms 
BO_TZ_PEMA-SANGTHIG-P15:205	de la drod thob nas rim bzhin shin tu phra ba'i hrihyig grangs med pa nam mkha' gang bar spro zhing slar de dag sa bon la bsdu bar bslab cing /	20	de la drod thob nas rim bzhin shin tu phra ba hrihyig grangs med ba nam mkha gang ba spro zhing slar de dag sa bon la sdud ba bslab cing 
BO_TZ_PEMA-SANGTHIG-P15:206	'phel 'grib bral ba gsal brtan gyi nyams dang ldan pa'i rgyan du ma shar bar du sbyangs pas ting nge 'dzin gyi gzhi 'ding /	20	phel grib bral ba gsal brtan gyi nyams dang ldan ba rgyan du ma char ba du sbyong ba ting nge dzin gyi gzhi ding 
BO_TZ_PEMA-SANGTHIG-P15:207	gnyis pa de las phyag rgya gcig pa ni /	20	gnyis ba de las phyag rgya gcig ba ni 
BO_TZ_PEMA-SANGTHIG-P15:208	de las phyag rgya sogs nas /	20	de las phyag rgya sogs nas 
BO_TZ_PEMA-SANGTHIG-P15:209	mngon du bya :	20	mngon du byed 
BO_TZ_PEMA-SANGTHIG-P15:210	de las phyag rgya gcig pa yi gtsho bo yab rkyang bsgom zhing /	21	de las phyag rgya gcig ba yi gtsho bo yab rkyang bsgom zhing 
BO_TZ_PEMA-SANGTHIG-P15:211	de yang dang po shin tu mkhas pas bris pa'i gzugs brnyan la legs par sems gtad de /	21	de yang dang po shin tu mkhas ba bri ba gzugs rnyan la legs ba sems gtod de 
BO_TZ_PEMA-SANGTHIG-P15:212	yid yul du lam mer shar ba dang de 'dra ba'i gzugs su bsgom /	21	yid yul du lam mer char ba dang de dra ba gzugs su bsgom 
BO_TZ_PEMA-SANGTHIG-P15:213	spyi bo nas gdan khri'i bar dang / gdan khri nas spyi bo'i bar sogs su rim bzhin gsal gdab ste myong ba thon nges byas la /	21	spyi bo nas gdan khri ba dang gdan khri nas spyi bo ba sogs su rim bzhin gsal gdab ste myong ba thon nges byed la 
BO_TZ_PEMA-SANGTHIG-P15:214	de yang rang bzhin gnyug ma'i ye shes lha yi phyag rgyar shar ba ste bskyed rdzogs zung 'jug gi don mngon du bya ba la bslab /	21	de yang rang bzhin gnyug ma ye shes lha yi phyag rgyar char ba ste skyed rdzogs zung jug gi don mngon du byed ba la bslab 
BO_TZ_PEMA-SANGTHIG-P15:215	gsum pa de las gtsho 'khor yongs rdzogs ni /	21	gsum ba de las gtsho khor yongs rdzogs ni 
BO_TZ_PEMA-SANGTHIG-P15:216	phyag rgya rgya cher sogs nas /	21	phyag rgya rgya cher sogs nas 
BO_TZ_PEMA-SANGTHIG-P15:217	rnam par rdzogs :	21	rnam ba rdzogs 
BO_TZ_PEMA-SANGTHIG-P15:218	de nas gtsho 'khor yongs rdzogs sgom pa la /	21	de nas gtsho khor yongs rdzogs sgom ba la 
BO_TZ_PEMA-SANGTHIG-P15:219	gong du bshad pa'i gzhal yas khang gi dbus su kha dog sna tshhogs pa'i pad+ma 'dab ma brgyad pa'i lte ba ge sar gyi snying por 'og nyi ma steng zla ba ste gwa'u kha sbyor gyi steng du /	21	gong du chad ba jal yas khang gi dbus su kha dog sna tshhogs ba pad+ma dab ma brgyad ba lte ba ge sar gyi snying por g nyi ma steng zla ba ste gwau kha sbyor gyi steng du 
BO_TZ_PEMA-SANGTHIG-P15:220	rang gi rig pa'i ngo bo hrihyig dkar po gnas pa yongs su gyur pa las bcom ldan 'das bde ba chen po 'chi med pad+ma 'byung gnas gzhung bzhin bsgoms pa'i /	22	rang gi rig ba ngo bo hrihyig dkar po gnas ba yongs su gyur ba las joms ldan da bde ba chen po chi med pad+ma byung gnas gzhung bzhin sgom ba 
BO_TZ_PEMA-SANGTHIG-P15:221	phyogs mtshhams kyi pad+ma'i 'dab mar sgeg sogs mchod pa'i lha mo dang sgo bzhir mgyogs ma bzhi bcas lha yi phyag rgya rgya cher spros pa ma 'dres yongs su rdzogs pa nam mkha' la 'ja' shar pa ltar snang la rang bzhin med pa'i rnal 'byor la bslab cing	22	phyogs mtshhams kyi pad+ma dab mar sgeg sogs mchod ba lha mo dang sgo bzhir mgyog ma bzhi cha lha yi phyag rgya rgya cher spros ba ma dre yongs su rdzogs ba nam mkha la ja char ba ltar snang la rang bzhin med ba rnal byor la bslab cing 
BO_TZ_PEMA-SANGTHIG-P15:222	/ gdod nas dug lnga ye shes lnga'i rang bzhin du dag cing /	22	gdod nas dug lnga ye shes lnga rang bzhin du dag cing 
BO_TZ_PEMA-SANGTHIG-P15:223	phung khams las dbang thams cad gdan gsum tshhang ba'i lha yi rol par rang shar ba la dbang bskur ba dang spyan 'dren pa sogs kyi spros mtshhan las 'das kyang /	22	phung khams las dbang thams cad gdan gsum tshhang ba lha yi rol ba rang char ba la dbang skur ba dang spyan bgrang ba sogs kyi spros mtshhan las da kyang 
BO_TZ_PEMA-SANGTHIG-P15:224	rnam pa'i cha la tha mal gyi zhen pa sbyang ba'i phyir ye shes pa dgug cing bstim /	22	rnam ba cha la tha mal gyi zhen ba sbyong ba phyir ye shes ba gugs cing stim 
BO_TZ_PEMA-SANGTHIG-P15:225	rang las sprul pa'i lha mo mtha' yas pas phyi nang gsang ba'i mchod pa phul zhing /	22	rang las sprul ba lha mo mtha yas ba phyi nang gsang ba mchod ba bul zhing 
BO_TZ_PEMA-SANGTHIG-P15:226	gsang gsum yon tan dran pas bstod pa'i rol mo 'khrol /	22	gsang gsum yon tan dran ba bstod ba rol mo khrol 
BO_TZ_PEMA-SANGTHIG-P15:227	dgongs rgyud rtogs pa'i byin rlabs 'pho med rdo rje tshhe yi dngos grub bskul ba bcas song nas sprul pa'i lha mo rnams rang la bstim mo //	22	dgongs brgyud rtogs ba byin rlabs pho med rdo rje tshhe yi dngos grub skul ba cha gro nas sprul ba lha mo rnams rang la stim mo 
BO_TZ_PEMA-SANGTHIG-P15:228	'di dag gis kyang mar 'dod pa'i chos lnga la longs spyod pa sogs khams gsum gyi zhen snang rags pa sbyong /	22	di dag gis kyang mar dod ba chos lnga la longs spyod ba sogs khams gsum gyi zhen snang rags ba sbyong 
BO_TZ_PEMA-SANGTHIG-P15:229	yar bsod nams dang ye shes kyi tshhogs gnyis yongs su rdzogs shing chos gzugs kyi sku gnyis thob ste zhing gi bkod pa bsam las 'das pa thob pa'i yon tan rdzogs /	22	yar bsod nams dang ye shes kyi tshhogs gnyis yongs su rdzogs shing chos gzugs kyi sku gnyis thob ste zhing gi bkod ba bsam las da ba thob ba yon tan rdzogs 
BO_TZ_PEMA-SANGTHIG-P15:230	bar du de dag gi mthu sgrub pa rnams gong nas gong du smin par byed do //	23	ba du de dag gi mthu sgrub ba rnams gong nas gong du smin ba byed do 
BO_TZ_PEMA-SANGTHIG-P15:231	'di dag gi skabs su dag pa dran pa'i rnal 'byor la yang bslab ste /	23	di dag gi skabs su dag ba dran ba rnal byor la yang bslab ste 
BO_TZ_PEMA-SANGTHIG-P15:232	zag pa med pa'i bde ba chen po'i lang tshhos gang bas sku mdog dkar la dmar mdangs chags pa /	23	zag ba med ba bde ba chen po lang tshhos gang ba sku mdog dkar la dmar mdangs chags ba 
BO_TZ_PEMA-SANGTHIG-P15:233	chos sku mtshhon pa'i zhal gcig pa 'gro la rjes su chags pas 'dzum pa'i mdangs can /	23	chos sku mtshhon ba zhal gcig ba gro la rjes su chags ba dzum ba mdangs can 
BO_TZ_PEMA-SANGTHIG-P15:234	phyag gnyis snang stong zung 'jug	23	phyag gnyis snang stong zung jug 
BO_TZ_PEMA-SANGTHIG-P15:235	/g.yas rdo rjes skye 'chi'i rtog pa 'joms /	23	rdo rjes skye chi rtogs ba joms 
BO_TZ_PEMA-SANGTHIG-P15:236	g.yon tshhe bum gyis 'pho med gzhon nu bum skur khams gsum po 'ubs chub pa /	23	g.yon tshhe bum gyis pho med gzhon nu bum skur khams gsum po ubs chub ba 
BO_TZ_PEMA-SANGTHIG-P15:237	bden gnyis zung du 'jug pa'i zhabs rdo rje'i skyil krung /	23	bden gnyis zung du jug ba zhabs rdo rje skyil krung 
BO_TZ_PEMA-SANGTHIG-P15:238	shes rab stong pa nyid kyi rang mdangs yum dang 'khril ba /	23	shes rab stong ba nyid kyi rang mdangs yum dang khril ba 
BO_TZ_PEMA-SANGTHIG-P15:239	chos kyi dbyings spros mtshhan las 'das pas yum rgyan med gcer bu /	23	chos kyi dbyings spros mtshhan las da ba yum rgyan med bcer bu 
BO_TZ_PEMA-SANGTHIG-P15:240	g.yas mda' dar gyis srid zhi'i dwangs bcud sdud pa /	24	g.yas mda dar gyis srid zhi dwangs bcud sdud ba 
BO_TZ_PEMA-SANGTHIG-P15:241	g.yon tshhe bum gyis sgrub la 'chi med stshol ba /	24	g.yon tshhe bum gyis sgrub la chi med stshol ba 
BO_TZ_PEMA-SANGTHIG-P15:242	yab kyi sku la rin po che'i rgyan brgyad dar gyi chas gos lnga sogs kyis brgyan pa ni sangs rgyas kyi spangs dang rtogs pa'i yon tan thams cad yongs su rdzogs pa /	24	yab kyi sku la rin po che rgyan brgyad dar gyi cha gos lnga sogs kyis rgyan ba ni sangs rgya kyi spong dang rtogs ba yon tan thams cad yongs su rdzogs ba 
BO_TZ_PEMA-SANGTHIG-P15:243	ye shes kyi rtshal las sprul pa'i cha shas mtha' klas pas 'gro ba sgrol bas 'od zer bsam yas 'phro ba sogs gzhi 'bras sbrel ba'i dag pa dran pa la rtshe gcig tu bslab pa'i mthus snod bcud tha mal snang zhen sbyang /	24	ye shes kyi rtshal las sprul ba cha shas mtha klas ba gro ba sgrol ba d zer bsam yas phro ba sogs gzhi bras sbrel ba dag ba dran ba la rtshe gcig tu bslab ba mthus snod bcud tha mal snang zhen sbyong 
BO_TZ_PEMA-SANGTHIG-P15:244	e ma zhes ngo mtshhar ba ste /	24	e ma zhes ngo mtshhar ba ste 
BO_TZ_PEMA-SANGTHIG-P15:245	tha mal gyi zhen pa sbyong ba'i rmad du byung ba'i chos ni 'di yin te /	24	tha mal gyi zhen ba sbyong ba rmad du byung ba chos ni di yin te 
BO_TZ_PEMA-SANGTHIG-P15:246	de dag thams cad kyang med pa la yod pa'i sgro btags pa ma rig 'khrul pa'i gang zag rnams kyi snang ngor /	24	de dag thams cad kyang med ba la yod ba sgro dogs ba ma rig khrul ba gang zag rnams kyi snang ngor 
BO_TZ_PEMA-SANGTHIG-P15:247	bdag gzhan gnyis su 'dzin pa'i rtog pa shin tu 'thas pas sgyu ma lta bu'i chos nyid kyi don 'di ma rtogs par /	24	bdag gzhan gnyis su dzin ba rtogs ba shin tu thas ba sgyu ma lta bu chos nyid kyi don di ma rtogs ba 
BO_TZ_PEMA-SANGTHIG-P15:248	bde sdug dgra gnyen sogs su 'khrul te de kho na nyid kyi gnas lugs ma shes pa'i byis pa thams cad a thang chad /	24	bde sdug dgra gnyen sogs su khrul te de kho na nyid kyi gnas lugs ma shes ba byis ba thams cad a thang chad 
BO_TZ_PEMA-SANGTHIG-P15:249	rnal 'byor pa thams cad la ni sna tshhogs rang gi rig pa spros pa dang bral ba'i klong /	24	rnal byor ba thams cad la ni sna tshhogs rang gi rig ba spros ba dang bral ba klong 
BO_TZ_PEMA-SANGTHIG-P15:250	'das ma 'ongs da lta ste dus gsum gyi cha dang bral ba'i bzhi pa'i cha ni dus kyi 'dzin pa med pa'am spang ba'i rig pa'i ngo bo 'di zhes mtshhon du med pa nam mkha' lta bu'i ngang la 'khor 'das kyi chos thams cad kun rnam par yongs	25	da ma ngs da lta ste dus gsum gyi cha dang bral ba bzhi ba cha ni dus kyi dzin ba med ba spong ba rig ba ngo bo di zhes mtshhon du med ba nam mkha lta bu ngang la khor da kyi chos thams cad kun rnam ba yongs 
BO_TZ_PEMA-SANGTHIG-P15:251	su rdzogs pa ste /	25	su rdzogs ba ste 
BO_TZ_PEMA-SANGTHIG-P15:252	de lta bu'i lha dang rang sems ro mnyam gyi ngang la mnyam par gzhag	25	de lta bu lha dang rang sems ro mnyam gyi ngang la mnyam ba jog 
BO_TZ_PEMA-SANGTHIG-P15:253	/mdor na rang gi phung khams skye mched snod bcud gzung 'dzin gyis bsdus pa'i chos thams cad lha yi 'khor lo dngos yin snyam pa'i nga rgyal brtan pa la yang nas yang du bslab bo //	25	na rang gi phung khams skye mched snod bcud gzung dzin gyis sdud ba chos thams cad lha yi khor lo dngos yin snyam ba nga rgyal brtan ba la yang nas yang du bslab bo 
BO_TZ_PEMA-SANGTHIG-P15:254	don gsum pa bsnyen sgrub yan lag bzhi'i chings bstan pa la /	25	don gsum ba snyen sgrub yan lag bzhi ching ston ba la 
BO_TZ_PEMA-SANGTHIG-P15:255	mdor bstan / rgyas bshad do //	25	mdor ston rgya chad do 
BO_TZ_PEMA-SANGTHIG-P15:256	dang po ni /	25	dang po ni 
BO_TZ_PEMA-SANGTHIG-P15:257	rnam pa'i cha las sogs nas /	25	rnam ba cha las sogs nas 
BO_TZ_PEMA-SANGTHIG-P15:258	yang dag bsgrub :	25	yang dag sgrub 
BO_TZ_PEMA-SANGTHIG-P15:259	nges don du 'khor 'das thams cad rig pa'i ngang du ro mnyam na'ang /	25	nges don du khor da thams cad rig ba ngang du ro mnyam na 
BO_TZ_PEMA-SANGTHIG-P15:260	rnam pa'i cha la sangs rgyas kyi mdzad pa bsgrub pa'i phyir spro bsdu'i ting nge 'dzin gyi chos phrul yang dag par bsgrub par bya'o //	26	rnam ba cha la sangs rgya kyi mdzad ba sgrub ba phyir spro sdud ting nge dzin gyi chos phrul yang dag ba sgrub ba byed 
BO_TZ_PEMA-SANGTHIG-P15:261	gnyis pa rgyas bshad ni /	26	gnyis ba rgya chad ni 
BO_TZ_PEMA-SANGTHIG-P15:262	bsnyen pa zla ba sogs nas /	26	snyen ba zla ba sogs nas 
BO_TZ_PEMA-SANGTHIG-P15:263	gzer bzhi gces :	26	gzer bzhi gces 
BO_TZ_PEMA-SANGTHIG-P15:264	bsnyen pa'i skabs su zla ba skar phreng lta bu ste /	26	snyen ba skabs su zla ba skar phreng lta bu ste 
BO_TZ_PEMA-SANGTHIG-P15:265	ye shes sems dpa'i thugs kar nyi zla'i gwa'u kha sbyor gyi dbus su /	26	ye shes sems dpa thugs kar nyi zla gwau kha sbyor gyi dbus su 
BO_TZ_PEMA-SANGTHIG-P15:266	ting 'dzin sems dpa' hrihyig gi mthar bzla bya'i sngags phreng g.yas su bskor ba la rtshe gcig tu sems gtad /	26	ting dzin sems dpa hrihyig gi mthar bzla byed sngags phreng g.yas su skor ba la rtshe gcig tu sems gtod 
BO_TZ_PEMA-SANGTHIG-P15:267	g.yo ba'i nyams mi brtan pa /	26	g.yo ba nyams mi brtan ba 
BO_TZ_PEMA-SANGTHIG-P15:268	thob pa'i nyams cung zad brtan pa /	26	thob ba nyams cung zad brtan ba 
BO_TZ_PEMA-SANGTHIG-P15:269	goms pa'i nyams rab tu brtan pa /	26	goms ba nyams rab tu brtan ba 
BO_TZ_PEMA-SANGTHIG-P15:270	brtan pa'i nyams mi g.yo ba /	27	brtan ba nyams mi g.yo ba 
BO_TZ_PEMA-SANGTHIG-P15:271	mthar phyin pa'i nyams yeng du med pa ste /	27	mthar phyin ba nyams yeng du med ba ste 
BO_TZ_PEMA-SANGTHIG-P15:272	de ltar ma byung gi bar du sa ma d+hi'i ting nge 'dzin la rtshe gcig tu dus rtag par brtshon pas bslab bo //	27	de ltar ma byung gi ba du sa ma d+hi ting nge dzin la rtshe gcig tu dus rtag ba brtshon ba bslab bo 
BO_TZ_PEMA-SANGTHIG-P15:273	nye bar bsnyen pa'i skabs su rgyal po yi phrin las 'bangs kyis sgrub pa bzhin sngags phreng mi g.yo bar 'od zer dpag med 'phros te sems can tha ma khams gsum rgyud lnga'i 'gro ba thams cad sdug bsngal las bsgral te gnas skabs mthar thug gi bde ba	27	nye ba snyen ba skabs su rgyal po yi phrin las bang kyis sgrub ba bzhin sngags phreng mi g.yo ba d zer dpog med phro te sems can tha ma khams gsum brgyud lnga gro ba thams cad sdug sngal las bsgral te gnas skabs mthar thug gi bde ba 
BO_TZ_PEMA-SANGTHIG-P15:274	la bzhag /sems can bar pa nyan thos rang rgyal thams cad 'gogs pa las bslangs te byang chub sems dpa'i sa la bzhag	27	la jog can ba ba nyan thos rang rgyal thams cad gogs ba las bslangs te byang chub sems dpa sa la jog 
BO_TZ_PEMA-SANGTHIG-P15:275	/sems can dang po byang chub sems dpa' thams cad sa nas sar spar te rdzogs pa'i sangs rgyas kyi sa la sbyor zhing bkod pa sogs dmigs pa'i 'phro 'du la bslab /	27	can dang po byang chub sems dpa thams cad sa nas sar spor te rdzogs ba sangs rgya kyi sa la sbyor zhing bkod ba sogs dmigs ba phro du la bslab 
BO_TZ_PEMA-SANGTHIG-P15:276	sgrub pa'i skabs sngags phreng rnams g.yas su mgal me klad la bskor ba 'khor ba ltar 'khor ba'i 'od zer 'phros 'dus tha mal gyi zhen snang rags pa sbyangs te /	27	sgrub ba skabs sngags phreng rnams g.yas su mgal me klad la skor ba khor ba ltar khor ba d zer phro du tha mal gyi zhen snang rags ba sbyong te 
BO_TZ_PEMA-SANGTHIG-P15:277	dwangs bcud thams cad 'od zer 'ja' tshhon gyi rnam par bsdu ba'i dmigs pa bya /	27	dwangs bcud thams cad d zer ja tshhon gyi rnam ba sdud ba dmigs ba byed 
BO_TZ_PEMA-SANGTHIG-P15:278	sgrub chen skabs sngags re re las kyang de 'dra ba bsam las 'das pa bung ba tshhang zhig ltar 'phros te ma dag pa'i snang ba sbyang /	27	sgrub chen skabs sngags re re las kyang de dra ba bsam las da ba bung ba tshhang jig ltar phro te ma dag ba snang ba sbyong 
BO_TZ_PEMA-SANGTHIG-P15:279	'khor 'das thams cad dag pa gsum dang mnyam pa bzhi'i bdag nyid chen por sbyangs par byas par bsam /	27	khor da thams cad dag ba gsum dang mnyam ba bzhi bdag nyid chen por sbyong ba byed ba bsam 
BO_TZ_PEMA-SANGTHIG-P15:280	de lta bu'i bskyed rim dus kyi gnas skabs kun tu srog sdom gzer bzhi dang ma bral bar bya ste /	28	de lta bu skyed rim dus kyi gnas skabs kun tu srog sdom gzer bzhi dang ma bral ba byed ste 
BO_TZ_PEMA-SANGTHIG-P15:281	gong du bshad pa'i bskyed rim gyi ting nge 'dzin dang ma bral ba /	28	gong du chad ba skyed rim gyi ting nge dzin dang ma bral ba 
BO_TZ_PEMA-SANGTHIG-P15:282	lhag chad myur bul gyi skyon dang bral ba'i sngags bzla ba /	28	lhag chad myur bul gyi skyon dang bral ba sngags bzla ba 
BO_TZ_PEMA-SANGTHIG-P15:283	lha dang rang sems ro mnyam gyi ngang du mnyam par gzhag pa /	28	lha dang rang sems ro mnyam gyi ngang du mnyam ba jog ba 
BO_TZ_PEMA-SANGTHIG-P15:284	'od zer spro bsdu sogs sgom pa ste de lta bu'i gzer bzhi dang ma bral ba shin tu nas kyang gces pa yin no //	28	d zer spro sdud sogs sgom ba ste de lta bu gzer bzhi dang ma bral ba shin tu nas kyang gces ba yin no 
BO_TZ_PEMA-SANGTHIG-P15:285	bzhi pa bskyed rim mthar phyin pa'i rnal 'byor pas thun mong gi dngos grub sgrub pa'i tshhul rnams dang lam la bsngags pa le rjes bcas ni /	28	bzhi ba skyed rim mthar phyin ba rnal byor ba thun mong gi dngos grub sgrub ba tshhul rnams dang lam la bsngags ba le rjes cha ni 
BO_TZ_PEMA-SANGTHIG-P15:286	shin tu sbyangs pa'i sogs nas /	28	shin tu sbyong ba sogs nas 
BO_TZ_PEMA-SANGTHIG-P15:287	gnyis pa rdzogs so :	28	gnyis ba rdzogs so 
BO_TZ_PEMA-SANGTHIG-P15:288	gzhung du bshad pa bzhin rtogs sla bas 'dir zhib tu brir ma langs shing /	28	gzhung du chad ba bzhin rtogs sla ba dir zhib tu brir ma ldang shing 
BO_TZ_PEMA-SANGTHIG-P15:289	rdo rje sa 'og tu 'gro ba'i man ngag rigs zhib par rdo rje sa 'og gi rgyud sogs las rtogs dgos shing /	28	rdo rje sa g tu gro ba man ngag rigs zhib ba rdo rje sa g gi brgyud sogs las rtogs dgos shing 
BO_TZ_PEMA-SANGTHIG-P15:290	bla ma'i man ngag yid la 'chang zhing sems rtshe gcig pas las rab 'byams 'grub par 'gyur ro //	29	bla ma man ngag yid la chang zhing sems rtshe gcig ba las rab byam grub ba gyur ro 
BO_TZ_PEMA-SANGTHIG-P15:291	de ltar ya mtshhan rmad du byung ba'i chos tha mal gyi mtshhan rtog sbyong ba'i thabs kyi cho 'phrul bsam las 'das pa /	29	de ltar ya mtshhan rmad du byung ba chos tha mal gyi mtshhan rtogs sbyong ba thabs kyi cho phrul bsam las da ba 
BO_TZ_PEMA-SANGTHIG-P15:292	rgyu rkyen med par rang byung lhun gyis grub pa'i ye shes kyi sku pad+ma sam+b+ha ba'i dgongs pa'i rtshal las shar pa'i chos rmad du byung ba lha sku phyag rgya sgom pa'i sngags 'dis ni snod bcud tha mal gyi zhen pa sbyong /	29	rgyu rkyen med ba rang byung lhun gyis grub ba ye shes kyi sku pad+ma sam+b+ha ba dgongs ba rtshal las char ba chos rmad du byung ba lha sku phyag rgya sgom ba sngags dis ni snod bcud tha mal gyi zhen ba sbyong 
BO_TZ_PEMA-SANGTHIG-P15:293	rnam smin rig 'dzin gyi sa bon thebs /	29	rnam smin rig dzin gyi sa bon thebs 
BO_TZ_PEMA-SANGTHIG-P15:294	gsang ba sngags kyi tshhogs lam mthar phyin par 'gyur ba sogs /	29	gsang ba sngags kyi tshhogs lam mthar phyin ba gyur ba sogs 
BO_TZ_PEMA-SANGTHIG-P15:295	sangs rgyas kyis 'gro ba 'dul ba'i phrin las kyi mdzad pa'i cho 'phrul zab mo kho na'o //	29	sangs rgya kyis gro ba dul ba phrin las kyi mdzad ba cho phrul zab mo kho na 
BO_TZ_PEMA-SANGTHIG-P15:296	//gnyis pa gsang dbang dang 'brel ba'i rtsha rlung thig le'i rnal 'byor bshad pa la /	29	ba gsang dbang dang brel ba rtsha rlung thig le rnal byor chad ba la 
BO_TZ_PEMA-SANGTHIG-P15:297	go don spyir bshad pa dang / man ngag zhib tu dbye ba /	29	go don spyir chad ba dang man ngag zhib tu byed ba 
BO_TZ_PEMA-SANGTHIG-P15:298	'bras bu mthar phyin pa'i tshhul dang gsum mo //	29	bras bu mthar phyin ba tshhul dang gsum mo 
BO_TZ_PEMA-SANGTHIG-P15:299	dang po ni /	29	dang po ni 
BO_TZ_PEMA-SANGTHIG-P15:300	slar yang byang chub sogs nas /	30	slar yang byang chub sogs nas 
BO_TZ_PEMA-SANGTHIG-P15:301	mngon du 'gyur :	30	mngon du gyur 
BO_TZ_PEMA-SANGTHIG-P15:302	gong du bskyed rim gyi chos bshad pa'i de ma thag slar yang gtsho bo yab yum bde ba chen po byang chub sems kyi rang bzhin nam mkha'i sprin ltar 'gro 'ong med pa'i tshhul gyis rnam par 'phro bas /	30	gong du skyed rim gyi chos chad ba de ma thag slar yang gtsho bo yab yum bde ba chen po byang chub sems kyi rang bzhin nam mkha sprin ltar gro ng med ba tshhul gyis rnam ba phro ba 
BO_TZ_PEMA-SANGTHIG-P15:303	gsang ba gsum bde ba chen po'i ye shes shin tu rgyas par mdzad de rdo rje'i glu blangs pa'i tshhul gyis bka' bstshal pa ni /	30	gsang ba gsum bde ba chen po ye shes shin tu rgya ba mdzad de rdo rje glu blangs ba tshhul gyis bka bstshal ba ni 
BO_TZ_PEMA-SANGTHIG-P15:304	yab kyis e ma ho zhes bde ba chen po ngo mtshhar ba'i sgra yis dbugs dbyung ba la /	30	yab kyis e ma ho zhes bde ba chen po ngo mtshhar ba sgra yis dbugs byin ba la 
BO_TZ_PEMA-SANGTHIG-P15:305	yum gyis a la la la la ho zhes chos nyid stong pa nyid kyi ngang du dbyer mi phyed pa'i lan gdab pa dang / rang gi rig pa mi 'gyur ba bde ba'i thabs chen po dang / rig pa'i ngo bo rnam pa kun gyi mchog dang ldan pa'i shes rab stong pa nyid de /	30	yum gyis a la la la la ho zhes chos nyid stong ba nyid kyi ngang du dbyer mi phyed ba lan gdab ba dang rang gi rig ba mi gyur ba bde ba thabs chen po dang rig ba ngo bo rnam ba kun gyi mchog dang ldan ba shes rab stong ba nyid de 
BO_TZ_PEMA-SANGTHIG-P15:306	de gnyis kyi dbyings su zung du 'jug pa'am snyoms par zhugs pa las 'od gsal ba'i ye shes mngon sum du mthong bar 'gyur ba'i phyir ro //	30	de gnyis kyi dbyings su zung du jug ba snyom ba jug ba las d gsal ba ye shes mngon sum du mthong ba gyur ba phyir ro 
BO_TZ_PEMA-SANGTHIG-P15:307	gnyis pa man ngag zhib tu dbye ba rgyas bshad la /	30	gnyis ba man ngag zhib tu byed ba rgya chad la 
BO_TZ_PEMA-SANGTHIG-P15:308	drod kyi gtum mo dang / bde ba'i gtum mo gnyis so //	30	drod kyi thum mo dang bde ba thum mo gnyis so 
BO_TZ_PEMA-SANGTHIG-P15:309	dang po ni /	30	dang po ni 
BO_TZ_PEMA-SANGTHIG-P15:310	rnam pa lam du sogs nas /	31	rnam ba lam du sogs nas 
BO_TZ_PEMA-SANGTHIG-P15:311	rnam bzhi bya :	31	rnam bzhi byed 
BO_TZ_PEMA-SANGTHIG-P15:312	bde stong zung 'jug gi ye shes de nyid rnam pa lam du bya bas rtogs par bya ba'i phyir /	31	bde stong zung jug gi ye shes de nyid rnam ba lam du byed ba rtogs ba byed ba phyir 
BO_TZ_PEMA-SANGTHIG-P15:313	thog mar rang gi lus bde chen chos sku tshhe dpag med pad+ma sam b+ha wa'i sku dngos po'i 'dzin pa dang bral ba stong nyid nam mkha'i dbyings su 'ja' shar pa ltar snang la rang bzhin med pa'i bdag nyid du gsal ba'i /	31	thogs mar rang gi lus bde chen chos sku tshhe dpog med pad+ma sam b+ha wa sku dngos po dzin ba dang bral ba stong nyid nam mkha dbyings su ja char ba ltar snang la rang bzhin med ba bdag nyid du gsal ba 
BO_TZ_PEMA-SANGTHIG-P15:314	lus dbus drang por rtsha dbu ma sbom phra srin lag tsham mar sna rdo rje phyed pa'i rnam pas gsang gnas su sleb pa /	31	lus dbus dren por rtsha dbu ma sbom phra srin lag tsham mar sna rdo rje phyed ba rnam ba gsang gnas su sleb ba 
BO_TZ_PEMA-SANGTHIG-P15:315	yar sna spyi bor zug pa /	31	yar sna spyi bor zug ba 
BO_TZ_PEMA-SANGTHIG-P15:316	de yi g.yas g.yon du ro rkyang gnyis mthe'u chung gi tshhad tsham /	31	de yi g.yas g.yon du ro rkyang gnyis mtheu chung gi tshhad tsham 
BO_TZ_PEMA-SANGTHIG-P15:317	mar sna lte 'og nas dbu mar 'dus pa /	31	mar sna lte g nas dbu mar du ba 
BO_TZ_PEMA-SANGTHIG-P15:318	yar sna sna bug gnyis su zug pa /	31	yar sna sna bug gnyis su zug ba 
BO_TZ_PEMA-SANGTHIG-P15:319	rtsha gsum ka phyi dkar la nang cung zad dmar mdangs yod pa gsal btab la /	31	rtsha gsum ka phyi dkar la nang cung zad dmar mdangs yod ba gsal debs la 
BO_TZ_PEMA-SANGTHIG-P15:320	spyi bo bde ba chen po'i rtsha 'dab so gnyis ni thabs kyi rnam pa thur du lta ba /	32	spyi bo bde ba chen po rtsha dab so gnyis ni thabs kyi rnam ba thur du lta ba 
BO_TZ_PEMA-SANGTHIG-P15:321	mgrin pa ro 'dus kyi 'khor lo'i rtsha 'dab bcu drug ni shes rab rang bzhin gyen du phyogs pa /	32	mgrin ba ro du kyi khor lo rtsha dab chu drug ni shes rab rang bzhin gyen du phyogs ba 
BO_TZ_PEMA-SANGTHIG-P15:322	snying kha chos kyi 'khor lo'i rtsha 'dab brgyad ni gdugs kyi rnam par thur du dbub pa'i 'og	32	snying kha chos kyi khor lo rtsha dab brgyad ni gdugs kyi rnam ba thur du bubs ba g 
BO_TZ_PEMA-SANGTHIG-P15:323	/lte ba sprul pa'i 'khor lo'i rtsha 'dab bcu gnyis ni 'degs pa'i tshhul gyis gyen du gyes pa /	32	ba sprul ba khor lo rtsha dab chu gnyis ni degs ba tshhul gyis gyen du gyes ba 
BO_TZ_PEMA-SANGTHIG-P15:324	gsang gnas bde skyong 'khor lo'i bde ba skyed pa'i rtsha 'dab bzhi thad drang las cung thur du lta ba khyim gyi tshhul du mnyam par 'khyil ba bcas /	32	gsang gnas bde skyong khor lo bde ba skyed ba rtsha dab bzhi thad dren las cung thur du lta ba khyim gyi tshhul du mnyam ba khyil ba cha 
BO_TZ_PEMA-SANGTHIG-P15:325	de dag kyang ro rkyang las cung phra ba /	32	de dag kyang ro rkyang las cung phra ba 
BO_TZ_PEMA-SANGTHIG-P15:326	'ja' ltar bkra ba /	32	ja ltar bkra ba 
BO_TZ_PEMA-SANGTHIG-P15:327	me ltar gsal ba /	32	me ltar gsal ba 
BO_TZ_PEMA-SANGTHIG-P15:328	chu shing ltar drang ba /	32	chu shing ltar dren ba 
BO_TZ_PEMA-SANGTHIG-P15:329	shog bu ltar khong stong ste mtshhan nyid bzhi ldan du gsal gdab la /	32	shog bu ltar khong stong ste mtshhan nyid bzhi ldan du gsal gdab la 
BO_TZ_PEMA-SANGTHIG-P15:330	khong du yod pa'i 'byung ba'i dug lnga dang 'dres pa'i rlung thams cad lag len ltar sangs kyis bus te rnam par bsal /	33	khong du yod ba byung ba dug lnga dang dre ba rlung thams cad lag len ltar sangs kyis bud te rnam ba bsal 
BO_TZ_PEMA-SANGTHIG-P15:331	dag pa ye shes lnga yi rang mdangs phyi snod nang bcud kyi dwangs ma bsdu ba'i dmigs pa dang sbrags steng 'og gi rlung kha sbyor du gzung /	33	dag ba ye shes lnga yi rang mdangs phyi snod nang bcud kyi dwangs ma sdud ba dmigs ba dang sbrag steng g gi rlung kha sbyor du gzung 
BO_TZ_PEMA-SANGTHIG-P15:332	mi thub pa na g.yas g.yon du gnan /	33	mi thub ba na g.yas g.yon du gnon 
BO_TZ_PEMA-SANGTHIG-P15:333	phyi nang du gzhil /	33	phyi nang du jil 
BO_TZ_PEMA-SANGTHIG-P15:334	cis kyang mi thub pa na mda' ltar 'phen pa ste yan lag bzhi ldan gyi bum can rab 'bring tha ma'i 'byongs tshhad ma byung bar 'di kho na la bslab /	33	cis kyang mi thub ba na mda ltar phen ba ste yan lag bzhi ldan gyi bum can rab bring tha ma byong tshhad ma byung ba di kho na la bslab 
BO_TZ_PEMA-SANGTHIG-P15:335	de la goms pas ro rkyang lam las bus pa'i rlung lte 'og tu me yi gong bu shes rab yum gyi ngo bo gsal btab ste de la ro rkyang gi rlung reg par byas ma thag tu me lce tal gyis 'bar ba yis /	33	de la goms ba ro rkyang lam las bud ba rlung lte g tu me yi gong bu shes rab yum gyi ngo bo gsal debs ste de la ro rkyang gi rlung reg ba byed ma thag tu me lce tal gyis bar ba yis 
BO_TZ_PEMA-SANGTHIG-P15:336	de las cher 'bar te rtsha gnas thams cad nyug nyug tu khyab par bsam la steng 'og gi rlung bsdam /	33	de las cher bar te rtsha gnas thams cad nyug nyug tu khyab ba bsam la steng g gi rlung sdom 
BO_TZ_PEMA-SANGTHIG-P15:337	gsus pa rgya mtshho ltar dgang ste bskyil zhing steng 'og gi sgo gnyis bsdams la bum pa can gyi rlung sbyor bya /	33	gsus ba rgya mtshho ltar geng ste skyil zhing steng g gi sgo gnyis sdom la bum ba can gyi rlung sbyor byed 
BO_TZ_PEMA-SANGTHIG-P15:338	'di skabs lte 'og 'phur brdab sogs drag tu bya /	33	di skabs lte g phur brdab sogs drag tu byed 
BO_TZ_PEMA-SANGTHIG-P15:339	dmigs rtshol ma byas kyang lte 'og tshha 'ur gyis byung ba na /	33	dmigs rtshol ma byed kyang lte g tshha ur gyis byung ba na 
BO_TZ_PEMA-SANGTHIG-P15:340	rim bzhin me lces lte ba snying kha gang bar bsam la sbar /	34	rim bzhin me lces lte ba snying kha gang ba bsam la sbor 
BO_TZ_PEMA-SANGTHIG-P15:341	gong ltar 'phur brdab sogs gang dmigs su bya /	34	gong ltar phur brdab sogs gang dmigs su byed 
BO_TZ_PEMA-SANGTHIG-P15:342	snga mar drod thob rim bzhin phyi ma la 'jug	34	snga mar drod thob rim bzhin phyi ma la jug 
BO_TZ_PEMA-SANGTHIG-P15:343	/de nas mgrin pa nas brtshams spyi bo'i bar du me sbar la gong bzhin bya /	34	nas mgrin ba nas brtshams spyi bo ba du me sbor la gong bzhin byed 
BO_TZ_PEMA-SANGTHIG-P15:344	rkang pa g.yas g.yon lag pa gnyis sogs me yis bkang ba phur shad brkyang ste drag tu brdab par byas la g.yas shad g.yon shad bya zhing pus mo brdab /	34	rkang ba g.yas g.yon lag ba gnyis sogs me yis geng ba phur shad rkyong ste drag tu brdab ba byed la g.yas shad g.yon shad byed zhing pus mo brdab 
BO_TZ_PEMA-SANGTHIG-P15:345	rdo rje skyil krung du thogs 'beb dang rkang gnyis brkyang ste 'beb bya /	34	rdo rje skyil krung du thogs beb dang rkang gnyis rkyong ste beb byed 
BO_TZ_PEMA-SANGTHIG-P15:346	rim bzhin nang lus phyi rol gnas khang dang mthar ni dpag tshhad tsham du me sbar dmigs pa bya zhing de yis bde ba'i ngo bo can gyi drod me ltar 'bar bar 'gyur ro //	34	rim bzhin nang lus phyi rol gnas khang dang mthar ni dpog tshhad tsham du me sbor dmigs ba byed zhing de yis bde ba ngo bo can gyi drod me ltar bar ba gyur ro 
BO_TZ_PEMA-SANGTHIG-P15:347	dbang po shin tu rgud pa'i gang zag yin na lte 'og gi phyogs bzhir me yi gong bu 'bar ba bzhi sgrom 'ur sgra dang bcas te 'bar bar bsam la drod kyi 'beb chen rnam bzhi bya'o //	34	dbang po shin tu rgud ba gang zag yin na lte g gi phyogs bzhir me yi gong bu bar ba bzhi sgrom ur sgra dang cha te bar ba bsam la drod kyi beb chen rnam bzhi byed 
BO_TZ_PEMA-SANGTHIG-P15:348	gnyis pa bde ba'i gtum mo la /	34	gnyis ba bde ba thum mo la 
BO_TZ_PEMA-SANGTHIG-P15:349	dmigs pa sngar ltar sogs nas /	34	dmigs ba sngar ltar sogs nas 
BO_TZ_PEMA-SANGTHIG-P15:350	rnam par rol :	35	rnam ba rol 
BO_TZ_PEMA-SANGTHIG-P15:351	dmigs pa rtsha 'dab sogs dang me dmigs sngar ltar la spyi bo yi bde chen 'khor lo'i dbus su thig le byang chub sems kyi rang bzhin dngos /	35	dmigs ba rtsha dab sogs dang me dmigs sngar ltar la spyi bo yi bde chen khor lo dbus su thig le byang chub sems kyi rang bzhin dngos 
BO_TZ_PEMA-SANGTHIG-P15:352	zla ba zhun ma lta bu'i mdog can gyi byang sems kyi thig le yi ge ham yig mgo thur du lta ba /	35	zla ba zhun ma lta bu mdog can gyi byang sems kyi thig le yi ge ham yig mgo thur du lta ba 
BO_TZ_PEMA-SANGTHIG-P15:353	mtha' skor du dga' ba bcu drug gi ngo bo thig le bcu drug zil pa khrom me skar ltar 'phro ba gsal btab la rlung sbyor gyis bskul ba'i lte 'og gi me 'bar ba'i me lce spyi bo'i ham la reg pas byang chub sems kyi rgyun babs /	35	mtha skor du dga ba chu drug gi ngo bo thig le chu drug zil ba khrom me skar ltar phro ba gsal debs la rlung sbyor gyis skul ba lte g gi me bar ba me lce spyi bo ham la reg ba byang chub sems kyi rgyun bab 
BO_TZ_PEMA-SANGTHIG-P15:354	'khor lo rnam pa bzhir me dang thig le 'bros 'ded kyi tshhul du bab par yang yang bsgoms /	35	khor lo rnam ba bzhir me dang thig le bros ded kyi tshhul du bab ba yang yang sgom 
BO_TZ_PEMA-SANGTHIG-P15:355	de la goms par bslab pas bde drod me ltar 'bar bar 'gyur zhing /	35	de la goms ba bslab ba bde drod me ltar bar ba gyur zhing 
BO_TZ_PEMA-SANGTHIG-P15:356	de yang thig le spyi bo nas mgrin par babs pas dga' ba /	35	de yang thig le spyi bo nas mgrin ba bab ba dga ba 
BO_TZ_PEMA-SANGTHIG-P15:357	snying khar babs pas mchog tu dga' ba /	35	snying khar bab ba mchog tu dga ba 
BO_TZ_PEMA-SANGTHIG-P15:358	lte bar babs pas khyad par dga' ba /	35	lte ba bab ba khyad ba dga ba 
BO_TZ_PEMA-SANGTHIG-P15:359	gsang gnas su babs pas lhan skyes kyi dga' ba ste mas brtan gyi dga' ba ngos gzung /	35	gsang gnas su bab ba lhan skye kyi dga ba ste mas brtan gyi dga ba ngos gzung 
BO_TZ_PEMA-SANGTHIG-P15:360	khru gang gi tshhad tsham gyi khri'u'i khar sogs thabs lam 'og sgo'i sngon 'gro lus sbyang yin la /	36	khru gang gi tshhad tsham gyi khriu khar sogs thabs lam g sgo sngon gro lus sbyong yin la 
BO_TZ_PEMA-SANGTHIG-P15:361	rgyal po sgyu ma'i longs spyod 'bebs pa thig le gsang gnas su 'dzin pa khron chu'am rdzing bur bskyil pa ltar bzung la bde stong gi rang mdangs bskyang la sems 'dzin /	36	rgyal po sgyu ma longs spyod bebs ba thig le gsang gnas su dzin ba khron chu rdzing bur skyil ba ltar bzung la bde stong gi rang mdangs skyong la sems dzin 
BO_TZ_PEMA-SANGTHIG-P15:362	de nas gsus pa sgal par sbyar la 'dren pa hu~m ring hu~m thung dang stag mo'i khong 'dren sogs 'dren tshhul dag gis gyen du drangs la yas bab kyi ye shes ngos gzung /	36	de nas gsus ba sgal ba sbyor la bgrang ba hu~m ring hu~m thung dang stag mo khong bgrang sogs bgrang tshhul dag gis gyen du drangs la yas bab kyi ye shes ngos gzung 
BO_TZ_PEMA-SANGTHIG-P15:363	bkram pa rgyu skar khyim du 'dzud pa ltar bya ste /	36	grem ba rgyu skar khyim du dzud ba ltar byed ste 
BO_TZ_PEMA-SANGTHIG-P15:364	'phar ba dang 'khrab pa dang seng+ge rnam par rol pa'i 'phrul 'khor la sogs pas thig le rtsha 'dab rnams su khyab par dgram mo //	36	phar ba dang khrab ba dang seng+ge rnam ba rol ba phrul khor la sogs ba thig le rtsha dab rnams su khyab ba grem mo 
BO_TZ_PEMA-SANGTHIG-P15:365	gsum pa 'bras bu mthar phyin pa'i tshhul le rjes bcas ni /	36	gsum ba bras bu mthar phyin ba tshhul le rjes cha ni 
BO_TZ_PEMA-SANGTHIG-P15:366	rtshe gcig bsgoms pas sogs nas /	36	rtshe gcig sgom ba sogs nas 
BO_TZ_PEMA-SANGTHIG-P15:367	gsum pa rdzogs so :	36	gsum ba rdzogs so 
BO_TZ_PEMA-SANGTHIG-P15:368	de ltar rtshe gcig tu bsgoms pas 'khor lo lnga'i rtsha mdud grol /	36	de ltar rtshe gcig tu sgom ba khor lo lnga rtsha mdud grol 
BO_TZ_PEMA-SANGTHIG-P15:369	sgo gsum shin tu sbyangs pa thob /	36	sgo gsum shin tu sbyong ba thob 
BO_TZ_PEMA-SANGTHIG-P15:370	dag pa'i rten 'brel mngon du 'gyur /	37	dag ba rten brel mngon du gyur 
BO_TZ_PEMA-SANGTHIG-P15:371	tshhe la dbang ba'i rig 'dzin 'grub /	37	tshhe la dbang ba rig dzin grub 
BO_TZ_PEMA-SANGTHIG-P15:372	gsang ba sngags kyi sbyor lam mthar phyin /	37	gsang ba sngags kyi sbyor lam mthar phyin 
BO_TZ_PEMA-SANGTHIG-P15:373	mthar thug longs spyod rdzogs sku thob pa'i rten 'brel 'grigs /	37	mthar thug longs spyod rdzogs sku thob ba rten brel grig 
BO_TZ_PEMA-SANGTHIG-P15:374	bcu drug lon pa'i na tshhod /	37	chu drug lon ba na tshhod 
BO_TZ_PEMA-SANGTHIG-P15:375	'dzer bag dig lkug med pa'i ngag	37	dzer bag dig lkugs med ba ngag 
BO_TZ_PEMA-SANGTHIG-P15:376	/gsal stong g.yo med kyi sems sogs 'grub /	37	stong g.yo med kyi sems sogs grub 
BO_TZ_PEMA-SANGTHIG-P15:377	shin tu rnam par dag cing spros pa med pa'i ye shes rgyud la 'char ba'i rten 'brel 'grigs par gyur cing /	37	shin tu rnam ba dag cing spros ba med ba ye shes brgyud la char ba rten brel grig ba gyur cing 
BO_TZ_PEMA-SANGTHIG-P15:378	'di dag kyang gsang ba byang chub sems kyi dbang thob pa las dam tshhig ma nyams pa dag gis yang dag dngos grub 'di dag thob pa 'byung bar 'gyur zhing /	37	di dag kyang gsang ba byang chub sems kyi dbang thob ba las dam tshhig ma nyams ba dag gis yang dag dngos grub di dag thob ba byung ba gyur zhing 
BO_TZ_PEMA-SANGTHIG-P15:379	'pho ba dang bcas pa'i rtsha rlung gi dri ma rang sar dag	37	pho ba dang cha ba rtsha rlung gi dri ma rang sar dag 
BO_TZ_PEMA-SANGTHIG-P15:380	/'od gsal ba'i ye shes rang bzhin gyis 'char bar 'gyur ba'i rmad du byung ba'i gsang ba'i lam mchog yang gsang mchog tu gyur pa'o //	38	gsal ba ye shes rang bzhin gyis char ba gyur ba rmad du byung ba gsang ba lam mchog yang gsang mchog tu gyur ba 
BO_TZ_PEMA-SANGTHIG-P15:381	//gsum pa sher dbang dang 'brel ba bde stong thugs rdo rje pho nya'i lam bshad pa la /	38	ba sher dbang dang brel ba bde stong thugs rdo rje pho nya lam chad ba la 
BO_TZ_PEMA-SANGTHIG-P15:382	go don spyir bshad pa dang / man ngag rgyas par bstan pa /	38	go don spyir chad ba dang man ngag rgya ba ston ba 
BO_TZ_PEMA-SANGTHIG-P15:383	mthar phyin 'bras bu'i tshhul dang gsum /	38	mthar phyin bras bu tshhul dang gsum 
BO_TZ_PEMA-SANGTHIG-P15:384	dang po ni /	38	dang po ni 
BO_TZ_PEMA-SANGTHIG-P15:385	slar yang zung 'jug sogs nas /	38	slar yang zung jug sogs nas 
BO_TZ_PEMA-SANGTHIG-P15:386	man ngag bstan :	38	man ngag ston 
BO_TZ_PEMA-SANGTHIG-P15:387	gong ltar gsang dbang gi lam bshad pa'i de ma thag slar yang yab yum snang stong zung 'jug bde ba chen por shin tu dgyes pa'i rdo rje'i na da'i dbyangs glu'i tshhul du blangs pa ni /	38	gong ltar gsang dbang gi lam chad ba de ma thag slar yang yab yum snang stong zung jug bde ba chen por shin tu dgyes ba rdo rje na da dbyangs glu tshhul du blangs ba ni 
BO_TZ_PEMA-SANGTHIG-P15:388	e ma ho :zhes pa rang rig gi ye shes la ngam zhing ngo mtshhar dang / e wam ma ya :gnyis chos zung du 'jug pa /	38	e ma ho :zhes ba rang rig gi ye shes la ngam zhing ngo mtshhar dang e wam ma ya :gnyis chos zung du jug ba 
BO_TZ_PEMA-SANGTHIG-P15:389	e sa ma ya zhes gsang ba chos kyi dbyings dang nam yang mi 'bral ba'i bde ba la sangs rgyas kun kyang rtag tu dgyes pa'i tshhul a la la la la ho :	38	e sa ma ya zhes gsang ba chos kyi dbyings dang nam yang mi bral ba bde ba la sangs rgya kun kyang rtag tu dgyes ba tshhul a la la la la ho 
BO_TZ_PEMA-SANGTHIG-P15:390	phyag rgya'i lam mkha' 'gro sgyu ma bde mchog sgyu ma'i tshhul ni /	39	phyag rgya lam mkha gro sgyu ma bde mchog sgyu ma tshhul ni 
BO_TZ_PEMA-SANGTHIG-P15:391	sangs rgyas kun gyis mnyam par sbyor zhing /	39	sangs rgya kun gyis mnyam ba sbyor zhing 
BO_TZ_PEMA-SANGTHIG-P15:392	lam 'di la ma brten par snang gsum 'pho ba'i bag chags cha phra ba sbyang dka' bas na rmad du byung ba'i thabs 'di e ma shin tu ngo mtshhar ya mtshhan che ba'i chos bde ba chen po gzhan lus pho nya'i man ngag bstan par bya'o zhes pas	39	lam di la ma rten ba snang gsum pho ba bag chags cha phra ba sbyong dka ba na rmad du byung ba thabs di e ma shin tu ngo mtshhar ya mtshhan che ba chos bde ba chen po gzhan lus pho nya man ngag ston ba byed zhes ba 
BO_TZ_PEMA-SANGTHIG-P15:393	bstan / gnyis pa man ngag rgyas par bstan pa la rang lus dang gzhan lus so //	39	ston gnyis ba man ngag rgya ba ston ba la rang lus dang gzhan lus so 
BO_TZ_PEMA-SANGTHIG-P15:394	dang po ni /	39	dang po ni 
BO_TZ_PEMA-SANGTHIG-P15:395	rtsha dang rlung lam sogs nas /	39	rtsha dang rlung lam sogs nas 
BO_TZ_PEMA-SANGTHIG-P15:396	brtan thob na :	39	brtan thob na 
BO_TZ_PEMA-SANGTHIG-P15:397	gsang dbang skabs bshad pa bzhin rtsha rlung gi rnal 'byor la legs par goms pas /	39	gsang dbang skabs chad ba bzhin rtsha rlung gi rnal byor la legs ba goms ba 
BO_TZ_PEMA-SANGTHIG-P15:398	yan lag yum lngar gsal ba dang snyoms par zhugs par mos pa sogs thabs lam kun dang mtshhungs /	39	yan lag yum lngar gsal ba dang snyom ba jug ba mos ba sogs thabs lam kun dang mtshhungs 
BO_TZ_PEMA-SANGTHIG-P15:399	'dren bkram ldog pa la dbang thob pas thig le 'pho med du gyur na /	39	bgrang grem ldog ba la dbang thob ba thig le pho med du gyur na 
BO_TZ_PEMA-SANGTHIG-P15:400	gnyis pa gzhan lus ni /	40	gnyis ba gzhan lus ni 
BO_TZ_PEMA-SANGTHIG-P15:401	lha mo klu mo sogs nas /	40	lha mo klu mo sogs nas 
BO_TZ_PEMA-SANGTHIG-P15:402	nges par 'grub :	40	nges ba grub 
BO_TZ_PEMA-SANGTHIG-P15:403	rigs can gsum gyi mu dra rgyud sbyangs dbang bskur /	40	rigs can gsum gyi mu dra brgyud sbyong dbang skur 
BO_TZ_PEMA-SANGTHIG-P15:404	'du shes gsum gyis snyoms par zhugs /	40	du shes gsum gyis snyom ba jug 
BO_TZ_PEMA-SANGTHIG-P15:405	mkhas pa bzhis dga' ba ngos gzung /	40	mkhas ba bzhis dga ba ngos gzung 
BO_TZ_PEMA-SANGTHIG-P15:406	yas babs kyi ye shes la mnyam par gzhag	40	yas bab kyi ye shes la mnyam ba jog 
BO_TZ_PEMA-SANGTHIG-P15:407	/slar dud 'gro'i 'gyur bzhis ldog pa spyi bor son pa'i mas brtan gyi ye shes mngon du byas la yang mnyam par gzhag	40	dud gro gyur bzhis ldog ba spyi bor son ba mas brtan gyi ye shes mngon du byed la yang mnyam ba jog 
BO_TZ_PEMA-SANGTHIG-P15:408	/yang na yum mkha' nas srid zhi'i dwangs bcud drangs tshhul thun min tshhe sgrub shin tu sbyangs pa'i gang zag gis bya /	40	na yum mkha nas srid zhi dwangs bcud drangs tshhul thun min tshhe sgrub shin tu sbyong ba gang zag gis byed 
BO_TZ_PEMA-SANGTHIG-P15:409	gsum pa mthar phyin 'bras bu'i tshhul le rjes bcas ni /	40	gsum ba mthar phyin bras bu tshhul le rjes cha ni 
BO_TZ_PEMA-SANGTHIG-P15:410	mchog mtha' dga' bral sogs nas /	41	mchog mtha dga bral sogs nas 
BO_TZ_PEMA-SANGTHIG-P15:411	bzhi pa rdzogs so :	41	bzhi ba rdzogs so 
BO_TZ_PEMA-SANGTHIG-P15:412	de ltar bsgoms pas bde ba chen po mchog tu mi 'gyur ba dga' bral gyi ye shes de nyid kyis mtshhon /	41	de ltar sgom ba bde ba chen po mchog tu mi gyur ba dga bral gyi ye shes de nyid kyis mtshhon 
BO_TZ_PEMA-SANGTHIG-P15:413	bde stong gnyis med kyi rang bzhin la rtag tu brtshon pas rtsha rlung thig le'i dri ma cha phra ba thams cad dag nas phyag chen rig 'dzin grub /	41	bde stong gnyis med kyi rang bzhin la rtag tu brtshon ba rtsha rlung thig le dri ma cha phra ba thams cad dag nas phyag chen rig dzin grub 
BO_TZ_PEMA-SANGTHIG-P15:414	gsang ba sngags kyi sbyor lam mthar phyin /	41	gsang ba sngags kyi sbyor lam mthar phyin 
BO_TZ_PEMA-SANGTHIG-P15:415	chos sku thob par 'gyur bas na lam 'di ni sangs rgyas kun gyi thugs kyi brnag pa kho na'o //	41	chos sku thob ba gyur ba na lam di ni sangs rgya kun gyi thugs kyi brnag ba kho na 
BO_TZ_PEMA-SANGTHIG-P15:416	//bzhi pa tshhig dbang dang 'brel ba ka dag ye shes rdo rje'i rnal 'byor gyi rim pa la /	41	ba tshhig dbang dang brel ba ka dag ye shes rdo rje rnal byor gyi rim ba la 
BO_TZ_PEMA-SANGTHIG-P15:417	spyir bshad pa /	41	spyir chad ba 
BO_TZ_PEMA-SANGTHIG-P15:418	man ngag rgyas par bshad pa /	41	man ngag rgya ba chad ba 
BO_TZ_PEMA-SANGTHIG-P15:419	mthar phyin 'bras bu'i tshhul gsum las /	41	mthar phyin bras bu tshhul gsum las 
BO_TZ_PEMA-SANGTHIG-P15:420	dang po ni /	42	dang po ni 
BO_TZ_PEMA-SANGTHIG-P15:421	slar yang 'khor 'das sogs nas /	42	slar yang khor da sogs nas 
BO_TZ_PEMA-SANGTHIG-P15:422	snang ba'i phyir :	42	snang ba phyir 
BO_TZ_PEMA-SANGTHIG-P15:423	gong du sher dbang gi lam bshad pa'i de ma thag	42	gong du sher dbang gi lam chad ba de ma thag 
BO_TZ_PEMA-SANGTHIG-P15:424	/slar yang gtsho mchog pad+ma tshhe dpag med yab yum gnyis su med pa'i bde stong gi ye shes mthar phyin pas /	42	yang gtsho mchog pad+ma tshhe dpog med yab yum gnyis su med ba bde stong gi ye shes mthar phyin ba 
BO_TZ_PEMA-SANGTHIG-P15:425	'khor 'das gnyis su btags pa'i chos thams cad rang ngor ka nas dag pa'i dbyings las brjod pa med pa'i rdo rje gsang ba'i sgra rang shar ba'i tshhul gyis bstan cing skal ldan dbang rnon gyi ngor mngon par snang ba /	42	khor da gnyis su dogs ba chos thams cad rang ngor ka nas dag ba dbyings las rjod ba med ba rdo rje gsang ba sgra rang char ba tshhul gyis ston cing skal ldan dbang rnon gyi ngor mngon ba snang ba 
BO_TZ_PEMA-SANGTHIG-P15:426	ho :zhes rang byung gi ye shes sangs rgyas kho na'i spyod yul la shin tu dgyes pa'i glu sngon du 'gro bas /	42	ho :zhes rang byung gi ye shes sangs rgya kho na spyod yul la shin tu dgyes ba glu sngon du gro ba 
BO_TZ_PEMA-SANGTHIG-P15:427	'khor 'das kyi spros pa thams cad ma dag glo bur ba'i dri ma ste 'khrul med sangs rgyas kyi gzigs ngor 'khor ba zhes ye nas grub pa med cing ka nas dag pa'i bdag nyid can te /	42	khor da kyi spros ba thams cad ma dag glo bur ba dri ma ste khrul med sangs rgya kyi gzigs ngor khor ba zhes ye nas grub ba med cing ka nas dag ba bdag nyid can te 
BO_TZ_PEMA-SANGTHIG-P15:428	de nyid rig pa dang ma rig pa'i dbye ba las /	42	de nyid rig ba dang ma rig ba byed ba las 
BO_TZ_PEMA-SANGTHIG-P15:429	sems can kun la rtag tu khyab par gnas pas rang rig pa bzhi cha gsum bral gyi gnyug ma'i shes pa ste /	42	sems can kun la rtag tu khyab ba gnas ba rang rig ba bzhi cha gsum bral gyi gnyug ma shes ba ste 
BO_TZ_PEMA-SANGTHIG-P15:430	de nyid mngon du byed pa'am mngon par snang ba'i thabs zab mo /	43	de nyid mngon du byed ba mngon ba snang ba thabs zab mo 
BO_TZ_PEMA-SANGTHIG-P15:431	gzhan nas sgrub tu med cing yod 'ong ma mchis pa ste 'gro 'ong dang bral la /	43	gzhan nas sgrub tu med cing yod ng ma mchis ba ste gro ng dang bral la 
BO_TZ_PEMA-SANGTHIG-P15:432	rang gi rang rig pa 'od gsal ba'i bdag nyid can 'di nyid /	43	rang gi rang rig ba d gsal ba bdag nyid can di nyid 
BO_TZ_PEMA-SANGTHIG-P15:433	nye drags pas yid ma ches /	43	nye drag ba yid ma ches 
BO_TZ_PEMA-SANGTHIG-P15:434	zab drags pas blor ma shong bas rang bzhin ye nas gsang ba'i don dbul po'i khyim gyi gter lta bu 'di ni rang la mngon sum par snang ba'i phyir gang bshad bya'i don no //	43	zab drag ba blor ma shong ba rang bzhin ye nas gsang ba don bul po khyim gyi gter lta bu di ni rang la mngon sum ba snang ba phyir gang chad byed don no 
BO_TZ_PEMA-SANGTHIG-P15:435	gnyis pa rgyas par bshad pa la /	43	gnyis ba rgya ba chad ba la 
BO_TZ_PEMA-SANGTHIG-P15:436	bsten bya slob dpon dang / des bstan pa'i chos gnyis /	43	sten byed slob dpon dang des ston ba chos gnyis 
BO_TZ_PEMA-SANGTHIG-P15:437	dang po ni /	43	dang po ni 
BO_TZ_PEMA-SANGTHIG-P15:438	man ngag ldan pa'i sogs nas /	43	man ngag ldan ba sogs nas 
BO_TZ_PEMA-SANGTHIG-P15:439	gtan la dbab :	43	gtan la bebs 
BO_TZ_PEMA-SANGTHIG-P15:440	rdzogs pa chen po'i man ngag gi don 'di legs par nyams su blangs shing gdul bya rjes 'dzin nus pa'i thugs rje dang ldan pa'i slob dpon mnyes pa gsum gyis tshhul bzhin bsten te /	44	rdzogs ba chen po man ngag gi don di legs ba nyams su blangs shing gdul byed rjes dzin nus ba thugs rje dang ldan ba slob dpon mnyes ba gsum gyis tshhul bzhin sten te 
BO_TZ_PEMA-SANGTHIG-P15:441	rim pa ltar gong ma la myong ba thon rim bzhin 'og ma lag khrid kyi tshhul du gtan la dbab ste bshad par bya'o //	44	rim ba ltar gong ma la myong ba thon rim bzhin g ma lag khrid kyi tshhul du gtan la bebs ste chad ba byed 
BO_TZ_PEMA-SANGTHIG-P15:442	gnyis pa des bstan pa'i chos la sngon 'gro dngos gzhi rjes so //	44	gnyis ba des ston ba chos la sngon gro dngos gzhi rjes so 
BO_TZ_PEMA-SANGTHIG-P15:443	dang po ni /	44	dang po ni 
BO_TZ_PEMA-SANGTHIG-P15:444	lus sbyang rdo rje'i sogs nas /	44	lus sbyong rdo rje sogs nas 
BO_TZ_PEMA-SANGTHIG-P15:445	shin sbyangs 'grub :	44	shin sbyong grub 
BO_TZ_PEMA-SANGTHIG-P15:446	thun gyi sngon 'gro bla ma la gsol ba drag tu gdab cing nyams rtogs mthar phyin pa'i ched du gdung shugs kyis 'bod pas rang la thim par bsam ste mnyam par gzhag	44	thun gyi sngon gro bla ma la gsol ba drag tu gdab cing nyams rtogs mthar phyin ba ched du gdung shugs kyis bod ba rang la thim ba bsam ste mnyam ba jog 
BO_TZ_PEMA-SANGTHIG-P15:447	/dben par stan 'bol zhing yangs la rgya che ba'i khar lus gcer bur ang rag tsham gyon la rdo rje'i 'dug stangs bya /	44	ba stan bol zhing yangs la rgya che ba khar lus bcer bur ang rag tsham gyon la rdo rje dug stangs byed 
BO_TZ_PEMA-SANGTHIG-P15:448	dmigs pa rang lus rdo rje sngon po rtshe gsum pa me 'bar bar bsam la mi nus pa na gang dgar 'gyel du bcug	44	dmigs ba rang lus rdo rje sngon po rtshe gsum ba me bar ba bsam la mi nus ba na gang dgar gyel du jug 
BO_TZ_PEMA-SANGTHIG-P15:449	/ci yang mi dmigs pa'i ngang du cung zad 'dug	44	yang mi dmigs ba ngang du cung zad dug 
BO_TZ_PEMA-SANGTHIG-P15:450	/yang gong bzhin sgom pa bcas zhag gsum tsham 'bad /	45	gong bzhin sgom ba cha zhag gsum tsham bad 
BO_TZ_PEMA-SANGTHIG-P15:451	yang rang tha mal du gnas pa'i snying gar hu~m mthing ga tshhad dang ldan pa khru gang ba zhig bsgom /	45	yang rang tha mal du gnas ba snying gar hu~m mthing ga tshhad dang ldan ba khru gang ba jig bsgom 
BO_TZ_PEMA-SANGTHIG-P15:452	de las hu~m me yi rang bzhin dpag tu med pa byung /	45	de las hu~m me yi rang bzhin dpog tu med ba byung 
BO_TZ_PEMA-SANGTHIG-P15:453	rang lus gang bas gdos bcas sha khrag gi tshhogs bag chags dang bcas pa thams cad rtshwa sbur me yis 'tshhig pa ltar dngos med du sbyangs /	45	rang lus gang ba gdos cha sha khrag gi tshhogs bag chags dang cha ba thams cad rtshwa sbur me yis tshhig ba ltar dngos med du sbyong 
BO_TZ_PEMA-SANGTHIG-P15:454	de bzhin phyi rol sa rdo ri brag dngos 'dzin snang ba thams cad bsregs te /	45	de bzhin phyi rol sa rdo ri brag dngos dzin snang ba thams cad bsregs te 
BO_TZ_PEMA-SANGTHIG-P15:455	nam mkha' stong par rang sems hu~m yig tu gsal ba la sems gzung /	45	nam mkha stong ba rang sems hu~m yig tu gsal ba la sems gzung 
BO_TZ_PEMA-SANGTHIG-P15:456	yang hu~m las hu~m gi tshhogs dpag med 'phros te phyi snod nang lus khrol mar phug	45	yang hu~m las hu~m gi tshhogs dpog med phro te phyi snod nang lus khrol mar bugs 
BO_TZ_PEMA-SANGTHIG-P15:457	/yang de thams cad rang sems hu~m la thim /	45	de thams cad rang sems hu~m la thim 
BO_TZ_PEMA-SANGTHIG-P15:458	yang hu~m gis yul la 'ching 'grol bya ba dang lam du gzhug pa sogs bya /	45	yang hu~m gis yul la ching grol byed ba dang lam du jug ba sogs byed 
BO_TZ_PEMA-SANGTHIG-P15:459	'di dag thun re re bzhin bsgom /	45	di dag thun re re bzhin bsgom 
BO_TZ_PEMA-SANGTHIG-P15:460	yang dmyal ba yi dwags sogs ngan 'gro'i gnas su skyes par bsam la sdug bsngal bya byed spyod lam sems thog tu blang /	46	yang dmyal ba yi dwags sogs ngan gro gnas su skye ba bsam la sdug sngal byed byed spyod lam sems thogs tu blang 
BO_TZ_PEMA-SANGTHIG-P15:461	lus ngag tu bya /	46	lus ngag tu byed 
BO_TZ_PEMA-SANGTHIG-P15:462	sdug bsngal myong ba'i ngo bo la lta /	46	sdug sngal myong ba ngo bo la lta 
BO_TZ_PEMA-SANGTHIG-P15:463	yang lha mi sogs bde 'gror skyes par bsam la de dag gi bde sdug nyams su 'dres nges bya /	46	yang lha mi sogs bde gror skye ba bsam la de dag gi bde sdug nyams su dre nges byed 
BO_TZ_PEMA-SANGTHIG-P15:464	yang zhing khams su skyes te sangs rgyas mjal zhing chos nyan mchod pa phul lung bstan dbug dbyung ba sogs bsam /	46	yang zhing khams su skye te sangs rgya mjal zhing chos nyan mchod ba bul lung ston bugs byin ba sogs bsam 
BO_TZ_PEMA-SANGTHIG-P15:465	gzhan yang lha zhi ba khro bo'i cha lugs sngags kyi tshhogs dang bcas pa thams cad lus ngag sems su blang /	46	gzhan yang lha zhi ba khro bo cha lugs sngags kyi tshhogs dang cha ba thams cad lus ngag sems su blang 
BO_TZ_PEMA-SANGTHIG-P15:466	de dag thams cad nyams su myong mkhan sems su thag chod /	46	de dag thams cad nyams su myong mkhan sems su thag chod 
BO_TZ_PEMA-SANGTHIG-P15:467	lus ngag yid kyi mngon zhen chung ba na /	46	lus ngag yid kyi mngon zhen chung ba na 
BO_TZ_PEMA-SANGTHIG-P15:468	sems de la gzugs kha dog dngos por grub pa 'dug gam mi 'dug	46	sems de la gzugs kha dog dngos por grub ba dug gam mi dug 
BO_TZ_PEMA-SANGTHIG-P15:469	/dang po byung ba'i khungs /	46	po byung ba khungs 
BO_TZ_PEMA-SANGTHIG-P15:470	bar du gnas pa'i sa /	47	ba du gnas ba sa 
BO_TZ_PEMA-SANGTHIG-P15:471	tha mar 'gro ba'i yul sogs kho thag ma chod bar rtshad gcod de rtsha bral du nges pa ma rnyed bar du bsgoms pas lus ngag yid kyi shin sbyangs 'grub ste ting nge 'dzin khyad par can gyi gzhi 'ding bar 'gyur ro //	47	tha mar gro ba yul sogs kho thag ma chod ba rtshad gcod de rtsha bral du nges ba ma rnyed ba du sgom ba lus ngag yid kyi shin sbyong grub ste ting nge dzin khyad ba can gyi gzhi ding ba gyur ro 
BO_TZ_PEMA-SANGTHIG-P15:472	gnyis pa dngos gzhi la /	47	gnyis ba dngos gzhi la 
BO_TZ_PEMA-SANGTHIG-P15:473	shin tu spros med ka dag gi lam dang le rjes /	47	shin tu spros med ka dag gi lam dang le rjes 
BO_TZ_PEMA-SANGTHIG-P15:474	rab tu spros med lhun grub kyi rnal 'byor gnyis /	47	rab tu spros med lhun grub kyi rnal byor gnyis 
BO_TZ_PEMA-SANGTHIG-P15:475	dang po la dngos ni /	47	dang po la dngos ni 
BO_TZ_PEMA-SANGTHIG-P15:476	dngos gzhi rig rtshal sogs nas /	47	dngos gzhi rig rtshal sogs nas 
BO_TZ_PEMA-SANGTHIG-P15:477	lnga pa rdzogs so :	47	lnga ba rdzogs so 
BO_TZ_PEMA-SANGTHIG-P15:478	thugs rje ldan pa'i slob dpon las rig pa rtshal gyi dbang thob nas dbang gi skabs su ngo sprad pa'i bzhi cha gsum bral gyi ye shes /	47	thugs rje ldan ba slob dpon las rig ba rtshal gyi dbang thob nas dbang gi skabs su ngo sprod ba bzhi cha gsum bral gyi ye shes 
BO_TZ_PEMA-SANGTHIG-P15:479	smra brjod kyi yul las 'das pa /	47	smra rjod kyi yul las da ba 
BO_TZ_PEMA-SANGTHIG-P15:480	bya rtshol blo yi spyod yul du mi btub pa /	48	byed rtshol blo yi spyod yul du mi thub ba 
BO_TZ_PEMA-SANGTHIG-P15:481	stong gsal rig pa'i snying po can /	48	stong gsal rig ba snying po can 
BO_TZ_PEMA-SANGTHIG-P15:482	'khor 'das kyi chos kun gyi spro gzhi /	48	khor da kyi chos kun gyi spro gzhi 
BO_TZ_PEMA-SANGTHIG-P15:483	'dus ma byas pa gnyug ma gshis kyi ngang du spro bsdu bral bar bzhag pa ste /	48	du ma byed ba gnyug ma gshis kyi ngang du spro sdud bral ba jog ba ste 
BO_TZ_PEMA-SANGTHIG-P15:484	ngo bo'i gnas lugs de nyid rang gi rang bzhin ye nas rnam par grol ba ka nas dag pa'i dbyings kyi gnas lugs 'pho 'gyur dang bral ba rang grol rig pa'i gshis lugs las /	48	ngo bo gnas lugs de nyid rang gi rang bzhin ye nas rnam ba grol ba ka nas dag ba dbyings kyi gnas lugs pho gyur dang bral ba rang grol rig ba gshis lugs las 
BO_TZ_PEMA-SANGTHIG-P15:485	rnam par rtog pa 'phros kyang rang thog las mi g.yo bas rang sar phan gnod med par grol bas gnyen po'i rnam rtog gis bskyar mi dgos /	48	rnam ba rtogs ba phro kyang rang thogs las mi g.yo ba rang sar phan gnod med ba grol ba gnyen po rnam rtogs gis skyor mi dgos 
BO_TZ_PEMA-SANGTHIG-P15:486	rnam rtog snga phyi med par /	48	rnam rtogs snga phyi med ba 
BO_TZ_PEMA-SANGTHIG-P15:487	shar ba dang grol ba dus mnyam pa /	48	char ba dang grol ba dus mnyam ba 
BO_TZ_PEMA-SANGTHIG-P15:488	ngo bo'i gshis sam gnas lugs stong pa chen po las rang snang 'od gsal ba /	48	ngo bo gshis sam gnas lugs stong ba chen po las rang snang d gsal ba 
BO_TZ_PEMA-SANGTHIG-P15:489	de yi rtshal thugs rje'i rnam rol rgyun mi 'chad cing 'gag pa med pa /	48	de yi rtshal thugs rje rnam rol rgyun mi chad cing gag ba med ba 
BO_TZ_PEMA-SANGTHIG-P15:490	stong pa chos sku /	49	stong ba chos sku 
BO_TZ_PEMA-SANGTHIG-P15:491	gsal ba longs sku /	49	gsal ba longs sku 
BO_TZ_PEMA-SANGTHIG-P15:492	thugs rje sprul sku'i bdag nyid du thag bcad de bsgom par bya'o //	49	thugs rje sprul sku bdag nyid du thag gcod de bsgom ba byed 
BO_TZ_PEMA-SANGTHIG-P15:493	de ltar nyams su blangs pas 'khor 'das su grags pa'i chos thams cad ma dag 'khrul pa'i ngor brtags pa tsham las /	49	de ltar nyams su blangs ba khor da su grags ba chos thams cad ma dag khrul ba ngor rtog ba tsham las 
BO_TZ_PEMA-SANGTHIG-P15:494	don la rang rig so ma gnyug ma'i gshis kyi gnas lugs gcig pu'i ngang du rdzogs pa ste /	49	don la rang rig so ma gnyug ma gshis kyi gnas lugs gcig pu ngang du rdzogs ba ste 
BO_TZ_PEMA-SANGTHIG-P15:495	de ltar mnyam pa'i tshhul yang /	49	de ltar mnyam ba tshhul yang 
BO_TZ_PEMA-SANGTHIG-P15:496	tha mal gyi shes pa de nyid bzo bcos /	49	tha mal gyi shes ba de nyid bzo chos 
BO_TZ_PEMA-SANGTHIG-P15:497	spro bsdu / dgag sgrub /	49	spro sdud gog sgrub 
BO_TZ_PEMA-SANGTHIG-P15:498	spang blang / zhen 'dzin /	49	spong blang zhen dzin 
BO_TZ_PEMA-SANGTHIG-P15:499	nges gzung med par brjod bral gyi klong du mnyam par bzhag la /	49	nges gzung med ba rjod bral gyi klong du mnyam ba jog la 
BO_TZ_PEMA-SANGTHIG-P15:500	de yi tshhe bzang ngan gyi rnam par rtog pa ji lta bu zhig 'phros kyang rig pa'i rang ngo la mnyam par bzhag pas /	50	de yi tshhe bzang ngan gyi rnam ba rtogs ba ji lta bu jig phro kyang rig ba rang ngo la mnyam ba jog ba 
BO_TZ_PEMA-SANGTHIG-P15:501	phan gnod med pa khang stong du rkun ma phyin pa bzhin rang sar grol ba la bslab par bya'o //	50	phan gnod med ba khang stong du rkun ma phyin ba bzhin rang sar grol ba la bslab ba byed 
BO_TZ_PEMA-SANGTHIG-P15:502	gnyis pa bogs 'don 'bras bu la /	50	gnyis ba bogs don bras bu la 
BO_TZ_PEMA-SANGTHIG-P15:503	dpe phyi yi nam mkha' stong dwangs dang / nang rang sems dri med /	50	dpe phyi yi nam mkha stong dwangs dang nang rang sems dri med 
BO_TZ_PEMA-SANGTHIG-P15:504	dpe can gsang ba 'od gsal spros bral gyi dbyings gsum phrugs gcig tu bsres te sgom la mnyam par gzhag par bya'o //	50	dpe can gsang ba d gsal spros bral gyi dbyings gsum phrug gcig tu bsres te sgom la mnyam ba jog ba byed 
BO_TZ_PEMA-SANGTHIG-P15:505	nangs par tho rangs rlung rig dwangs pa'i skabs rlung sems rang babs su gzhag	50	nangs ba tho rangs rlung rig dwangs ba skabs rlung sems rang bab su jog 
BO_TZ_PEMA-SANGTHIG-P15:506	/rig pa rjen pa'i ngang nyid las ma g.yos bzhin du /	50	ba rjen ba ngang nyid las ma g.yos bzhin du 
BO_TZ_PEMA-SANGTHIG-P15:507	skye med a yig mthing ga nam mkhar bsgoms pa la rig pa gtad de ha zhes rlung phyir bus la ci la yang mi 'dzin par rig pa ha re spro bsdu med par gzhag go	50	skye med a yig mthing ga nam mkhar sgom ba la rig ba gtod de ha zhes rlung phyir bud la ci la yang mi dzin ba rig ba ha re spro sdud med ba jog go 
BO_TZ_PEMA-SANGTHIG-P15:508	/mdor bsdu na /	50	sdud na 
BO_TZ_PEMA-SANGTHIG-P15:509	rig pa 'di stong dang mi stong sogs der 'dzin yod na lta ba rnam dag ma yin pas /	50	rig ba di stong dang mi stong sogs der dzin yod na lta ba rnam dag ma yin ba 
BO_TZ_PEMA-SANGTHIG-P15:510	'di yin gyi rtshis gdab med par rig pa had de ba la gsal rig gi snying po can de'i klong du yengs med du gnas par bya ba las /	51	di yin gyi rtshis gdab med ba rig ba had de ba la gsal rig gi snying po can de klong du yengs med du gnas ba byed ba las 
BO_TZ_PEMA-SANGTHIG-P15:511	bcos shing bslad pas 'khor bar 'ching bas ma bcos pa bdun dang ldan pa'i ngo bor rtag tu gnas par bya'o //	51	chos shing bslad ba khor ba ching ba ma chos ba bdun dang ldan ba ngo bor rtag tu gnas ba byed 
BO_TZ_PEMA-SANGTHIG-P15:512	e ma zhes ngo mtshhar ba /	51	e ma zhes ngo mtshhar ba 
BO_TZ_PEMA-SANGTHIG-P15:513	sangs rgyas thams cad kyi dgongs pa'i mthil snying phyung ste lag mthil du legs par bkram pa'i man ngag 'di /	51	sangs rgya thams cad kyi dgongs ba mthil snying byin ste lag mthil du legs ba grem ba man ngag di 
BO_TZ_PEMA-SANGTHIG-P15:514	sangs rgyas nyid kyis dgongs pa'i rang bzhin ji lta ba nyid gsal bar yang dag par bstan pa 'o ste yin no //	51	sangs rgya nyid kyis dgongs ba rang bzhin ji lta ba nyid gsal ba yang dag ba ston ba mang ste yin no 
BO_TZ_PEMA-SANGTHIG-P15:515	des shin tu spros med kyi lam bshad pa song nas /	51	des shin tu spros med kyi lam chad ba gro nas 
BO_TZ_PEMA-SANGTHIG-P15:516	gnyis pa rab tu spros med lhun grub kyi rnal 'byor bshad pa la /	51	gnyis ba rab tu spros med lhun grub kyi rnal byor chad ba la 
BO_TZ_PEMA-SANGTHIG-P15:517	mdor bstan / rgyas bshad /	51	mdor ston rgya chad 
BO_TZ_PEMA-SANGTHIG-P15:518	mthar phyin 'bras bu'o //	51	mthar phyin bras bu 
BO_TZ_PEMA-SANGTHIG-P15:519	dang po ni /	51	dang po ni 
BO_TZ_PEMA-SANGTHIG-P15:520	slar yang 'od gsal sogs nas /	52	slar yang d gsal sogs nas 
BO_TZ_PEMA-SANGTHIG-P15:521	khyad 'phags pa :	52	khyad phag ba 
BO_TZ_PEMA-SANGTHIG-P15:522	e ma ho :zhes rmad du byung ba'i rdo rje'i gnas la ngo mtshhar ba'i glu sngon du 'gro bas /	52	e ma ho :zhes rmad du byung ba rdo rje gnas la ngo mtshhar ba glu sngon du gro ba 
BO_TZ_PEMA-SANGTHIG-P15:523	ka dag 'dus ma byas pa'i dbyings spros pa dang bral ba'i lta ba khyad par 'phags pa gong du bshad pa de nyid la drod thob pas /	52	ka dag du ma byed ba dbyings spros ba dang bral ba lta ba khyad ba phag ba gong du chad ba de nyid la drod thob ba 
BO_TZ_PEMA-SANGTHIG-P15:524	lhun grub kyi ye shes nyi ma ltar shar zhing thugs rje 'gag pa med pa snang ba bzhi'i 'od zer 'phro bas /	52	lhun grub kyi ye shes nyi ma ltar char zhing thugs rje gag ba med ba snang ba bzhi d zer phro ba 
BO_TZ_PEMA-SANGTHIG-P15:525	'pho bcas kyi rtsha rlung thig le'i khams 'pho med gzhon nu bum pa sku'i dbyings su 'ubs chub pa'i myur lam /	52	pho cha kyi rtsha rlung thig le khams pho med gzhon nu bum ba sku dbyings su ubs chub ba myur lam 
BO_TZ_PEMA-SANGTHIG-P15:526	brtshon 'grus can lo zla tsham gyis mchog gi dngos grub la sbyor bas zab cing rmad du byung ba /	52	brtshon grus can lo zla tsham gyis mchog gi dngos grub la sbyor ba zab cing rmad du byung ba 
BO_TZ_PEMA-SANGTHIG-P15:527	theg pa 'og ma gzhan la ma grags shing theg pa'i rtshe mo 'od gsal rdo rje snying po yi lam /	52	theg ba g ma gzhan la ma grags shing theg ba rtshe mo d gsal rdo rje snying po yi lam 
BO_TZ_PEMA-SANGTHIG-P15:528	kun tu bzang po'i dgongs pa'i ti ka khyad par 'phags pa ni bshad par bya ba'i chos yin no //	52	kun tu bzang po dgongs ba ti ka khyad ba phag ba ni chad ba byed ba chos yin no 
BO_TZ_PEMA-SANGTHIG-P15:529	gnyis pa rgyas par bshad pa la /	52	gnyis ba rgya ba chad ba la 
BO_TZ_PEMA-SANGTHIG-P15:530	nyams blang thog mar sogs nas /	53	nyams blang thogs mar sogs nas 
BO_TZ_PEMA-SANGTHIG-P15:531	mngon du bya :	53	mngon du byed 
BO_TZ_PEMA-SANGTHIG-P15:532	de lta bu'i lam nyams su blang ba la /	53	de lta bu lam nyams su blang ba la 
BO_TZ_PEMA-SANGTHIG-P15:533	thog mar lus ngag yid gsum gyis dge mi dge'i bya byed spyod lam g.yeng ba sogs phyi nang bya ba dgu phrugs thams cad spangs te btang la lam 'di kho na nyams su len par bya'o //	53	thogs mar lus ngag yid gsum gyis dge mi dge byed byed spyod lam g.yeng ba sogs phyi nang byed ba dgu phrug thams cad spong te gtong la lam di kho na nyams su len ba byed 
BO_TZ_PEMA-SANGTHIG-P15:534	de yang lus gnad sku gsum gyi bzhugs stangs seng+ge glang chen drang srong gsum dang mi 'bral ba bya /	53	de yang lus gnad sku gsum gyi bzhugs stangs seng+ge glang chen dren srong gsum dang mi bral ba byed 
BO_TZ_PEMA-SANGTHIG-P15:535	rlung gnad 'gro 'ong dal bar sna nas mi gtang bar mchu so ma reg tsham gyis kha nas cung phyir 'dzin ring tsham bya ba la bslab /	53	rlung gnad gro ng dal ba sna nas mi gtong ba mchu so ma reg tsham gyis kha nas cung phyir dzin ring tsham byed ba la bslab 
BO_TZ_PEMA-SANGTHIG-P15:536	yul gnad nam mkhar zer gnyis dang sbrags pa'am chos longs sprul sku'i rten nyi zla mar me sogs la brten /	53	yul gnad nam mkhar zer gnyis dang sbrag ba chos longs sprul sku rten nyi zla mar me sogs la rten 
BO_TZ_PEMA-SANGTHIG-P15:537	sgo gnad mig phyed btshum zim bus bzhugs stangs gsum dang sbrags la ldog phab bam gyen thur g.yas g.yon zur gyis blta /	53	sgo gnad mig phyed btshum zim bud bzhugs stangs gsum dang sbrag la ldog bebs bam gyen thur g.yas g.yon zur gyis lta 
BO_TZ_PEMA-SANGTHIG-P15:538	sems gnad snang ba la zhen pa dang 'dzin pa'i spu ris bral bas rig pa dbyings snang la thim 'gro ba lta bur gtad /	53	sems gnad snang ba la zhen ba dang dzin ba spu ris bral ba rig ba dbyings snang la thim gro ba lta bur gtod 
BO_TZ_PEMA-SANGTHIG-P15:539	de yang rang gi snying tshit+ta sha yi sgron me'i dbus su snying nas mig tu 'brel ba'i rtsha dkar 'jam shel gyi sbu gu can /	53	de yang rang gi snying tshit+ta sha yi sgron me dbus su snying nas mig tu brel ba rtsha dkar jam shel gyi sbu gu can 
BO_TZ_PEMA-SANGTHIG-P15:540	rgyang zhags chu yi sgron ma mig dang 'brel bas /	54	rgyang zhags chu yi sgron ma mig dang brel ba 
BO_TZ_PEMA-SANGTHIG-P15:541	skyon bral zer gyis go phyes te /	54	skyon bral zer gyis go phyes te 
BO_TZ_PEMA-SANGTHIG-P15:542	dbyings rnam dag gi sgron ma za 'og kha phyes pa lta bu'i klong du /	54	dbyings rnam dag gi sgron ma za g kha phyes ba lta bu klong du 
BO_TZ_PEMA-SANGTHIG-P15:543	thig le stong pa'i sgron ma rdzing bur rdo bor ba lta bu mu khyud can gyi dbyings rum nas /	54	thig le stong ba sgron ma rdzing bur rdo bor ba lta bu mu khyud can gyi dbyings rum nas 
BO_TZ_PEMA-SANGTHIG-P15:544	rig pa rdo rje lu gu rgyud gser gyi skud pa lta bu bdag po'i sems shes rab rang byung gi sgron ma'i rjes su 'gro ba sgyu ma lta bu'i rol gar mkhan /	54	rig ba rdo rje lu gu brgyud gser gyi skud ba lta bu bdag po sems shes rab rang byung gi sgron ma rjes su gro ba sgyu ma lta bu rol gar mkhan 
BO_TZ_PEMA-SANGTHIG-P15:545	mngon sum tshak+shu ste mig lam du snang ba la /	54	mngon sum tshak+shu ste mig lam du snang ba la 
BO_TZ_PEMA-SANGTHIG-P15:546	'dzin pa bral bar rtshe gcig tu nyams su blang ste goms par byas pas /	54	dzin ba bral ba rtshe gcig tu nyams su blang ste goms ba byed ba 
BO_TZ_PEMA-SANGTHIG-P15:547	dbyings snang re lde nas brtsham ste smin mtshhams dang bral zhing /	54	dbyings snang re lde nas brtsham ste smin mtshhams dang bral zhing 
BO_TZ_PEMA-SANGTHIG-P15:548	thig le 'od lnga tshhom bu'i tshhul du 'char ba dang / rig pa rim gyis dal bas dbyings rig snyoms par zhugs te rig pa sku ru smin pa las /	54	thig le d lnga tshhom bu tshhul du char ba dang rig ba rim gyis dal ba dbyings rig snyom ba jug te rig ba sku ru smin ba las 
BO_TZ_PEMA-SANGTHIG-P15:549	phyed sku dang sku yang dag gam yongs su rdzogs kyi bar /	54	phyed sku dang sku yang dag gam yongs su rdzogs kyi ba 
BO_TZ_PEMA-SANGTHIG-P15:550	de yang rigs gcig nas rigs lnga dang rigs brgya rigs bsam gyis mi khyab par snang zhing /	55	de yang rigs gcig nas rigs lnga dang rigs brgya rigs bsam gyis mi khyab ba snang zhing 
BO_TZ_PEMA-SANGTHIG-P15:551	mthar ni phyi nang gi snang ba thams cad kun sku dang zhing khams kyi rang bzhin du 'ong bar 'gyur ba 'di la the tshhom med do //	55	mthar ni phyi nang gi snang ba thams cad kun sku dang zhing khams kyi rang bzhin du ng ba gyur ba di la the tshhom med do 
BO_TZ_PEMA-SANGTHIG-P15:552	snang ba'i rim pa ji ltar 'phel kha che yang /	55	snang ba rim ba ji ltar phel kha che yang 
BO_TZ_PEMA-SANGTHIG-P15:553	byis pas lha khang blta ba ltar zhen 'dzin med par ngang du cham mer gzhag la /	55	byis ba lha khang lta ba ltar zhen dzin med ba ngang du cham mer jog la 
BO_TZ_PEMA-SANGTHIG-P15:554	phyi dbyings nam mkha'/	55	phyi dbyings nam 
BO_TZ_PEMA-SANGTHIG-P15:555	nang dbyings 'od dang 'od khyim /	55	nang dbyings d dang d khyim 
BO_TZ_PEMA-SANGTHIG-P15:556	gsang dbyings rig pa ka dag ste dbyings de gsum gcig tu bsre ba gnad dam pa yin no //	55	gsang dbyings rig ba ka dag ste dbyings de gsum gcig tu bsre ba gnad dam ba yin no 
BO_TZ_PEMA-SANGTHIG-P15:557	lus mi 'gul ba ri bo cog gzhag	55	lus mi gul ba ri bo cog jog 
BO_TZ_PEMA-SANGTHIG-P15:558	/mig mi 'gul ba rgya mtshho cog gzhag	55	mi gul ba rgya mtshho cog jog 
BO_TZ_PEMA-SANGTHIG-P15:559	/yid mi g.yo ba rig pa cog gzhag gi tshhul gyi lta ba zab mo'i mthu yis /	55	mi g.yo ba rig ba cog jog gi tshhul gyi lta ba zab mo mthu yis 
BO_TZ_PEMA-SANGTHIG-P15:560	lhun grub kyi ye shes mthar phyin mngon du 'gyur bar bya'o //	56	lhun grub kyi ye shes mthar phyin mngon du gyur ba byed 
BO_TZ_PEMA-SANGTHIG-P15:561	gsum pa mthar phyin 'bras bu le rjes bcas ni /	56	gsum ba mthar phyin bras bu le rjes cha ni 
BO_TZ_PEMA-SANGTHIG-P15:562	shin tu goms pas sogs nas /	56	shin tu goms ba sogs nas 
BO_TZ_PEMA-SANGTHIG-P15:563	drug pa rdzogs so :	56	drug ba rdzogs so 
BO_TZ_PEMA-SANGTHIG-P15:564	shin tu goms pas snang ba zad par bya dgos te /	56	shin tu goms ba snang ba zad ba byed dgos te 
BO_TZ_PEMA-SANGTHIG-P15:565	phyi nyams snang na ro bdun brtshegs rang bzhin 'char ba nas /	56	phyi nyams snang na ro bdun brtshegs rang bzhin char ba nas 
BO_TZ_PEMA-SANGTHIG-P15:566	chos nyid mngon sum lhag ger mthong ba'i skabs su dbyings snang 'od khyim /	56	chos nyid mngon sum lhag ger mthong ba skabs su dbyings snang d khyim 
BO_TZ_PEMA-SANGTHIG-P15:567	ye shes thig le sku lu gu rgyud du snang ste rig pa dbyings su tshhud nas thig le sum 'brel du 'char ba tshhun chos nyid mngon sum /	56	ye shes thig le sku lu gu brgyud du snang ste rig ba dbyings su tshhud nas thig le sum brel du char ba tshhun chos nyid mngon sum 
BO_TZ_PEMA-SANGTHIG-P15:568	dbyings rig smin mtshhams dang bral te dbyings dang thig le je che dang lug rgyud je gsal je brtan /	56	dbyings rig smin mtshhams dang bral te dbyings dang thig le je che dang lug brgyud je gsal je brtan 
BO_TZ_PEMA-SANGTHIG-P15:569	thig le'i nang du phyed sku'i sku rkyang 'gul 'phrig med par shar ba nyams kyi snang ba gong du 'phel ba /	56	thig le nang du phyed sku sku rkyang gul phrig med ba char ba nyams kyi snang ba gong du phel ba 
BO_TZ_PEMA-SANGTHIG-P15:570	thig le re re'i nang du rigs lnga'i zhing khams 'char zhing de dag rang dang 'brel ba sgom ma bsgom med par rang snang ba rig pa tshhad phebs chen po nyid de /	57	thig le re re nang du rigs lnga zhing khams char zhing de dag rang dang brel ba sgom ma bsgom med ba rang snang ba rig ba tshhad phebs chen po nyid de 
BO_TZ_PEMA-SANGTHIG-P15:571	phyi nyams snang na ro bdun brtshegs nas rim par zad cing /	57	phyi nyams snang na ro bdun brtshegs nas rim ba zad cing 
BO_TZ_PEMA-SANGTHIG-P15:572	nang sgyu lus kyi chos /	57	nang sgyu lus kyi chos 
BO_TZ_PEMA-SANGTHIG-P15:573	gsang ba rtog tshhogs thams cad zad pas chos nyid zad pa'i sa la skyol zhing /	57	gsang ba rtogs tshhogs thams cad zad ba chos nyid zad ba sa la skyol zhing 
BO_TZ_PEMA-SANGTHIG-P15:574	de tshhe sor mor rig pa gtad pas /	57	de tshhe sor mor rig ba gtod ba 
BO_TZ_PEMA-SANGTHIG-P15:575	'od gsal gyi snang ba slar gsal te /	57	d gsal gyi snang ba slar gsal te 
BO_TZ_PEMA-SANGTHIG-P15:576	'chi med 'od kyi sku ru 'grub par 'gyur la /	57	chi med d kyi sku ru grub ba gyur la 
BO_TZ_PEMA-SANGTHIG-P15:577	gzhan du'am mi 'dod na /	57	gzhan du mi dod na 
BO_TZ_PEMA-SANGTHIG-P15:578	sgra 'od zer dang bcas gdos bcas kyi phung po mi snang bar 'od kyi rang bzhin du grol nas zag pa med pa gzhon nu bum pa sku'i dbyings su mngon par 'tshhang rgya ba'i thabs rmad du byung ba'i lam /	57	sgra d zer dang cha gdos cha kyi phung po mi snang ba d kyi rang bzhin du grol nas zag ba med ba gzhon nu bum ba sku dbyings su mngon ba tshhang rgya ba thabs rmad du byung ba lam 
BO_TZ_PEMA-SANGTHIG-P15:579	sgron ma drug gi dbyings rum du rig pa'i skyes bu snyoms par zhubs pas rig gdangs dbyer med du nyams su blangs pas /	57	sgron ma drug gi dbyings rum du rig ba skye bu snyom ba zhubs ba rig gdang dbyer med du nyams su blangs ba 
BO_TZ_PEMA-SANGTHIG-P15:580	'khor 'das ro mnyam du rang sar grol ba'i thabs rmad du byung ba'i don gyi yang snying 'di ni rdo rje'i tshhig tu yang dag par gsang ba'i brda ru bstan pa yin no //	58	khor da ro mnyam du rang sar grol ba thabs rmad du byung ba don gyi yang snying di ni rdo rje tshhig tu yang dag ba gsang ba brda ru ston ba yin no 
BO_TZ_PEMA-SANGTHIG-P15:581	rab tu spros med 'od gsal gyi lam ste 'di dag la brten sgo gsum gyi bag chags phra ba sbyangs /	58	rab tu spros med d gsal gyi lam ste di dag la rten sgo gsum gyi bag chags phra ba sbyong 
BO_TZ_PEMA-SANGTHIG-P15:582	lhun grub rig 'dzin gyi go 'phang thob /	58	lhun grub rig dzin gyi go phen thob 
BO_TZ_PEMA-SANGTHIG-P15:583	ngo bo nyid kyi sku mngon du byed par 'gyur ro //	58	ngo bo nyid kyi sku mngon du byed ba gyur ro 
BO_TZ_PEMA-SANGTHIG-P15:584	//rtsha ba'i don bzhi pa 'khor la gdams shing bstan pa gtad pa ni /	58	ba don bzhi ba khor la doms shing ston ba gtod ba ni 
BO_TZ_PEMA-SANGTHIG-P15:585	zab gsang thugs kyi sogs nas /	58	zab gsang thugs kyi sogs nas 
BO_TZ_PEMA-SANGTHIG-P15:586	brda thim : dngos su rig pa 'dzin pa dang mkha' 'gro ma /	58	brda thim dngos su rig ba dzin ba dang mkha gro ma 
BO_TZ_PEMA-SANGTHIG-P15:587	rgyud nas gdul bya skal ldan gyi tshhogs la yang dag par gtad pa ni go sla'o //	58	brgyud nas gdul byed skal ldan gyi tshhogs la yang dag ba gtod ba ni go sla 
BO_TZ_PEMA-SANGTHIG-P15:588	sku gsung thugs kyi rgya gsum gyis snod ldan la spel /	58	sku gsung thugs kyi rgya gsum gyis snod ldan la spel 
BO_TZ_PEMA-SANGTHIG-P15:589	snod min la gsang bar gnyer du gtad pa'o //	58	snod min la gsang ba gnyer du gtod ba 
BO_TZ_PEMA-SANGTHIG-P15:590	bsdus 'grel 'di yang dge slong byams pa yar 'phel gyi ngor bris pa yin no //	59	sdud grel di yang dge slong byams ba yar phel gyi ngor bri ba yin no 
BO_TZ_PEMA-SANGTHIG-P15:591	srung ma mthu rtshal can gyis bka' 'di srungs shig	59	srung ma mthu rtshal can gyis bka di srungs shig 
BO_TZ_PEMA-SANGTHIG-P15:592	/sa ma ya rak+shan+tu ///	59	ma ya rak+shan+tu 
BO_TZ_PEMA-SANGTHIG-P15:593	/bsdus 'grel 'di bzhin gter chen mchog nas gzhan bskul ngor zhib gzigs dang gtan 'beb nyis bris sogs ma mdzad par gnang ba'i dpe rgyun 'dra zhing /	59	grel di bzhin gter chen mchog nas gzhan skul ngor zhib gzigs dang gtan beb nyis bri sogs ma mdzad ba gnang ba dpe rgyun dra zhing 
BO_TZ_PEMA-SANGTHIG-P15:594	bdud 'joms rin po che 'jigs bral ye shes rdo rjes zhu dag yig skyon bsal ba'i dpe dang yang bsdur kyang /	59	bdud joms rin po che jigs bral ye shes rdo rjes ju dag yig skyon bsal ba dpe dang yang sdur kyang 
BO_TZ_PEMA-SANGTHIG-P15:595	da dung sa bcad ma zin pa dang 'khrugs pa sogs mang bas /	59	da dung sa gcod ma zin ba dang khrugs ba sogs mang ba 
BO_TZ_PEMA-SANGTHIG-P15:596	rtsha rgyud rang dang zhib bsdur gyis rtsha ba'i tshhig mtshhams phyes nas dkyus su bkod pa sogs dag bcos mang tsham dpa' thal lta bus /	59	rtsha brgyud rang dang zhib sdur gyis rtsha ba tshhig mtshhams phyes nas dkyu su bkod ba sogs dag chos mang tsham dpa thal lta bud 
BO_TZ_PEMA-SANGTHIG-P15:597	phyin chad dpe rgyun rnam dag 'phel blos rin gter zhu dag tha ma pa pad bkod sgam sprul pas zhus pa /	59	phyin chad dpe rgyun rnam dag phel blos rin gter ju dag tha ma ba pad bkod sgam sprul ba zhus ba 
BO_TZ_PEMA-SANGTHIG-P15:598	nongs pa bzod par gsol zhing 'di phyi'i sgrib par ma gyur cig	59	nongs ba bzod ba gsol zhing di phyi sgrib ba ma gyur cig 
BO_TZ_PEMA-SANGTHIG-P15:599	/dge legs 'phel ///	59	legs phel 
