segmentnr	original	folio	stemmed
BO_TZ_DZOGCHEN-DESUM-P26:0	rdzogs pa chen po sde gsum las :	0	rdzogs ba chen po sde gsum las 
BO_TZ_DZOGCHEN-DESUM-P26:1	phyi skor bla ma'i sgrub dbang bzhugs :na mo gu ru :	0	phyi skor bla ma sgrub dbang bzhugs :na mo gu ru 
BO_TZ_DZOGCHEN-DESUM-P26:2	phyi skor bla ma sgrub pa'i dbang :	0	phyi skor bla ma sgrub ba dbang 
BO_TZ_DZOGCHEN-DESUM-P26:3	tshhul bzhin bskur na dkyil 'khor yang :	0	tshhul bzhin skur na dkyil khor yang 
BO_TZ_DZOGCHEN-DESUM-P26:4	rgyas bsdus rigs pas dpag la bsham :	0	rgya sdud rigs ba dpog la bsham 
BO_TZ_DZOGCHEN-DESUM-P26:5	slob ma rnams kyis 'di skad zhu :	0	slob ma rnams kyis di skad ju 
BO_TZ_DZOGCHEN-DESUM-P26:6	zung 'jug dgongs pa brnyes pa yi :	0	zung jug dgongs ba brnyes ba yi 
BO_TZ_DZOGCHEN-DESUM-P26:7	'gro 'dul sum cu rtsha gcig gi :	0	gro dul sum cu rtsha gcig gi 
BO_TZ_DZOGCHEN-DESUM-P26:8	byin rlabs brtshe bas gnang du gsol :	0	byin rlabs brtshe ba gnang du gsol 
BO_TZ_DZOGCHEN-DESUM-P26:9	bla mas : spyir ni 'gro 'dul lnga bcu rtsha brgyad po :	0	bla mas spyir ni gro dul lnga chu rtsha brgyad po 
BO_TZ_DZOGCHEN-DESUM-P26:10	thams cad zung 'jug mngon gyur kun tu bzang :	1	thams cad zung jug mngon gyur kun tu bzang 
BO_TZ_DZOGCHEN-DESUM-P26:11	dgongs pa rang byung nam mkha'i rnal 'byor tshhogs :	1	dgongs ba rang byung nam mkha rnal byor tshhogs 
BO_TZ_DZOGCHEN-DESUM-P26:12	ye shes sku can 'khor 'das yongs la khyab :	1	ye shes sku can khor da yongs la khyab 
BO_TZ_DZOGCHEN-DESUM-P26:13	bzhugs yul zhing khams gzhan du btshal mi 'tshhal :	1	bzhugs yul zhing khams gzhan du btshal mi tshhal 
BO_TZ_DZOGCHEN-DESUM-P26:14	da lta'i nam mkha' 'dir yang rnal 'byor rnams :	1	da lta nam mkha dir yang rnal byor rnams 
BO_TZ_DZOGCHEN-DESUM-P26:15	rang gi sems nyid 'di la'ang bla mas khyab :	1	rang gi sems nyid di la bla mas khyab 
BO_TZ_DZOGCHEN-DESUM-P26:16	bskur bya skur thabs bsgrub dang sgrub thabs med :	1	skur byed skur thabs sgrub dang sgrub thabs med 
BO_TZ_DZOGCHEN-DESUM-P26:17	rnal 'byor lta ba'i ngang la sgrub dbang rdzogs :	1	rnal byor lta ba ngang la sgrub dbang rdzogs 
BO_TZ_DZOGCHEN-DESUM-P26:18	e ma ho bde gshegs bla ma rnams :	1	e ma ho bde gshegs bla ma rnams 
BO_TZ_DZOGCHEN-DESUM-P26:19	bsam gyis mi khyab chos nyid klong :	1	bsam gyis mi khyab chos nyid klong 
BO_TZ_DZOGCHEN-DESUM-P26:20	kun tu bzang po'i rnal 'byor yin :	2	kun tu bzang po rnal byor yin 
BO_TZ_DZOGCHEN-DESUM-P26:21	lta ba'i rgyal po'i mchod pa 'bul :	2	lta ba rgyal po mchod ba bul 
BO_TZ_DZOGCHEN-DESUM-P26:22	slob ma rnams kyis man+dal tshhogs :	2	slob ma rnams kyis man+dal tshhogs 
BO_TZ_DZOGCHEN-DESUM-P26:23	ci 'byor bshams te lta bar gnas :	2	ci byor bshams te lta ba gnas 
BO_TZ_DZOGCHEN-DESUM-P26:24	gdod nas dag pa'i kun bzang bla ma la :	2	gdod nas dag ba kun bzang bla ma la 
BO_TZ_DZOGCHEN-DESUM-P26:25	mtshhan 'dzin 'khrul pa'i bskang bshags mi 'tshhal zhing :	2	mtshhan dzin khrul ba skong chags mi tshhal zhing 
BO_TZ_DZOGCHEN-DESUM-P26:26	gnyis su med pa'i phyag 'tshhal mos gus bral :	2	gnyis su med ba phyag tshhal mos gus bral 
BO_TZ_DZOGCHEN-DESUM-P26:27	de bas rang rig klong du phyag 'tshhal lo :	2	de ba rang rig klong du phyag tshhal lo 
BO_TZ_DZOGCHEN-DESUM-P26:28	gnyis su med pa'i mchod sprin rgya mtshhos mchod :	2	gnyis su med ba mchod sprin rgya mtshhos mchod 
BO_TZ_DZOGCHEN-DESUM-P26:29	bsam las 'das pa'i ngang du thugs dam bskang :	2	bsam las da ba ngang du thugs dam skong 
BO_TZ_DZOGCHEN-DESUM-P26:30	brjod med brjod pa thams cad mthol lo bshags :	3	rjod med rjod ba thams cad mthol lo chags 
BO_TZ_DZOGCHEN-DESUM-P26:31	e ma ho bde gshegs bla ma rnams :	3	e ma ho bde gshegs bla ma rnams 
BO_TZ_DZOGCHEN-DESUM-P26:32	kun bzang dgongs klong sems su rdzogs pa la :	3	kun bzang dgongs klong sems su rdzogs ba la 
BO_TZ_DZOGCHEN-DESUM-P26:33	phyi nang gnyis med spros pa'i mtha' las 'das :	3	phyi nang gnyis med spros ba mtha las da 
BO_TZ_DZOGCHEN-DESUM-P26:34	chos dbyings klong chub ngang du phyag 'tshhal lo :	3	chos dbyings klong chub ngang du phyag tshhal lo 
BO_TZ_DZOGCHEN-DESUM-P26:35	e ma ho rang rig bla ma rnams :	3	e ma ho rang rig bla ma rnams 
BO_TZ_DZOGCHEN-DESUM-P26:36	'khor 'das thams cad sa ler mthong ba la :	3	khor da thams cad sa ler mthong ba la 
BO_TZ_DZOGCHEN-DESUM-P26:37	gnyis su med pa'i dbyings su lhun rdzogs pas :	3	gnyis su med ba dbyings su lhun rdzogs ba 
BO_TZ_DZOGCHEN-DESUM-P26:38	mthong bya mthong mkhan med la phyag 'tshhal lo :	3	mthong byed mthong mkhan med la phyag tshhal lo 
BO_TZ_DZOGCHEN-DESUM-P26:39	e ma ho bde gshegs bla ma rnams :	3	e ma ho bde gshegs bla ma rnams 
BO_TZ_DZOGCHEN-DESUM-P26:40	phyi nang nam mkha' kun la sku ni yongs su khyab pa nyid :	4	phyi nang nam mkha kun la sku ni yongs su khyab ba nyid 
BO_TZ_DZOGCHEN-DESUM-P26:41	bzhugs pa'i yul ni phyogs bcu'i 'jig rten dag na mchis :	4	bzhugs ba yul ni phyogs chu jig rten dag na mchis 
BO_TZ_DZOGCHEN-DESUM-P26:42	glo bur dri ma'i rnam rtog bsal phyir gzugs skur bzhengs pa rnams :	4	glo bur dri ma rnam rtogs bsal phyir gzugs skur bzhengs ba rnams 
BO_TZ_DZOGCHEN-DESUM-P26:43	mtshhan 'dzin 'khrul pa 'di dag myur du bsal bar mdzad du gsol :	4	mtshhan dzin khrul ba di dag myur du bsal ba mdzad du gsol 
BO_TZ_DZOGCHEN-DESUM-P26:44	slob dpon gyis :	4	slob dpon gyis 
BO_TZ_DZOGCHEN-DESUM-P26:45	e ma ho :	4	e ma ho 
BO_TZ_DZOGCHEN-DESUM-P26:46	bde gshegs bla ma 'gro 'dul lnga bcu rtsha brgyad rnams :	4	bde gshegs bla ma gro dul lnga chu rtsha brgyad rnams 
BO_TZ_DZOGCHEN-DESUM-P26:47	dmigs med chos kyi sku las da lta bzhengs su gsol :	4	dmigs med chos kyi sku las da lta bzhengs su gsol 
BO_TZ_DZOGCHEN-DESUM-P26:48	phyi skor bla ma sum cu rtsha gcig snang bar mdzod :	4	phyi skor bla ma sum cu rtsha gcig snang ba mdzod 
BO_TZ_DZOGCHEN-DESUM-P26:49	ye shes sku yis slob mar byin rlabs dbang chen da lta bskur du gsol :	4	ye shes sku yis slob mar byin rlabs dbang chen da lta skur du gsol 
BO_TZ_DZOGCHEN-DESUM-P26:50	zhes dang : bla ma'i mngon rtogs sum cu rtsha gcig dpon slob gnyis kas bsgom :	5	zhes dang bla ma mngon rtogs sum cu rtsha gcig dpon slob gnyis kas bsgom 
BO_TZ_DZOGCHEN-DESUM-P26:51	bsam gtan gyi khang bur :	5	bsam gtan gyi khang bur 
BO_TZ_DZOGCHEN-DESUM-P26:52	ji ltar bsam yang sogs rdo rje'i glu blangs la shri sim ha'i sku spyi bor bzhag la bstim :	5	ji ltar bsam yang sogs rdo rje glu blangs la shri sim ha sku spyi bor jog la stim 
BO_TZ_DZOGCHEN-DESUM-P26:53	rdo rje'i bzlas pa bya zhing :	5	rdo rje bzlas ba byed zhing 
BO_TZ_DZOGCHEN-DESUM-P26:54	shri sim ha rang rig tu rdzogs pa'i ngang du mnyam par gzhag :	5	shri sim ha rang rig tu rdzogs ba ngang du mnyam ba jog 
BO_TZ_DZOGCHEN-DESUM-P26:55	de bzhin du skor gsum gyi bla ma rnams kyi byin rlabs rigs pas 'phrul lo :	5	de bzhin du skor gsum gyi bla ma rnams kyi byin rlabs rigs ba phrul lo 
BO_TZ_DZOGCHEN-DESUM-P26:56	phyi skor bla ma'i sgrub dbang rdzogs so :	5	phyi skor bla ma sgrub dbang rdzogs so 
BO_TZ_DZOGCHEN-DESUM-P26:57	sa ma ya rgya rgya :gter chen mchog gyur gling pas pad+ma shel phug nas spyan drangs pa'i shog ser las phab rim bzhin mkhyen brtshe'i dbang pos bris pa dge'o //	5	sa ma ya rgya rgya :gter chen mchog gyur gling ba pad+ma shel bugs nas spyan drangs ba shog ser las bebs rim bzhin mkhyen brtshe dbang pos bri ba dge 
BO_TZ_DZOGCHEN-DESUM-P26:58	// \u0f01\u0f83:	5	\u0f01\u0f83: 
BO_TZ_DZOGCHEN-DESUM-P26:59	dam chos rdzogs pa chen po sde gsum las :	5	dam chos rdzogs ba chen po sde gsum las 
BO_TZ_DZOGCHEN-DESUM-P26:60	shri sim ha'i rdo rje'i glu bzhugs so :	6	shri sim ha rdo rje glu bzhugs so 
BO_TZ_DZOGCHEN-DESUM-P26:61	shri sim ha'i rdo rje'i glu ni :	6	shri sim ha rdo rje glu ni 
BO_TZ_DZOGCHEN-DESUM-P26:62	ji ltar bsam yang mi rtog ngang :	6	ji ltar bsam yang mi rtogs ngang 
BO_TZ_DZOGCHEN-DESUM-P26:63	ji ltar smras kyang sgom pa med :	6	ji ltar smras kyang sgom ba med 
BO_TZ_DZOGCHEN-DESUM-P26:64	snang srid chos kun ye shes ngang :	6	snang srid chos kun ye shes ngang 
BO_TZ_DZOGCHEN-DESUM-P26:65	ye shes btshal du med pa 'di :	6	ye shes btshal du med ba di 
BO_TZ_DZOGCHEN-DESUM-P26:66	rang byung rang shar thal le ba :	6	rang byung rang char thal le ba 
BO_TZ_DZOGCHEN-DESUM-P26:67	nga ni deng phyin gzhi la gnas :	6	nga ni deng phyin gzhi la gnas 
BO_TZ_DZOGCHEN-DESUM-P26:68	gzhi ni ma bcos lhug par 'dug :	6	gzhi ni ma chos lhug ba dug 
BO_TZ_DZOGCHEN-DESUM-P26:69	mtshhan nyid kun ldan 'od gsal ba :	6	mtshhan nyid kun ldan d gsal ba 
BO_TZ_DZOGCHEN-DESUM-P26:70	cir yang ma yin cir yang rtogs :	7	cir yang ma yin cir yang rtogs 
BO_TZ_DZOGCHEN-DESUM-P26:71	lta ba mthar phyin shri sim:	7	lta ba mthar phyin shri sim: 
BO_TZ_DZOGCHEN-DESUM-P26:72	sgom pa'i blo dang bral 'dod nas :	7	sgom ba blo dang bral dod nas 
BO_TZ_DZOGCHEN-DESUM-P26:73	gsal ba 'di la lam byas pas :	7	gsal ba di la lam byed ba 
BO_TZ_DZOGCHEN-DESUM-P26:74	gtad so med pa'i nyams shig shar :	7	gtod so med ba nyams shig char 
BO_TZ_DZOGCHEN-DESUM-P26:75	rgyun chad med pa'i shri sim:	7	rgyun chad med ba shri sim: 
BO_TZ_DZOGCHEN-DESUM-P26:76	spyod pa spyad rgyu 'dug gam bltas :	7	spyod ba spyod rgyu dug gam lta 
BO_TZ_DZOGCHEN-DESUM-P26:77	ci byas thams cad bde ba che :	7	ci byed thams cad bde ba che 
BO_TZ_DZOGCHEN-DESUM-P26:78	gang byung thams cad dga' ba'i ngang :	7	gang byung thams cad dga ba ngang 
BO_TZ_DZOGCHEN-DESUM-P26:79	zung 'jug mngon gyur shri sim:	7	zung jug mngon gyur shri sim: 
BO_TZ_DZOGCHEN-DESUM-P26:80	'bras bu 'thob par bya ba'i phyir :	8	bras bu thob ba byed ba phyir 
BO_TZ_DZOGCHEN-DESUM-P26:81	gzhi yi steng du mnyam par bzhag :	8	gzhi yi steng du mnyam ba jog 
BO_TZ_DZOGCHEN-DESUM-P26:82	'jam dpal bshes gnyen gdams pa ste :	8	jam dpal bshes gnyen doms ba ste 
BO_TZ_DZOGCHEN-DESUM-P26:83	sems kyi klong nas gter du rnyed :	8	sems kyi klong nas gter du rnyed 
BO_TZ_DZOGCHEN-DESUM-P26:84	rnam shes yul dbang kun gzhi rnams :	8	rnam shes yul dbang kun gzhi rnams 
BO_TZ_DZOGCHEN-DESUM-P26:85	so sor dbyer med dmigs su med :	8	so sor dbyer med dmigs su med 
BO_TZ_DZOGCHEN-DESUM-P26:86	gang yang 'di zhes med pa yi :	8	gang yang di zhes med ba yi 
BO_TZ_DZOGCHEN-DESUM-P26:87	bde ba chen por a la la ho :	8	bde ba chen por a la la ho 
BO_TZ_DZOGCHEN-DESUM-P26:88	zhes bsam gtan gyi khang bur glu phyi ma blangs pa'o :	8	zhes bsam gtan gyi khang bur glu phyi ma blangs ba 
BO_TZ_DZOGCHEN-DESUM-P26:89	gter chen mchog gyur gling pas pad+ma shel phug nas spyan drangs pa'i shog ser las phab rim bzhin mkhyen brtshe'i dbang pos bris pa dge	8	gter chen mchog gyur gling ba pad+ma shel bugs nas spyan drangs ba shog ser las bebs rim bzhin mkhyen brtshe dbang pos bri ba dge 
BO_TZ_DZOGCHEN-DESUM-P26:90	/zhus so /// /	9	so 
