segmentnr	original	folio	stemmed
BO_TZ_DZOGCHEN-DESUM-P72:0	\u0f01\u0f83: dam chos rdzogs pa chen po sde gsum las :	0	\u0f01\u0f83: dam chos rdzogs ba chen po sde gsum las 
BO_TZ_DZOGCHEN-DESUM-P72:1	gsang skor yi dam khro bo'i dbang chog bzhugs so :	0	gsang skor yi dam khro bo dbang chog bzhugs so 
BO_TZ_DZOGCHEN-DESUM-P72:2	sde gsum gsang skor man ngag sde /	0	sde gsum gsang skor man ngag sde 
BO_TZ_DZOGCHEN-DESUM-P72:3	\u0f88\u0f88\u0f88 na mo gu ru :	0	\u0f88\u0f88\u0f88 na mo gu ru 
BO_TZ_DZOGCHEN-DESUM-P72:4	gsang skor yi dam khro bo'i dbang :	0	gsang skor yi dam khro bo dbang 
BO_TZ_DZOGCHEN-DESUM-P72:5	tshhul bzhin bskur bar bya ba la :	0	tshhul bzhin skur ba byed ba la 
BO_TZ_DZOGCHEN-DESUM-P72:6	phun sum tshhogs lnga 'dzom par bya :	0	phun sum tshhogs lnga dzom ba byed 
BO_TZ_DZOGCHEN-DESUM-P72:7	bde gshegs snying pos 'gro kun khyab :	0	bde gshegs snying pos gro kun khyab 
BO_TZ_DZOGCHEN-DESUM-P72:8	ru dra ma gtogs bskur bar rung :	0	ru dra ma gtogs skur ba rung 
BO_TZ_DZOGCHEN-DESUM-P72:9	dkyil 'khor 'khor lo dgu ldan bri :	0	dkyil khor khor lo dgu ldan bri 
BO_TZ_DZOGCHEN-DESUM-P72:10	phyi ru rgyas par sgo rdzogs gcig :	1	phyi ru rgya ba sgo rdzogs gcig 
BO_TZ_DZOGCHEN-DESUM-P72:11	bsdu na re kha lnga ldan bri :	1	sdud na re kha lnga ldan bri 
BO_TZ_DZOGCHEN-DESUM-P72:12	bum pa bcu 'am gcig kyang rung :	1	bum ba chu mang gcig kyang rung 
BO_TZ_DZOGCHEN-DESUM-P72:13	chas ldan sku gzugs rnams kyis brgyan :	1	cha ldan sku gzugs rnams kyis rgyan 
BO_TZ_DZOGCHEN-DESUM-P72:14	rigs lnga rdor dril cod pan bcas :	1	rigs lnga rdar dril cod pan cha 
BO_TZ_DZOGCHEN-DESUM-P72:15	sku dang sngags phreng phyag mtshhan bcas :	1	sku dang sngags phreng phyag mtshhan cha 
BO_TZ_DZOGCHEN-DESUM-P72:16	dam rdzas gsang thod rig ma dang : ngo sprod me long brda rdzas bsags :	1	dam rdzas gsang thod rig ma dang ngo sprod me long brda rdzas bsags 
BO_TZ_DZOGCHEN-DESUM-P72:17	bdag mdun dbyer med bsgrubs byas te :	1	bdag mdun dbyer med sgrub byed te 
BO_TZ_DZOGCHEN-DESUM-P72:18	slob ma khrus byas bgegs bskrad nas :	1	slob ma khru byed bgegs skrod nas 
BO_TZ_DZOGCHEN-DESUM-P72:19	yol ba'i phyi nas gsol ba gdab :	1	yol ba phyi nas gsol ba gdab 
BO_TZ_DZOGCHEN-DESUM-P72:20	ho : bde gshegs kun 'dus bla ma rje :	2	ho bde gshegs kun du bla ma rje 
BO_TZ_DZOGCHEN-DESUM-P72:21	srid pa'i 'khor lor 'khyams pa'i 'gro :	2	srid ba khor lor khyam ba gro 
BO_TZ_DZOGCHEN-DESUM-P72:22	ma lus bsgral bar mdzad pa dang : khyad par bdag cag sgrol bar gsol :	2	ma lus bsgral ba mdzad ba dang khyad ba bdag cag sgrol ba gsol 
BO_TZ_DZOGCHEN-DESUM-P72:23	slob dpon gyis :	2	slob dpon gyis 
BO_TZ_DZOGCHEN-DESUM-P72:24	e ma bde gshegs dkyil 'khor 'dir :	2	e ma bde gshegs dkyil khor dir 
BO_TZ_DZOGCHEN-DESUM-P72:25	tshhul bzhin 'jug pa'i snod ldan dkon :	2	tshhul bzhin jug ba snod ldan dkon(d) 
BO_TZ_DZOGCHEN-DESUM-P72:26	dam tshhig thub na 'jug kyang rung :	2	dam tshhig thub na jug kyang rung 
BO_TZ_DZOGCHEN-DESUM-P72:27	zhugs na mchog thun dngos grub 'grub :	2	jug na mchog thun dngos grub grub 
BO_TZ_DZOGCHEN-DESUM-P72:28	slob mas : srid pa'i 'khor lor rnam skrag ste :	2	slob mas srid ba khor lor rnam skrag ste 
BO_TZ_DZOGCHEN-DESUM-P72:29	'jigs pa che las thar ba'i phyir :	2	jigs ba che las thar ba phyir 
BO_TZ_DZOGCHEN-DESUM-P72:30	dam tshhig srog phyir mi gtang zhing :	3	dam tshhig srog phyir mi gtong zhing 
BO_TZ_DZOGCHEN-DESUM-P72:31	ji ltar bka' bstshal bdag gis bgyi :	3	ji ltar bka bstshal bdag gis bgyid 
BO_TZ_DZOGCHEN-DESUM-P72:32	slob dpon gyis :	3	slob dpon gyis 
BO_TZ_DZOGCHEN-DESUM-P72:33	de ltar yin na he ru ka'i :	3	de ltar yin na he ru ka 
BO_TZ_DZOGCHEN-DESUM-P72:34	grong khyer 'di ru 'jug par rung :	3	grong khyer di ru jug ba rung 
BO_TZ_DZOGCHEN-DESUM-P72:35	sku gsung thugs kyi dngos grub ni :	3	sku gsung thugs kyi dngos grub ni 
BO_TZ_DZOGCHEN-DESUM-P72:36	tshhe 'dir 'grub pas spro ba skyed :	3	tshhe dir grub ba spro ba skyed 
BO_TZ_DZOGCHEN-DESUM-P72:37	yol ba bsal zhing nang du btang :	3	yol ba bsal zhing nang du gtong 
BO_TZ_DZOGCHEN-DESUM-P72:38	slob mas yon phul bla ma yis :	3	slob mas yon bul bla ma yis 
BO_TZ_DZOGCHEN-DESUM-P72:39	chos kyi nges pa lnga ldan bshad :	3	chos kyi nges ba lnga ldan chad 
BO_TZ_DZOGCHEN-DESUM-P72:40	slob ma rnams kyis slar yang phyag bcas :   mig dar /	4	slob ma rnams kyis slar yang phyag cha mig dar 
BO_TZ_DZOGCHEN-DESUM-P72:41	ho : bde bar gshegs pa bla ma rje :	4	ho bde ba gshegs ba bla ma rje 
BO_TZ_DZOGCHEN-DESUM-P72:42	dngos grub kun bdag yi dam lha :	4	dngos grub kun bdag yi dam lha 
BO_TZ_DZOGCHEN-DESUM-P72:43	mkha' 'gro'i gtsho bo dgongs su gsol :	4	mkha gro gtsho bo dgongs su gsol 
BO_TZ_DZOGCHEN-DESUM-P72:44	bdag cag dkyil 'khor chen po 'dir :	4	bdag cag dkyil khor chen po dir 
BO_TZ_DZOGCHEN-DESUM-P72:45	myur du gzhug par mdzad du gsol :	4	myur du jug ba mdzad du gsol 
BO_TZ_DZOGCHEN-DESUM-P72:46	bla mas : dpal chen po yi gnas 'di ru :	4	bla mas dpal chen po yi gnas di ru 
BO_TZ_DZOGCHEN-DESUM-P72:47	su yin 'jug pa'i skal med pas :	4	su yin jug ba skal med ba 
BO_TZ_DZOGCHEN-DESUM-P72:48	theg pa'i thabs tshhul shes pa dang : rgyud dag bsod nams ldan pa rnams :	4	theg ba thabs tshhul shes ba dang brgyud dag bsod nams ldan ba rnams 
BO_TZ_DZOGCHEN-DESUM-P72:49	'jug par rung bar rgyal bas bshad :	4	jug ba rung ba rgyal ba chad 
BO_TZ_DZOGCHEN-DESUM-P72:50	de bas rgyud dag tshhogs gsag mdzod :	5	de ba brgyud dag tshhogs gsag mdzod 
BO_TZ_DZOGCHEN-DESUM-P72:51	de bzhin bgyid la slob dpon gyis :	5	de bzhin bgyid la slob dpon gyis 
BO_TZ_DZOGCHEN-DESUM-P72:52	dpal chen klong dgu'i dkyil 'khor du :	5	dpal chen klong dgu dkyil khor du 
BO_TZ_DZOGCHEN-DESUM-P72:53	ngas ni yang dag khyod gzhug gi :	5	ngas ni yang dag khyod jug gi 
BO_TZ_DZOGCHEN-DESUM-P72:54	bla med rgyud las gang gsungs pa'i :	5	bla med brgyud las gang gsungs ba 
BO_TZ_DZOGCHEN-DESUM-P72:55	dam tshhig thams cad thub par srungs :	5	dam tshhig thams cad thub ba srungs 
BO_TZ_DZOGCHEN-DESUM-P72:56	bstshal pas slob mas khas len ni :	5	bstshal ba slob mas khas len ni 
BO_TZ_DZOGCHEN-DESUM-P72:57	bde bar gshegs pa khyed ci 'dra :	5	bde ba gshegs ba khyed ci dra 
BO_TZ_DZOGCHEN-DESUM-P72:58	de 'dra kho nar bdag gyur cig :	5	de dra kho nar bdag gyur cig 
BO_TZ_DZOGCHEN-DESUM-P72:59	sprul sku'i ston pas bshad pa yi :	5	sprul sku ston ba chad ba yi 
BO_TZ_DZOGCHEN-DESUM-P72:60	so so thar dang byang chub sems :	6	so so thar dang byang chub sems 
BO_TZ_DZOGCHEN-DESUM-P72:61	longs sku'i ston pas bshad pa yi :	6	longs sku ston ba chad ba yi 
BO_TZ_DZOGCHEN-DESUM-P72:62	rigs lnga'i sdom pa ma lus gzung :	6	rigs lnga sdom ba ma lus gzung 
BO_TZ_DZOGCHEN-DESUM-P72:63	khyad par he ru kahdpal gyis :	6	khyad ba he ru kahdpal gyis 
BO_TZ_DZOGCHEN-DESUM-P72:64	nyi shu lnga dang bye brag tu :	6	nyi shu lnga dang bye brag tu 
BO_TZ_DZOGCHEN-DESUM-P72:65	sku gsung thugs kyi dam tshhig rnams :	6	sku gsung thugs kyi dam tshhig rnams 
BO_TZ_DZOGCHEN-DESUM-P72:66	ji ltar bstan pa bdag gis bsrung :	6	ji ltar ston ba bdag gis bsrung 
BO_TZ_DZOGCHEN-DESUM-P72:67	srog gi phyir yang mi gtong na :	6	srog gi phyir yang mi gtong na 
BO_TZ_DZOGCHEN-DESUM-P72:68	bde gshegs rigs mchog bstshal du gsol :	6	bde gshegs rigs mchog bstshal du gsol 
BO_TZ_DZOGCHEN-DESUM-P72:69	khas blangs dam la gzhag pa ni :	6	khas blangs dam la jog ba ni 
BO_TZ_DZOGCHEN-DESUM-P72:70	nga ni sangs rgyas kun bdag nyid :	7	nga ni sangs rgya kun bdag nyid 
BO_TZ_DZOGCHEN-DESUM-P72:71	he ru kahdpal bla na med :	7	he ru kahdpal bla na med 
BO_TZ_DZOGCHEN-DESUM-P72:72	dpal chen che mchog nga yin gyis :	7	dpal chen che mchog nga yin gyis 
BO_TZ_DZOGCHEN-DESUM-P72:73	nga la brnyas par ma byed cig :	7	nga la brnyas ba ma byed cig 
BO_TZ_DZOGCHEN-DESUM-P72:74	rdo rje phreng ba mgo bor bzhag :	7	rdo rje phreng ba mgo bor jog 
BO_TZ_DZOGCHEN-DESUM-P72:75	nga ni bla ma kun tu bzang :	7	nga ni bla ma kun tu bzang 
BO_TZ_DZOGCHEN-DESUM-P72:76	khyod kyis bka' yang mi gcog cing :	7	khyod kyis bka yang mi gcog cing 
BO_TZ_DZOGCHEN-DESUM-P72:77	bde gshegs rigs kyis bshad pa'i chos :	7	bde gshegs rigs kyis chad ba chos 
BO_TZ_DZOGCHEN-DESUM-P72:78	bshad kyis the tshhom ma za zhig :	7	chad kyis the tshhom ma za jig 
BO_TZ_DZOGCHEN-DESUM-P72:79	rdo rje phreng ba snying gar bzhag :	7	rdo rje phreng ba snying gar jog 
BO_TZ_DZOGCHEN-DESUM-P72:80	'di ni ngo bo dam tshhig chu :	8	di ni ngo bo dam tshhig chu 
BO_TZ_DZOGCHEN-DESUM-P72:81	ye shes bskyed phyir sbyin pa yin :	8	ye shes skyed phyir sbyin ba yin 
BO_TZ_DZOGCHEN-DESUM-P72:82	dam bsrungs dngos grub 'dis thob byed :	8	dam bsrungs dngos grub dis thob byed 
BO_TZ_DZOGCHEN-DESUM-P72:83	ma bsrung lcags kyi sdig par 'gyur :	8	ma bsrung lcags kyi sdig ba gyur 
BO_TZ_DZOGCHEN-DESUM-P72:84	srog gcod dmyal ba chen por ltung :	8	srog gcod dmyal ba chen por ltung 
BO_TZ_DZOGCHEN-DESUM-P72:85	dam srung rdo rje'i chu 'di thungs :	8	dam srung rdo rje chu di thungs 
BO_TZ_DZOGCHEN-DESUM-P72:86	slob mas 'thung zhing bro bor ba :	8	slob mas thung zhing bro bor ba 
BO_TZ_DZOGCHEN-DESUM-P72:87	a+o~m badzra sa ma ya i dan na ra kan :	8	a+o~m badzra sa ma ya i dan na ra kan 
BO_TZ_DZOGCHEN-DESUM-P72:88	slob ma dpal chen por gsal ba'i snying gar nyi ma'i gdan la hu~m:	8	slob ma dpal chen por gsal ba snying gar nyi ma gdan la hu~m: 
BO_TZ_DZOGCHEN-DESUM-P72:89	slob dpon gyi thugs ka nas 'od zer 'phros :	8	slob dpon gyi thugs ka nas d zer phro 
BO_TZ_DZOGCHEN-DESUM-P72:90	rang bzhin gyi dbyings nas ye shes pa'i tshhogs spyan drangs te slob ma la thim :	9	rang bzhin gyi dbyings nas ye shes ba tshhogs spyan drangs te slob ma la thim 
BO_TZ_DZOGCHEN-DESUM-P72:91	dz+nya na a be sha ya a a:	9	dz+nya na a be sha ya a a: 
BO_TZ_DZOGCHEN-DESUM-P72:92	brtan par bya 'o slob dpon gyis :	9	brtan ba byed mang slob dpon gyis 
BO_TZ_DZOGCHEN-DESUM-P72:93	dpal chen po yi pho brang du :	9	dpal chen po yi pho brang du 
BO_TZ_DZOGCHEN-DESUM-P72:94	rig pa'i me tog 'dres med dor :	9	rig ba me tog dre med dor 
BO_TZ_DZOGCHEN-DESUM-P72:95	sngon nas las 'phro gang yod pa'i :	9	sngon nas las phro gang yod ba 
BO_TZ_DZOGCHEN-DESUM-P72:96	ye shes lha la 'bab par 'gyur :	9	ye shes lha la bab ba gyur 
BO_TZ_DZOGCHEN-DESUM-P72:97	slob mas me tog thal mor gzung :	9	slob mas me tog thal mor gzung 
BO_TZ_DZOGCHEN-DESUM-P72:98	ho : bde gshegs kun 'dus dkyil 'khor 'dir :	9	ho bde gshegs kun du dkyil khor dir 
BO_TZ_DZOGCHEN-DESUM-P72:99	snying po'i ye shes brtag bya'i phyir :	9	snying po ye shes rtog byed phyir 
BO_TZ_DZOGCHEN-DESUM-P72:100	rig pa'i me tog 'di 'bul gyis :	10	rig ba me tog di bul gyis 
BO_TZ_DZOGCHEN-DESUM-P72:101	las 'phro'i dbang gis bzhes su gsol :	10	las phro dbang gis bzhes su gsol 
BO_TZ_DZOGCHEN-DESUM-P72:102	push+pe pra titsh+tshha ho :	10	push+pe pra titsh+tshha ho 
BO_TZ_DZOGCHEN-DESUM-P72:103	dor zhing gang la phog pa yi :	10	dor zhing gang la bogs ba yi 
BO_TZ_DZOGCHEN-DESUM-P72:104	rigs dang mthun pa'i ming btags te :	10	rigs dang mthun ba ming dogs te 
BO_TZ_DZOGCHEN-DESUM-P72:105	hu~m: mi gnas ye shes dkyil 'khor du :	10	hu~m: mi gnas ye shes dkyil khor du 
BO_TZ_DZOGCHEN-DESUM-P72:106	rig pa'i me tog phul pa 'di :	10	rig ba me tog bul ba di 
BO_TZ_DZOGCHEN-DESUM-P72:107	byin rlabs bsam mi khyab par zungs :	10	byin rlabs bsam mi khyab ba zungs 
BO_TZ_DZOGCHEN-DESUM-P72:108	dngos grub thams cad 'dis thob shog :	10	dngos grub thams cad dis thob shog 
BO_TZ_DZOGCHEN-DESUM-P72:109	push+pe gr-ih+na satwam i mam satwa ma ha ba la :	10	push+pe gr-ih+na satwam i mam satwa ma ha ba la 
BO_TZ_DZOGCHEN-DESUM-P72:110	slob mas phyag 'tshhal 'di skad do :	11	slob mas phyag tshhal di skad do 
BO_TZ_DZOGCHEN-DESUM-P72:111	ho : bskal sngon bsgribs pa'i ma rig mig :	11	ho bskal sngon sgrib ba ma rig mig 
BO_TZ_DZOGCHEN-DESUM-P72:112	thabs mkhas rgyal po he ru kas :	11	thabs mkhas rgyal po he ru kas 
BO_TZ_DZOGCHEN-DESUM-P72:113	myur ba nyid du dbye ba dang : ye shes dkyil 'khor bstan du gsol :	11	myur ba nyid du byed ba dang ye shes dkyil khor ston du gsol 
BO_TZ_DZOGCHEN-DESUM-P72:114	slob dpon mig thur thogs byas la :	11	slob dpon mig thur thogs byed la 
BO_TZ_DZOGCHEN-DESUM-P72:115	sngon gyi rgyal ba thams cad kyis :	11	sngon gyi rgyal ba thams cad kyis 
BO_TZ_DZOGCHEN-DESUM-P72:116	'gro ba'i mig ni dbye bar mdzad :	11	gro ba mig ni byed ba mdzad 
BO_TZ_DZOGCHEN-DESUM-P72:117	sangs rgyas sa la bkod pa bzhin :	11	sangs rgya sa la bkod ba bzhin 
BO_TZ_DZOGCHEN-DESUM-P72:118	deng 'dir he ru kahbdag gis :	11	deng dir he ru kahbdag gis 
BO_TZ_DZOGCHEN-DESUM-P72:119	ma rig mig ni dbye bar bya :	11	ma rig mig ni byed ba byed 
BO_TZ_DZOGCHEN-DESUM-P72:120	tshak+shu pra be sha ya phata?:	12	tshak+shu pra be sha ya phata?: 
BO_TZ_DZOGCHEN-DESUM-P72:121	ho : ltos shig skal pa can rnams ltos :	12	ho ltos shig skal ba can rnams ltos 
BO_TZ_DZOGCHEN-DESUM-P72:122	bde gshegs kun 'dus dkyil 'khor 'di :	12	bde gshegs kun du dkyil khor di 
BO_TZ_DZOGCHEN-DESUM-P72:123	skad cig mthong ba tsham gyis kyang :	12	skad cig mthong ba tsham gyis kyang 
BO_TZ_DZOGCHEN-DESUM-P72:124	sgrib pa dag ste ye shes mthong :	12	sgrib ba dag ste ye shes mthong 
BO_TZ_DZOGCHEN-DESUM-P72:125	ho : dpal chen po'i pho brang dgu dang ye shes kyi bum pa dbyer med pa'i nang du :	12	ho dpal chen po pho brang dgu dang ye shes kyi bum ba dbyer med ba nang du 
BO_TZ_DZOGCHEN-DESUM-P72:126	bde gshegs kun 'dus tshhom bu dgu yi tshhul du bzhugs pa 'di ni mtshhan ma rdzas dang ting 'dzin sprul pa'i dkyil 'khor dbyer med yin cing :	12	bde gshegs kun du tshhom bu dgu yi tshhul du bzhugs ba di ni mtshhan ma rdzas dang ting dzin sprul ba dkyil khor dbyer med yin cing 
BO_TZ_DZOGCHEN-DESUM-P72:127	'di mtshhon byed de :	12	di mtshhon byed de 
BO_TZ_DZOGCHEN-DESUM-P72:128	mtshhon bya don gyi dkyil 'khor rang gi sems nyid ye shes klong dgur rdzogs pa'i rang bzhin du ngo shes par gyis shig :	12	mtshhon byed don gyi dkyil khor rang gi sems nyid ye shes klong dgur rdzogs ba rang bzhin du ngo shes ba gyis shig 
BO_TZ_DZOGCHEN-DESUM-P72:129	de ltar zhugs nas mngon par dbang :	12	de ltar jug nas mngon ba dbang 
BO_TZ_DZOGCHEN-DESUM-P72:130	bskur phyir man+dal gsol ba gdab :	13	skur phyir man+dal gsol ba gdab 
BO_TZ_DZOGCHEN-DESUM-P72:131	ho : ye shes dgu yi dkyil 'khor 'dir :	13	ho ye shes dgu yi dkyil khor dir 
BO_TZ_DZOGCHEN-DESUM-P72:132	zhugs kyang smin par mdzad du gsol :	13	jug kyang smin ba mdzad du gsol 
BO_TZ_DZOGCHEN-DESUM-P72:133	smin cing grol ba mthar phyin zhing :	13	smin cing grol ba mthar phyin zhing 
BO_TZ_DZOGCHEN-DESUM-P72:134	mi gnas klong du skyel bar mdzod :	13	mi gnas klong du skyel ba mdzod 
BO_TZ_DZOGCHEN-DESUM-P72:135	ces gsol slob dpon bum pa thogs :	13	ces gsol slob dpon bum ba thogs 
BO_TZ_DZOGCHEN-DESUM-P72:136	hu~m: dbyings kyi bum par rig pa'i bcud :	13	hu~m: dbyings kyi bum ba rig ba bcud 
BO_TZ_DZOGCHEN-DESUM-P72:137	zung 'jug ye shes klong dgu'i lha :	13	zung jug ye shes klong dgu lha 
BO_TZ_DZOGCHEN-DESUM-P72:138	gnyis med mnyam sbyor bdud rtshi mchog :	13	gnyis med mnyam sbyor bdud rtshi mchog 
BO_TZ_DZOGCHEN-DESUM-P72:139	ye shes chu yi dbang bskur ro :	13	ye shes chu yi dbang skur ro 
BO_TZ_DZOGCHEN-DESUM-P72:140	ka la shaha b+hi shiny+tsha hu~m:	14	ka la shaha b+hi shiny+tsha hu~m: 
BO_TZ_DZOGCHEN-DESUM-P72:141	rgyas par ye shes klong dgu dbye :	14	rgya ba ye shes klong dgu byed 
BO_TZ_DZOGCHEN-DESUM-P72:142	rin chen 'bar ba'i prog zhu 'di :	14	rin chen bar ba prog ju di 
BO_TZ_DZOGCHEN-DESUM-P72:143	rgyal ba kun dang mnyam pa yi :	14	rgyal ba kun dang mnyam ba yi 
BO_TZ_DZOGCHEN-DESUM-P72:144	go 'phang bla med bsgrub bya'i phyir :	14	go phen bla med sgrub byed phyir 
BO_TZ_DZOGCHEN-DESUM-P72:145	dbang bskur cod pan chen po 'o :	14	dbang skur cod pan chen po mang 
BO_TZ_DZOGCHEN-DESUM-P72:146	rat+na mu ku ta a b+hi shiny+tsha tram:	14	rat+na mu ku ta a b+hi shiny+tsha tram: 
BO_TZ_DZOGCHEN-DESUM-P72:147	sangs rgyas rigs lnga'i ye shes lngas :	14	sangs rgya rigs lnga ye shes lngas 
BO_TZ_DZOGCHEN-DESUM-P72:148	dug lnga rnam par gzhom pa'i phyir :	14	dug lnga rnam ba joms ba phyir 
BO_TZ_DZOGCHEN-DESUM-P72:149	mi 'gyur rdo rje bla na med :	14	mi gyur rdo rje bla na med 
BO_TZ_DZOGCHEN-DESUM-P72:150	sangs rgyas rdo rje'i dbang bskur ro :	15	sangs rgya rdo rje dbang skur ro 
BO_TZ_DZOGCHEN-DESUM-P72:151	badzra d+ha ra a d+hi pa ti badzra a b+hi shiny+tsha hri:	15	badzra d+ha ra a d+hi ba ti badzra a b+hi shiny+tsha hri: 
BO_TZ_DZOGCHEN-DESUM-P72:152	yan lag drug cu'i dbyangs ldan gsung :	15	yan lag drug cu dbyangs ldan gsung 
BO_TZ_DZOGCHEN-DESUM-P72:153	rjes su 'gro ba'i shes rab mchog :	15	rjes su gro ba shes rab mchog 
BO_TZ_DZOGCHEN-DESUM-P72:154	ma rig sad pa'i dril bu che :	15	ma rig sad ba dril bu che 
BO_TZ_DZOGCHEN-DESUM-P72:155	karma g+han+de a b+hi shiny+tsha a:	15	karma g+han+de a b+hi shiny+tsha a: 
BO_TZ_DZOGCHEN-DESUM-P72:156	dus gsum sangs rgyas thams cad kyi :	15	dus gsum sangs rgya thams cad kyi 
BO_TZ_DZOGCHEN-DESUM-P72:157	rdo rje'i ming ni bla na med :	15	rdo rje ming ni bla na med 
BO_TZ_DZOGCHEN-DESUM-P72:158	sa gsum kun tu grags pa yi :	15	sa gsum kun tu grags ba yi 
BO_TZ_DZOGCHEN-DESUM-P72:159	che ge mo zhes bya'o :	15	che ge mo zhes byed 
BO_TZ_DZOGCHEN-DESUM-P72:160	a+o~m sarba ta tha ga ta che ge mo   spyir he ru kahdpal zhes sbyar /d+ha ra ya mi a b+hi shiny+tsha a+o~m:	16	a+o~m sarba ta tha ga ta che ge mo spyir he ru kahdpal zhes sbyor ra ya mi a b+hi shiny+tsha a+o~m: 
BO_TZ_DZOGCHEN-DESUM-P72:161	dpal gyi sku rnams so sor bskur :	16	dpal gyi sku rnams so sor skur 
BO_TZ_DZOGCHEN-DESUM-P72:162	hu~m: chos sku zhi ba'i ngang las ma g.yos kyang :	16	hu~m: chos sku zhi ba ngang las ma g.yos kyang 
BO_TZ_DZOGCHEN-DESUM-P72:163	chos dbyings ye shes longs spyod rdzogs pa'i sku :	16	chos dbyings ye shes longs spyod rdzogs ba sku 
BO_TZ_DZOGCHEN-DESUM-P72:164	bla na med pa che mchog he ru ka :	16	bla na med ba che mchog he ru ka 
BO_TZ_DZOGCHEN-DESUM-P72:165	yab yum 'khor dang bcas pas dbang bskur ro :	16	yab yum khor dang cha ba dbang skur ro 
BO_TZ_DZOGCHEN-DESUM-P72:166	a+o~m badzra kro d+ha ma ha shri he ru kahhu~m phata?:	16	a+o~m badzra kro d+ha ma ha shri he ru kahhu~m phata?: 
BO_TZ_DZOGCHEN-DESUM-P72:167	sarba sa ma ya a b+hi shiny+tsha hu~m:	16	sarba sa ma ya a b+hi shiny+tsha hu~m: 
BO_TZ_DZOGCHEN-DESUM-P72:168	hu~m: chos sku\u0f8e me long\u0f8e	16	hu~m: chos sku\u0f8e me long\u0f8e 
BO_TZ_DZOGCHEN-DESUM-P72:169	bla na med pa'i yang dag he ru ka :	16	bla na med ba yang dag he ru ka 
BO_TZ_DZOGCHEN-DESUM-P72:170	yab yum\u0f8e a+o~m ru lu ru lu hu~m b+h+yo hu~m:	17	yab yum\u0f8e a+o~m ru lu ru lu hu~m b+h+yo hu~m: 
BO_TZ_DZOGCHEN-DESUM-P72:171	sarba sa ma ya a\u0f8e	17	sarba sa ma ya a\u0f8e 
BO_TZ_DZOGCHEN-DESUM-P72:172	hu~m: chos sku\u0f8e mnyam nyid\u0f8e	17	hu~m: chos sku\u0f8e mnyam nyid\u0f8e 
BO_TZ_DZOGCHEN-DESUM-P72:173	bla na med pa'i 'jam dpal gshin rje gshed :	17	bla na med ba jam dpal gshin rje gshed 
BO_TZ_DZOGCHEN-DESUM-P72:174	yab yum\u0f8e a+o~m a kro te ka ya man+ta ka ha na ma tha b+hany+dza hu~m phata?:	17	yab yum\u0f8e a+o~m a kro te ka ya man+ta ka ha na ma tha b+hany+dza hu~m phata?: 
BO_TZ_DZOGCHEN-DESUM-P72:175	sarba sa ma ya a\u0f8e	17	sarba sa ma ya a\u0f8e 
BO_TZ_DZOGCHEN-DESUM-P72:176	hu~m: chos sku\u0f8esor rtog\u0f8e	17	hu~m: chos sku\u0f8esor rtog\u0f8e 
BO_TZ_DZOGCHEN-DESUM-P72:177	bla na med pa'i dpal chen rta mchog rgyal :	17	bla na med ba dpal chen rta mchog rgyal 
BO_TZ_DZOGCHEN-DESUM-P72:178	yab yum\u0f8e a+o~m pad+man+ta kr-ita badzra kro d+ha ha ya gr-i wa hu~m phata?:	17	yab yum\u0f8e a+o~m pad+man+ta kr-ita badzra kro d+ha ha ya gr-i wa hu~m phata?: 
BO_TZ_DZOGCHEN-DESUM-P72:179	sarba sa ma ya a\u0f8e	17	sarba sa ma ya a\u0f8e 
BO_TZ_DZOGCHEN-DESUM-P72:180	hu~m: chos sku\u0f8e nan tan ye shes\u0f8e	18	hu~m: chos sku\u0f8e nan tan ye shes\u0f8e 
BO_TZ_DZOGCHEN-DESUM-P72:181	bla na med pa'i rdo rje gzhon nu che :	18	bla na med ba rdo rje gzhon nu che 
BO_TZ_DZOGCHEN-DESUM-P72:182	yab yum\u0f8e a+o~m badzra ki+a li ki la ya sarba big+h+nan bam hu~m phata?:	18	yab yum\u0f8e a+o~m badzra ki+a li ki la ya sarba big+h+nan bam hu~m phata?: 
BO_TZ_DZOGCHEN-DESUM-P72:183	sarba sa ma ya a\u0f8e	18	sarba sa ma ya a\u0f8e 
BO_TZ_DZOGCHEN-DESUM-P72:184	hu~m: chos sku\u0f8e klong gyur ye shes\u0f8e	18	hu~m: chos sku\u0f8e klong gyur ye shes\u0f8e 
BO_TZ_DZOGCHEN-DESUM-P72:185	bla na med pa'i ye shes he ru ka :	18	bla na med ba ye shes he ru ka 
BO_TZ_DZOGCHEN-DESUM-P72:186	yab yum\u0f8e a+o~m gu h+ya dz+nya na shri he ru kahgu h+ya dz+nya na kro d+hi shwa ri satwam:	18	yab yum\u0f8e a+o~m gu h+ya dz+nya na shri he ru kahgu h+ya dz+nya na kro d+hi shwa ri satwam: 
BO_TZ_DZOGCHEN-DESUM-P72:187	ma ma yo gi ni ru lu ru lu hu~m b+h+yo hu~m phata?:	18	ma ma yo gi ni ru lu ru lu hu~m b+h+yo hu~m phata?: 
BO_TZ_DZOGCHEN-DESUM-P72:188	sarba sa ma ya a\u0f8e	18	sarba sa ma ya a\u0f8e 
BO_TZ_DZOGCHEN-DESUM-P72:189	hu~m: chos sku\u0f8e phyag chen ye shes\u0f8e	18	hu~m: chos sku\u0f8e phyag chen ye shes\u0f8e 
BO_TZ_DZOGCHEN-DESUM-P72:190	bla med rig 'dzin mi yi thod pa rtshal :	19	bla med rig dzin mi yi thod ba rtshal 
BO_TZ_DZOGCHEN-DESUM-P72:191	yab yum\u0f8e a+o~m badzra ma ha gu ru sarba sid+d+hi hu~m phata?:	19	yab yum\u0f8e a+o~m badzra ma ha gu ru sarba sid+d+hi hu~m phata?: 
BO_TZ_DZOGCHEN-DESUM-P72:192	sarba sa ma ya a\u0f8e	19	sarba sa ma ya a\u0f8e 
BO_TZ_DZOGCHEN-DESUM-P72:193	hu~m: chos sku\u0f8e dbyings grol ye shes\u0f8e	19	hu~m: chos sku\u0f8e dbyings grol ye shes\u0f8e 
BO_TZ_DZOGCHEN-DESUM-P72:194	bla na med pa'i dregs pa 'dul byed che :	19	bla na med ba dregs ba dul byed che 
BO_TZ_DZOGCHEN-DESUM-P72:195	yab yum\u0f8e a+o~m badzra tshan+da sarba dush+tan hu~m phata?:	19	yab yum\u0f8e a+o~m badzra tshan+da sarba dush+tan hu~m phata?: 
BO_TZ_DZOGCHEN-DESUM-P72:196	sarba sa ma ya a\u0f8e	19	sarba sa ma ya a\u0f8e 
BO_TZ_DZOGCHEN-DESUM-P72:197	hu~m: chos sku\u0f8e mtha' grol ye shes\u0f8e	19	hu~m: chos sku\u0f8e mtha grol ye shes\u0f8e 
BO_TZ_DZOGCHEN-DESUM-P72:198	bla na med pa'i dpal chen stobs dang ldan :	19	bla na med ba dpal chen stobs dang ldan 
BO_TZ_DZOGCHEN-DESUM-P72:199	yab yum\u0f8e a+o~m badzra sarba dush+tan hu~m phata?:	19	yab yum\u0f8e a+o~m badzra sarba dush+tan hu~m phata?: 
BO_TZ_DZOGCHEN-DESUM-P72:200	sarba sa ma ya a b+hi shiny+tsha hu~m:	20	sarba sa ma ya a b+hi shiny+tsha hu~m: 
BO_TZ_DZOGCHEN-DESUM-P72:201	hu~m: snod bcud yongs rdzogs bka' sdod bum pa ru :	20	hu~m: snod bcud yongs rdzogs bka sdod bum ba ru 
BO_TZ_DZOGCHEN-DESUM-P72:202	ma mo nyer brgyad gtshor gyur bye ba 'bum :	20	ma mo nyer brgyad gtshor gyur bye ba bum 
BO_TZ_DZOGCHEN-DESUM-P72:203	bsam gyis mi khyab yongs rdzogs dbang bskur bas :	20	bsam gyis mi khyab yongs rdzogs dbang skur ba 
BO_TZ_DZOGCHEN-DESUM-P72:204	phrin las sna tshhogs lhun gyis 'grub par shog :	20	phrin las sna tshhogs lhun gyis grub ba shog 
BO_TZ_DZOGCHEN-DESUM-P72:205	a+o~m badzra sarba yak+sha sa ma ya hu~m phata?:	20	a+o~m badzra sarba yak+sha sa ma ya hu~m phata?: 
BO_TZ_DZOGCHEN-DESUM-P72:206	sarba a b+hi shiny+tsha hu~m:	20	sarba a b+hi shiny+tsha hu~m: 
BO_TZ_DZOGCHEN-DESUM-P72:207	bzlas lung sbyin zhing sngags phreng gtad :	20	bzlas lung sbyin zhing sngags phreng gtod 
BO_TZ_DZOGCHEN-DESUM-P72:208	he ru kahyi gsung dang mnyam :	20	he ru kahyi gsung dang mnyam 
BO_TZ_DZOGCHEN-DESUM-P72:209	bzlas brjod sngags kyi nus pa rnams :	20	bzlas rjod sngags kyi nus ba rnams 
BO_TZ_DZOGCHEN-DESUM-P72:210	nus ldan mi nyams 'phel ba yi :	21	nus ldan mi nyams phel ba yi 
BO_TZ_DZOGCHEN-DESUM-P72:211	gsung gi dbang mchog rdzogs par shog :	21	gsung gi dbang mchog rdzogs ba shog 
BO_TZ_DZOGCHEN-DESUM-P72:212	a+o~m badzra kro d+ha sarba wa ka a b+hi shiny+tsha a:	21	a+o~m badzra kro d+ha sarba wa ka a b+hi shiny+tsha a: 
BO_TZ_DZOGCHEN-DESUM-P72:213	phyag mtshhan du bsgom rdo rje gtad :	21	phyag mtshhan du bsgom rdo rje gtod 
BO_TZ_DZOGCHEN-DESUM-P72:214	dbyings kyi stong cha thugs kyi ngang :	21	dbyings kyi stong cha thugs kyi ngang 
BO_TZ_DZOGCHEN-DESUM-P72:215	phyag mtshhan rig pa lu gu rgyud :	21	phyag mtshhan rig ba lu gu brgyud 
BO_TZ_DZOGCHEN-DESUM-P72:216	dbyings rig dbyer med gsal stong thugs :	21	dbyings rig dbyer med gsal stong thugs 
BO_TZ_DZOGCHEN-DESUM-P72:217	ma bcos lhug par dbang bskur ro :	21	ma chos lhug ba dbang skur ro 
BO_TZ_DZOGCHEN-DESUM-P72:218	a+o~m badzra kro d+ha sarba tshit+ta a b+hi shiny+tsha hu~m:	21	a+o~m badzra kro d+ha sarba tshit+ta a b+hi shiny+tsha hu~m: 
BO_TZ_DZOGCHEN-DESUM-P72:219	ye shes sems dpa'i dbang bskur ni :	21	ye shes sems dpa dbang skur ni 
BO_TZ_DZOGCHEN-DESUM-P72:220	kun tu bzang po rdo rje sems :	22	kun tu bzang po rdo rje sems 
BO_TZ_DZOGCHEN-DESUM-P72:221	'jam dpal gzhon nu spyan ras gzigs :	22	jam dpal gzhon nu spyan ras gzigs 
BO_TZ_DZOGCHEN-DESUM-P72:222	gsang ba'i bdag po rdo rje 'dzin :	22	gsang ba bdag po rdo rje dzin 
BO_TZ_DZOGCHEN-DESUM-P72:223	sems dpa' lnga yi dbang bskur ro :	22	sems dpa lnga yi dbang skur ro 
BO_TZ_DZOGCHEN-DESUM-P72:224	a+o~m sa man+ta b+ha dra badzra satwa many+dzu shri ar+ya a ba lo ki shwa ra badzra d+ha ra a b+hi shiny+tsha hu~m:	22	a+o~m sa man+ta b+ha dra badzra satwa many+dzu shri ar+ya a ba lo ki shwa ra badzra d+ha ra a b+hi shiny+tsha hu~m: 
BO_TZ_DZOGCHEN-DESUM-P72:225	yon tan dam rdzas chas dbang ni :	22	yon tan dam rdzas cha dbang ni 
BO_TZ_DZOGCHEN-DESUM-P72:226	dbyings rig dbyer med gtor ma dang : 'khor 'das yongs grol rak+ta che :	22	dbyings rig dbyer med thor ma dang khor da yongs grol rak+ta che 
BO_TZ_DZOGCHEN-DESUM-P72:227	ye shes lnga rdzogs bdud rtshi'i dbang :	22	ye shes lnga rdzogs bdud rtshi dbang 
BO_TZ_DZOGCHEN-DESUM-P72:228	bskur bas bsnyen sgrub mthar phyin shog :	22	skur ba snyen sgrub mthar phyin shog 
BO_TZ_DZOGCHEN-DESUM-P72:229	ba lim ta rak+ta pany+tsha a mr-ita a b+hi shiny+tsha hu~m:	22	ba lim ta rak+ta pany+tsha a mr-ita a b+hi shiny+tsha hu~m: 
BO_TZ_DZOGCHEN-DESUM-P72:230	hu~m: ye shes klong nas shar ba'i dpal gyi chas :	23	hu~m: ye shes klong nas char ba dpal gyi cha 
BO_TZ_DZOGCHEN-DESUM-P72:231	ko rlon zhing chen stag sham sbrul chun dang : thod skam thod rlon rdo rje'i go khrab bcas :	23	ko rlon zhing chen stag sham sbrul chun dang thod skam thod rlon rdo rje go khrab cha 
BO_TZ_DZOGCHEN-DESUM-P72:232	khrag zhag thal chen rdo rje'i khyung gshog sogs :	23	khrag zhag thal chen rdo rje khyung gshog sogs 
BO_TZ_DZOGCHEN-DESUM-P72:233	yon tan yongs rdzogs chas kyi dbang bskur ro :	23	yon tan yongs rdzogs cha kyi dbang skur ro 
BO_TZ_DZOGCHEN-DESUM-P72:234	a+o~m badzra kro d+ha sarba gu na a b+hi shiny+tsha hu~m:	23	a+o~m badzra kro d+ha sarba gu na a b+hi shiny+tsha hu~m: 
BO_TZ_DZOGCHEN-DESUM-P72:235	phrin las khyung gi dbang bskur ni :	23	phrin las khyung gi dbang skur ni 
BO_TZ_DZOGCHEN-DESUM-P72:236	gdug pa klu 'dul bya khyung dkar nag gnyis :	23	gdug ba klu dul byed khyung dkar nag gnyis 
BO_TZ_DZOGCHEN-DESUM-P72:237	sprul pa'i khra thabs mang po las la 'gyed :	23	sprul ba khra thabs mang po las la gyed 
BO_TZ_DZOGCHEN-DESUM-P72:238	log rtog 'dul phyir dpal chen khyung gi dbang :	23	log rtogs dul phyir dpal chen khyung gi dbang 
BO_TZ_DZOGCHEN-DESUM-P72:239	las sbyor lhun gyis 'grub phyir dbang bskur ro :	23	las sbyor lhun gyis grub phyir dbang skur ro 
BO_TZ_DZOGCHEN-DESUM-P72:240	khrom ga ru dahkarma a b+hi shiny+tsha hu~m:	24	khrom ga ru dahkarma a b+hi shiny+tsha hu~m: 
BO_TZ_DZOGCHEN-DESUM-P72:241	ho : bkra shis bum pa 'khor dang bcas pa'i dbang bskur pas :	24	ho bkra shis bum ba khor dang cha ba dbang skur ba 
BO_TZ_DZOGCHEN-DESUM-P72:242	slob ma thams cad lha ru 'gyur zhing lha thams cad snang stong gi ye shes su rtogs par gyur cig :	24	slob ma thams cad lha ru gyur zhing lha thams cad snang stong gi ye shes su rtogs ba gyur cig 
BO_TZ_DZOGCHEN-DESUM-P72:243	me tog 'thor zhing brda don bshad :	24	me tog thor zhing brda don chad 
BO_TZ_DZOGCHEN-DESUM-P72:244	hu~m: dbyings kyi b+han+d+ha yangs pa ru :	24	hu~m: dbyings kyi b+han+d+ha yangs ba ru 
BO_TZ_DZOGCHEN-DESUM-P72:245	rig pa bde stong lha tshhogs sbyor :	24	rig ba bde stong lha tshhogs sbyor 
BO_TZ_DZOGCHEN-DESUM-P72:246	zung 'jug bde chen bdud rtshi'i dbang :	24	zung jug bde chen bdud rtshi dbang 
BO_TZ_DZOGCHEN-DESUM-P72:247	bde chen yongs su bskyed phyir bskur :	24	bde chen yongs su skyed phyir skur 
BO_TZ_DZOGCHEN-DESUM-P72:248	bo d+hi tshit+ta a b+hi shiny+tsha hu~m:	24	bo d+hi tshit+ta a b+hi shiny+tsha hu~m: 
BO_TZ_DZOGCHEN-DESUM-P72:249	ho : bde ba chen po byang chub sems kyi bdud rtshis dbang bskur pas phung khams thams cad lhar dag ste bde gsal ye shes mngon du 'bar bar gyur cig :	24	ho bde ba chen po byang chub sems kyi bdud rtshis dbang skur ba phung khams thams cad lhar dag ste bde gsal ye shes mngon du bar ba gyur cig 
BO_TZ_DZOGCHEN-DESUM-P72:250	me tog 'thor zhing brda don bshad :	25	me tog thor zhing brda don chad 
BO_TZ_DZOGCHEN-DESUM-P72:251	hu~m: bkra shis mtshhan ldan gzungs ma 'di :	25	hu~m: bkra shis mtshhan ldan gzungs ma di 
BO_TZ_DZOGCHEN-DESUM-P72:252	bsten na bde ba chen po rtogs :	25	sten na bde ba chen po rtogs 
BO_TZ_DZOGCHEN-DESUM-P72:253	'di spangs sangs rgyas thob 'dod min :	25	di spong sangs rgya thob dod min 
BO_TZ_DZOGCHEN-DESUM-P72:254	bde chen ngal med rtag tu rol :	25	bde chen ngal med rtag tu rol 
BO_TZ_DZOGCHEN-DESUM-P72:255	ma ha su kha a b+hi shiny+tsha hu~m:	25	ma ha su kha a b+hi shiny+tsha hu~m: 
BO_TZ_DZOGCHEN-DESUM-P72:256	ho : bde skyed yum gyi dbang bskur pas rtog tshhogs thams cad bde ba chen por dag ste :	25	ho bde skyed yum gyi dbang skur ba rtogs tshhogs thams cad bde ba chen por dag ste 
BO_TZ_DZOGCHEN-DESUM-P72:257	bde chen ye shes klong du 'bar bar gyur cig :	25	bde chen ye shes klong du bar ba gyur cig 
BO_TZ_DZOGCHEN-DESUM-P72:258	me tog 'thor zhing brda don bshad :	25	me tog thor zhing brda don chad 
BO_TZ_DZOGCHEN-DESUM-P72:259	hu~m: sems nyid ma bcos ka nas dag :	25	hu~m: sems nyid ma chos ka nas dag 
BO_TZ_DZOGCHEN-DESUM-P72:260	stong gsal rang byung ye shes rtshal :	26	stong gsal rang byung ye shes rtshal 
BO_TZ_DZOGCHEN-DESUM-P72:261	lhun gyis grub pa me long bzhin :	26	lhun gyis grub ba me long bzhin 
BO_TZ_DZOGCHEN-DESUM-P72:262	rig rtshal mchog gi dbang thob shog :	26	rig rtshal mchog gi dbang thob shog 
BO_TZ_DZOGCHEN-DESUM-P72:263	d+harma d+ha tu a b+hi shiny+tsha a:	26	d+harma d+ha tu a b+hi shiny+tsha a: 
BO_TZ_DZOGCHEN-DESUM-P72:264	ho : rdo rje sems dpa'i me long gi dbang bskur pas :	26	ho rdo rje sems dpa me long gi dbang skur ba 
BO_TZ_DZOGCHEN-DESUM-P72:265	mi gnas ye shes kyi rtogs pa mngon du 'gyur bar gyur cig :	26	mi gnas ye shes kyi rtogs ba mngon du gyur ba gyur cig 
BO_TZ_DZOGCHEN-DESUM-P72:266	me tog 'thor zhing brda don bshad :	26	me tog thor zhing brda don chad 
BO_TZ_DZOGCHEN-DESUM-P72:267	dbyings kyi rang bzhin me long la :	26	dbyings kyi rang bzhin me long la 
BO_TZ_DZOGCHEN-DESUM-P72:268	rma bya'i mdongs ltar ci yang 'char :	26	rma byed mdongs ltar ci yang char 
BO_TZ_DZOGCHEN-DESUM-P72:269	rig rtshal zung 'jug rtshal gyi dbang :	26	rig rtshal zung jug rtshal gyi dbang 
BO_TZ_DZOGCHEN-DESUM-P72:270	yang dag par ni rtogs par shog :	27	yang dag ba ni rtogs ba shog 
BO_TZ_DZOGCHEN-DESUM-P72:271	d+harma dz+nya na a b+hi shiny+tsha hu~m:	27	d+harma dz+nya na a b+hi shiny+tsha hu~m: 
BO_TZ_DZOGCHEN-DESUM-P72:272	ho : rigs kyi bu la thod rgal gyi dbang bskur pas :	27	ho rigs kyi bu la thod rgal gyi dbang skur ba 
BO_TZ_DZOGCHEN-DESUM-P72:273	dbyings ye zung du 'jug pa'i rtogs pa mngon du 'gyur bar gyur cig :	27	dbyings ye zung du jug ba rtogs ba mngon du gyur ba gyur cig 
BO_TZ_DZOGCHEN-DESUM-P72:274	me tog 'thor zhing brda don bshad :	27	me tog thor zhing brda don chad 
BO_TZ_DZOGCHEN-DESUM-P72:275	yongs rdzogs slob ma'i dbang bskur rdzogs :	27	yongs rdzogs slob ma dbang skur rdzogs 
BO_TZ_DZOGCHEN-DESUM-P72:276	rdo rje slob dpon dbang bskur ni :	27	rdo rje slob dpon dbang skur ni 
BO_TZ_DZOGCHEN-DESUM-P72:277	slob ma khri la mnga' gsol zhing :	27	slob ma khri la mnga gsol zhing 
BO_TZ_DZOGCHEN-DESUM-P72:278	gzhan snang zil gyis gnon pa'i khri steng du :	27	gzhan snang zil gyis gnon ba khri steng du 
BO_TZ_DZOGCHEN-DESUM-P72:279	slob ma dpal chen rang gi rig par rtogs :	27	slob ma dpal chen rang gi rig ba rtogs 
BO_TZ_DZOGCHEN-DESUM-P72:280	bkra shis gdugs dang rgyal mtshhan rol mo'i sgra :	28	bkra shis gdugs dang rgyal mtshhan rol mo sgra 
BO_TZ_DZOGCHEN-DESUM-P72:281	rgyal bas me tog 'thor bas mnga' gsol zhing :	28	rgyal ba me tog thor ba mnga gsol zhing 
BO_TZ_DZOGCHEN-DESUM-P72:282	'gro don mdzad pa'i glegs bam phyag shing dang : chos kyi dung chen rnams kyis mnga' dbul lo :	28	gro don mdzad ba glegs bam phyag shing dang chos kyi dung chen rnams kyis mnga bul lo 
BO_TZ_DZOGCHEN-DESUM-P72:283	rten 'brel snying po brjod par bya :	28	rten brel snying po rjod ba byed 
BO_TZ_DZOGCHEN-DESUM-P72:284	gdug pa'i dgra bgegs bsgral dbang ni :	28	gdug ba dgra bgegs bsgral dbang ni 
BO_TZ_DZOGCHEN-DESUM-P72:285	hu~m: rnam thar gsum gyi e dbyings su :	28	hu~m: rnam thar gsum gyi e dbyings su 
BO_TZ_DZOGCHEN-DESUM-P72:286	dug gsum ru dra bkug nas ni :	28	dug gsum ru dra gugs nas ni 
BO_TZ_DZOGCHEN-DESUM-P72:287	sku gsum phur pas gdab pa yis :	28	sku gsum phur ba gdab ba yis 
BO_TZ_DZOGCHEN-DESUM-P72:288	'od gsal dbyings bsgral dbang thob shog :	28	d gsal dbyings bsgral dbang thob shog 
BO_TZ_DZOGCHEN-DESUM-P72:289	karma ki li ki la ya a b+hi shiny+tsha hu~m:	28	karma ki li ki la ya a b+hi shiny+tsha hu~m: 
BO_TZ_DZOGCHEN-DESUM-P72:290	hu~m: rnam rtog mtshhan 'dzin 'khrul pa kun :	29	hu~m: rnam rtogs mtshhan dzin khrul ba kun 
BO_TZ_DZOGCHEN-DESUM-P72:291	ye shes klong du bsreg pa'i phyir :	29	ye shes klong du bsreg ba phyir 
BO_TZ_DZOGCHEN-DESUM-P72:292	thabs shes dbyer med gzar bu'i dbang :	29	thabs shes dbyer med gzar bu dbang 
BO_TZ_DZOGCHEN-DESUM-P72:293	mnyam rdzogs chen por thob par shog :	29	mnyam rdzogs chen por thob ba shog 
BO_TZ_DZOGCHEN-DESUM-P72:294	dz+wa la ram a b+hi shiny+tsha hu~m:	29	dz+wa la ram a b+hi shiny+tsha hu~m: 
BO_TZ_DZOGCHEN-DESUM-P72:295	hu~m: mnyam nyid dbyings nas rig pa bzhengs :	29	hu~m: mnyam nyid dbyings nas rig ba bzhengs 
BO_TZ_DZOGCHEN-DESUM-P72:296	ye shes dpag med dmag dpung 'khrigs :	29	ye shes dpog med dmag dpung khrig 
BO_TZ_DZOGCHEN-DESUM-P72:297	ma rungs log rtog zlog par mdzad :	29	ma rungs log rtogs zlog ba mdzad 
BO_TZ_DZOGCHEN-DESUM-P72:298	la bzla zor gyi dbang bskur ro :	29	la bzla zor gyi dbang skur ro 
BO_TZ_DZOGCHEN-DESUM-P72:299	ma ra ya b+h+yo b+h+yo zlog zlog a b+hi shiny+tsha hu~m:	29	ma ra ya b+h+yo b+h+yo zlog zlog a b+hi shiny+tsha hu~m: 
BO_TZ_DZOGCHEN-DESUM-P72:300	hu~m: mnyam nyid g.yo ba med pa'i dbyings :	30	hu~m: mnyam nyid g.yo ba med ba dbyings 
BO_TZ_DZOGCHEN-DESUM-P72:301	rtog pa phra rags thams cad mnan :	30	rtogs ba phra rags thams cad gnon 
BO_TZ_DZOGCHEN-DESUM-P72:302	gnyis su med par thim gyur pas :	30	gnyis su med ba thim gyur ba 
BO_TZ_DZOGCHEN-DESUM-P72:303	log rtog gnan pa'i dbang bskur ro :	30	log rtogs gnon ba dbang skur ro 
BO_TZ_DZOGCHEN-DESUM-P72:304	a+o~m lam hu~m lam satwam b+ha ya nan :	30	a+o~m lam hu~m lam satwam b+ha ya nan 
BO_TZ_DZOGCHEN-DESUM-P72:305	kun nas drag sngags so lnga brjod :	30	kun nas drag sngags so lnga rjod 
BO_TZ_DZOGCHEN-DESUM-P72:306	spyi blugs zhwa dang gos nag gtad :	30	spyi blugs zhwa dang gos nag gtod 
BO_TZ_DZOGCHEN-DESUM-P72:307	hu~m: snang srid zil gyis gnon pa'i phyir :	30	hu~m: snang srid zil gyis gnon ba phyir 
BO_TZ_DZOGCHEN-DESUM-P72:308	bcu gsum chas ldan drag po'i zhwa :	30	chu gsum cha ldan drag po zhwa 
BO_TZ_DZOGCHEN-DESUM-P72:309	ber nag rdzas snod phreng ba dang : ral pa'i thor tshhugs me long sogs :	30	ber nag rdzas snod phreng ba dang ral ba thor tshhugs me long sogs 
BO_TZ_DZOGCHEN-DESUM-P72:310	rgyud las gsungs pa'i chas rnams kyis :	31	brgyud las gsungs ba cha rnams kyis 
BO_TZ_DZOGCHEN-DESUM-P72:311	sngags 'chang rgyal por mnga' gsol lo :	31	sngags chang rgyal por mnga gsol lo 
BO_TZ_DZOGCHEN-DESUM-P72:312	sarba a b+hi shiny+tsha hu~m:	31	sarba a b+hi shiny+tsha hu~m: 
BO_TZ_DZOGCHEN-DESUM-P72:313	chas rnams bzhes shing 'chams stabs bsgyur :	31	cha rnams bzhes shing cham stabs sgyur 
BO_TZ_DZOGCHEN-DESUM-P72:314	dbang rnams yongs rdzogs tshhang ba'i rjes :	31	dbang rnams yongs rdzogs tshhang ba rjes 
BO_TZ_DZOGCHEN-DESUM-P72:315	bkra shis tshhe gal la sogs sbyin :	31	bkra shis tshhe gal la sogs sbyin 
BO_TZ_DZOGCHEN-DESUM-P72:316	hri: mi 'gyur mi shigs tshhe yi dbang :	31	hri: mi gyur mi shigs tshhe yi dbang 
BO_TZ_DZOGCHEN-DESUM-P72:317	bde stong dbyer med gal gyi dbang :	31	bde stong dbyer med gal gyi dbang 
BO_TZ_DZOGCHEN-DESUM-P72:318	thabs shes bza' btung sna tshhogs pa'i :	31	thabs shes bza thung sna tshhogs ba 
BO_TZ_DZOGCHEN-DESUM-P72:319	bkra shis zhal zas dbang bskur ro :	31	bkra shis zhal zas dbang skur ro 
BO_TZ_DZOGCHEN-DESUM-P72:320	sarba sid+d+hi a b+hi shiny+tsha hri:	32	sarba sid+d+hi a b+hi shiny+tsha hri: 
BO_TZ_DZOGCHEN-DESUM-P72:321	bkra shis brjod cing me tog 'thor :	32	bkra shis rjod cing me tog thor 
BO_TZ_DZOGCHEN-DESUM-P72:322	khas blang yon 'bul bsngo ba bya :	32	khas blang yon bul sngo ba byed 
BO_TZ_DZOGCHEN-DESUM-P72:323	rjes bsdu rgyun spyod nyams bskyang ngo :	32	rjes sdud rgyun spyod nyams skyong ngo 
BO_TZ_DZOGCHEN-DESUM-P72:324	bde gshegs sgrub pa bka' brgyad kyi :	32	bde gshegs sgrub ba bka brgyad kyi 
BO_TZ_DZOGCHEN-DESUM-P72:325	dbang bskur man ngag bzhin bskur ba :	32	dbang skur man ngag bzhin skur ba 
BO_TZ_DZOGCHEN-DESUM-P72:326	ji bzhin bgyis nas phyi rabs la :	32	ji bzhin bgyid nas phyi rabs la 
BO_TZ_DZOGCHEN-DESUM-P72:327	phan phyir pad+ma shel phug tu :	32	phan phyir pad+ma shel bugs tu 
BO_TZ_DZOGCHEN-DESUM-P72:328	sbas pa las can dang 'phrad shog :	32	sbed ba las can dang phrad shog 
BO_TZ_DZOGCHEN-DESUM-P72:329	sa ma ya rgya rgya :	32	sa ma ya rgya rgya 
BO_TZ_DZOGCHEN-DESUM-P72:330	gter rgya : sbas rgya :	33	gter rgya sbed rgya 
BO_TZ_DZOGCHEN-DESUM-P72:331	kha tham: gu h+ya :lha sras mu rub btshan po'i rnam par 'phrul pa sprul pa'i gter chen mchog gyur gling pas gnas mchog nam mkha' mdzod nas spyan drangs pa'i kha byang dang / 'phral du slob dpon rin po che yab yum gyis dngos su gsungs pa'i yang byang snying byang la brten nas me 'brug rgyal zla ba'i dkar phyogs kyi rgyal ba dang po'i nyi shar la /	33	kha tham: gu h+ya :lha sras mu rub btshan po rnam ba phrul ba sprul ba gter chen mchog gyur gling ba gnas mchog nam mkha mdzod nas spyan drangs ba kha byang dang phral du slob dpon rin po che yab yum gyis dngos su gsungs ba yang byang snying byang la rten nas me brug rgyal zla ba dkar phyogs kyi rgyal ba dang po nyi char la 
BO_TZ_DZOGCHEN-DESUM-P72:332	bod chen po'i sa'i thig le sde dge chos rgyal chen po'i pho brang gi shar gyi phyogs kyi yul ljongs smad shod dzam nang phu o rgyan rin po che'i sgrub gnas pad+ma shel phug gi gnam mthongs nas bdag cag 'dus pa nyer lnga tsham gyis mthong bar dngos	33	bod chen po sa thig le sde dge chos rgyal chen po pho brang gi char gyi phyogs kyi yul ljongs smad shod dzam nang phu o rgyan rin po che sgrub gnas pad+ma shel bugs gi gnam mthongs nas bdag cag du ba nyer lnga tsham gyis mthong ba dngos 
BO_TZ_DZOGCHEN-DESUM-P72:333	su spyan drangs shing /	33	su spyan drangs shing 
BO_TZ_DZOGCHEN-DESUM-P72:334	de 'phral skal ldan gyi 'dus pa nyis brgya brgal bar byin rlabs bstshal te thams cad kyis yid ches rtshod bral du gyur pa'i mchong shog smug po'i ngos las phab rim bzhin /	33	de phral skal ldan gyi du ba nyis brgya rgol ba byin rlabs bstshal te thams cad kyis yid ches rtshod bral du gyur ba mchong shog smug po ngos las bebs rim bzhin 
BO_TZ_DZOGCHEN-DESUM-P72:335	bya bral ba 'jam dbyangs mkhyen brtshe'i dbang po kun dga' bstan pa'i rgyal mtshhan dpal bzang pos dag par bris pa'i dge bas bstan 'dzin mchog rnams zhabs pad bskal brgyar brtan zhing /	33	byed bral ba jam dbyangs mkhyen brtshe dbang po kun dga ston ba rgyal mtshhan dpal bzang pos dag ba bri ba dge ba ston dzin mchog rnams zhabs pad bskal brgyar brtan zhing 
BO_TZ_DZOGCHEN-DESUM-P72:336	zab gter gyi bstan pa phyogs dus gnas skabs thams cad du dar zhing rgyas la yun ring du gnas par gyur cig	33	zab gter gyi ston ba phyogs dus gnas skabs thams cad du dar zhing rgya la yun ring du gnas ba gyur cig 
BO_TZ_DZOGCHEN-DESUM-P72:337	/sarba mang+ga lam/// /	33	mang+ga 
