segmentnr	original	folio	stemmed
BO_TZ_TSASUM-OSEL-NYINGTHIG-P9-C:2000	d+ha ti ma ma karma shi g+h+ram ka ra ye ma ra se na pra mar+d+ha na ye hu~m phata?:	200	d+ha ti ma ma karma chi g+h+ram ka ra ye ma ra se na pra mar+d+ha na ye hu~m phata?: 
BO_TZ_TSASUM-OSEL-NYINGTHIG-P9-C:2001	de ltar gtad pa'i phur pa phyogs bcur sgril zhing gzir bas khams gsum gyi bdud tshhogs tshhar bcad cing bya ba nan tur gyi phrin las /	200	de ltar gtod ba phur ba phyogs jur sgril zhing gzir ba khams gsum gyi bdud tshhogs tshhar gcod cing byed ba nan tur gyi phrin las 
BO_TZ_TSASUM-OSEL-NYINGTHIG-P9-C:2002	srung ba rdo rje'i rdzong mkhar /	200	srung ba rdo rje rdzong mkhar 
BO_TZ_TSASUM-OSEL-NYINGTHIG-P9-C:2003	zlog pa drag po'i dmag dpung /	200	zlog ba drag po dmag dpung 
BO_TZ_TSASUM-OSEL-NYINGTHIG-P9-C:2004	gdab pa las kyi spu gri /	200	gdab ba las kyi spu gri 
BO_TZ_TSASUM-OSEL-NYINGTHIG-P9-C:2005	mtha' sdud gnan sreg 'phang gsum gyi mtshhon /	200	mtha sdud gnon sreg phen gsum gyi mtshhon 
BO_TZ_TSASUM-OSEL-NYINGTHIG-P9-C:2006	drag shul gyi las chen bcu gnyis log rdugs 'byams gsum gyi skyon dang bral bas phyi nang gsang ba'i dgra gsum bsad /	200	drag shul gyi las chen chu gnyis log rdugs byam gsum gyi skyon dang bral ba phyi nang gsang ba dgra gsum bsad 
BO_TZ_TSASUM-OSEL-NYINGTHIG-P9-C:2007	bdud bzhi bcom /	200	bdud bzhi joms 
BO_TZ_TSASUM-OSEL-NYINGTHIG-P9-C:2008	'phrang gsum las brgal nas dpal khrag 'thung chen po 'jigs mdzad rdo rje gzhon nu dang dgongs spyod mnyam par mos mdzod /	200	phrangs gsum las rgol nas dpal khrag thung chen po jigs mdzad rdo rje gzhon nu dang dgongs spyod mnyam ba mos mdzod 
BO_TZ_TSASUM-OSEL-NYINGTHIG-P9-C:2009	de dag gis /	200	de dag gis 
BO_TZ_TSASUM-OSEL-NYINGTHIG-P9-C:2010	thugs kyi phur gcig la brten nas :	201	thugs kyi phur gcig la rten nas 
BO_TZ_TSASUM-OSEL-NYINGTHIG-P9-C:2011	ting nge 'dzin gyi dbang bskur ba :	201	ting nge dzin gyi dbang skur ba 
BO_TZ_TSASUM-OSEL-NYINGTHIG-P9-C:2012	rgyud kyi khong snying phyung pa ste :	201	brgyud kyi khong snying byin ba ste 
BO_TZ_TSASUM-OSEL-NYINGTHIG-P9-C:2013	snod ldan bu la gtad do rgya :	201	snod ldan bu la gtod do rgya 
BO_TZ_TSASUM-OSEL-NYINGTHIG-P9-C:2014	zhes spros pa'i yan lag bsdus kyang yang gsang thugs kyi phur gcig la brten pa'i snying po don gyi dbang bzhi mtha' rten dang bcas pa yongs su rdzogs pa'i zab khyad can /	201	zhes spros ba yan lag sdud kyang yang gsang thugs kyi phur gcig la rten ba snying po don gyi dbang bzhi mtha rten dang cha ba yongs su rdzogs ba zab khyad can 
BO_TZ_TSASUM-OSEL-NYINGTHIG-P9-C:2015	sngon chad rgya cher ma bstan pa'i zab gsang da ki'i thugs tig byin rlabs don gyi brgyud pa ma nyams pa'i dbang gi rim pa legs par grub pa lags pas sogs mtshhams sbyor dang bcas dam tshhig khas blang /	201	sngon chad rgya cher ma ston ba zab gsang da ki thugs tig byin rlabs don gyi brgyud ba ma nyams ba dbang gi rim ba legs ba grub ba lags ba sogs mtshhams sbyor dang cha dam tshhig khas blang 
BO_TZ_TSASUM-OSEL-NYINGTHIG-P9-C:2016	gtang rag lus 'bul dge bsngo rnams dang / tshhogs la rol zhing lhag ma gtong ba sogs phrin las rjes kyi rim pa mthar chags su bya'o //	201	gtong rag lus bul dge sngo rnams dang tshhogs la rol zhing lhag ma gtong ba sogs phrin las rjes kyi rim ba mthar chags su byed 
BO_TZ_TSASUM-OSEL-NYINGTHIG-P9-C:2017	'jigs bral mkhyen brtshe dgyes pa'i gar //	201	jigs bral mkhyen brtshe dgyes ba gar 
BO_TZ_TSASUM-OSEL-NYINGTHIG-P9-C:2018	stobs bcu'i 'od zer stong 'bar ba //	201	stobs chu d zer stong bar ba 
BO_TZ_TSASUM-OSEL-NYINGTHIG-P9-C:2019	phyogs las rnam rgyal bkra shis kyi //	201	phyogs las rnam rgyal bkra shis kyi 
BO_TZ_TSASUM-OSEL-NYINGTHIG-P9-C:2020	bstan 'gro'i dpal 'byor rgyas gyur cig	202	ston gro dpal byor rgya gyur cig 
BO_TZ_TSASUM-OSEL-NYINGTHIG-P9-C:2021	/rtsha gsum 'od gsal snying tig gi sgos bka' yi dam phrin las phur pa 'dus pa'i dril sgrub kyi dbang gi rim pa phrin las rgyan gyi rol mo le'u tshhan bco brgyad pa phrin las drag po rtshal gyis sbyar pa ste /	202	gsum d gsal snying tig gi sgos bka yi dam phrin las phur ba du ba dril sgrub kyi dbang gi rim ba phrin las rgyan gyi rol mo leu tshhan chos brgyad ba phrin las drag po rtshal gyis sbyor ba ste 
BO_TZ_TSASUM-OSEL-NYINGTHIG-P9-C:2022	dngos grub kyi rtsha ba yi dam gyi skor gang byon rdzogs so ///	202	dngos grub kyi rtsha ba yi dam gyi skor gang byon rdzogs so 
BO_TZ_TSASUM-OSEL-NYINGTHIG-P9-C:2023	/  @#// gnyis pa rtsha gsum 'od gsal snying tig gi phrin las kyi rtsha ba mkha' 'gro'i sgrub skor la /	202	gnyis ba rtsha gsum d gsal snying tig gi phrin las kyi rtsha ba mkha gro sgrub skor la 
BO_TZ_TSASUM-OSEL-NYINGTHIG-P9-C:2024	rigs lnga mkha' 'gro spyi dang bye brag gi sgrub thabs dbang las tshhogs bcas rgya cher yod pa'i rtsha tho rje bla ma thams cad mkhyen pa'i phyag bris dngos mjal ba'i skal bzang thob kyang /	202	rigs lnga mkha gro spyi dang bye brag gi sgrub thabs dbang las tshhogs cha rgya cher yod ba rtsha tho rje bla ma thams cad mkhyen ba phyag bri dngos mjal ba skal bzang thob kyang 
BO_TZ_TSASUM-OSEL-NYINGTHIG-P9-C:2025	phag mo dkar mo tsham las gzhan gtan la ma phab par mngon la /	202	phag mo dkar mo tsham las gzhan gtan la ma bebs ba mngon la 
BO_TZ_TSASUM-OSEL-NYINGTHIG-P9-C:2026	de la mkhas grub kyi rgyal po 'jam mgon rnam gnyis kyis ljags sgrig bzhugs bzhin pa dang /    tshhe dbang chog sgrig dil mkhyen rin po che'i mdzad pa yang yod /	202	de la mkhas grub kyi rgyal po jam mgon rnam gnyis kyis ljags sgrig bzhugs bzhin ba dang tshhe dbang chog sgrig dil mkhyen rin po che mdzad ba yang yod 
BO_TZ_TSASUM-OSEL-NYINGTHIG-P9-C:2027	gzhan yon tan bdud rtshi bde chen snying po dang / phrin las phur pa 'dus pa'i dril sgrub ma ha'i sgom khog ltar byon pa gnyis dbu gzhag tsham las rdzogs par ma phab //	202	gzhan yon tan bdud rtshi bde chen snying po dang phrin las phur ba du ba dril sgrub ma ha sgom khog ltar byon ba gnyis dbu jog tsham las rdzogs ba ma bebs 
BO_TZ_TSASUM-OSEL-NYINGTHIG-P9-C:2028	! //gsum pa bka' srung gsol mchod rdo rje'i drwa ba la rjes gnang srog gtad sogs dmigs bsal med pas da lta bdag cag gi spyod yul du gyur pa chos bka' de tsham gyis rdzogs par grub pa'o ///	202	ba bka srung gsol mchod rdo rje drwa ba la rjes gnang srog gtod sogs dmigs bsal med ba da lta bdag cag gi spyod yul du gyur ba chos bka de tsham gyis rdzogs ba grub ba 
BO_TZ_TSASUM-OSEL-NYINGTHIG-P9-C:2029	/theg mchog ston pa'i thugs bskyed skya rengs dang // skal bzang gdul bya'i smon lam rta bdun shugs //	202	mchog ston ba thugs skyed skya rengs dang skal bzang gdul byed smon lam rta bdun shugs 
BO_TZ_TSASUM-OSEL-NYINGTHIG-P9-C:2030	nang 'dzoms bka' bab rin chen bdun gyi nyi //	203	nang dzoms bka bab rin chen bdun gyi nyi 
BO_TZ_TSASUM-OSEL-NYINGTHIG-P9-C:2031	mi mjed zhing gi rgyan du mdzes par shar //	203	mi mjed zhing gi rgyan du mdzes ba char 
BO_TZ_TSASUM-OSEL-NYINGTHIG-P9-C:2032	rgya che'i bka' dang zab gter bdud rtshi'i rlabs //	203	rgya che bka dang zab gter bdud rtshi rlabs 
BO_TZ_TSASUM-OSEL-NYINGTHIG-P9-C:2033	smin grol bskyed rdzogs gdams pa'i ro nus can //	203	smin grol skyed rdzogs doms ba ro nus can 
BO_TZ_TSASUM-OSEL-NYINGTHIG-P9-C:2034	gcig las gcig mtshhar 'khor bsgyur bang mdzod bzhin //	203	gcig las gcig mtshhar khor sgyur bang mdzod bzhin 
BO_TZ_TSASUM-OSEL-NYINGTHIG-P9-C:2035	mngon sum spyod pa sngon smon bzang po'i mthu //	203	mngon sum spyod ba sngon smon bzang po mthu 
BO_TZ_TSASUM-OSEL-NYINGTHIG-P9-C:2036	gzur gnas blo yi rin chen mig yangs shing //	203	gzur gnas blo yi rin chen mig yangs shing 
BO_TZ_TSASUM-OSEL-NYINGTHIG-P9-C:2037	'chad rtshom sgrub pa'i gtong ba'i phyag yangs pa'i //	203	chad rtshom sgrub ba gtong ba phyag yangs ba 
BO_TZ_TSASUM-OSEL-NYINGTHIG-P9-C:2038	blo ldan mchis na theg mchog chos kyi khab //	203	blo ldan mchis na theg mchog chos kyi khab 
BO_TZ_TSASUM-OSEL-NYINGTHIG-P9-C:2039	mel tshhe bgyid la mi brel su zhig mchis //	203	mel tshhe bgyid la mi brel su jig mchis 
BO_TZ_TSASUM-OSEL-NYINGTHIG-P9-C:2040	bsags pa rgya che pha yi nor skal mchog	204	bsags ba rgya che pha yi nor skal mchog 
BO_TZ_TSASUM-OSEL-NYINGTHIG-P9-C:2041	/rjes 'jug bu la brtshe bas sbyin pa 'di //	204	jug bu la brtshe ba sbyin ba di 
BO_TZ_TSASUM-OSEL-NYINGTHIG-P9-C:2042	rang gar bor na de las khrel 'os su //	204	rang gar bor na de las khrel s su 
BO_TZ_TSASUM-OSEL-NYINGTHIG-P9-C:2043	de tshhul shes pas rtag tu brtshon pa legs //	204	de tshhul shes ba rtag tu brtshon ba legs 
BO_TZ_TSASUM-OSEL-NYINGTHIG-P9-C:2044	gsag srung brlag pa'i sdug bsngal khur brtshegs shing //	204	gsag srung brlag ba sdug sngal khur brtshegs shing 
BO_TZ_TSASUM-OSEL-NYINGTHIG-P9-C:2045	phung khrol gdengs kas g.yengs ba'i mdzod phal cher //	204	phung khrol gdeng kas g.yengs ba mdzod phal cher 
BO_TZ_TSASUM-OSEL-NYINGTHIG-P9-C:2046	dgra sdes brlags kyang chos kyi gsang mdzod ni //	204	dgra sdes brlags kyang chos kyi gsang mdzod ni 
BO_TZ_TSASUM-OSEL-NYINGTHIG-P9-C:2047	'grib med bdag gi dpal du chas la gzigs //	204	grib med bdag gi dpal du cha la gzigs 
BO_TZ_TSASUM-OSEL-NYINGTHIG-P9-C:2048	'di ni skye 'chi'i 'pho skyas kyis thebs kyang //	204	di ni skye chi pho skya kyis thebs kyang 
BO_TZ_TSASUM-OSEL-NYINGTHIG-P9-C:2049	phyi mar bcol ba'i nor la rang dbang du //	204	phyi mar chol ba nor la rang dbang du 
BO_TZ_TSASUM-OSEL-NYINGTHIG-P9-C:2050	'di bas lhag par len zhing 'dzin spel gyi //	205	di ba lhag ba len zhing dzin spel gyi 
BO_TZ_TSASUM-OSEL-NYINGTHIG-P9-C:2051	spobs pa'i mgo 'phang bstod la som nyi ci //	205	spobs ba mgo phen bstod la som nyi ci 
BO_TZ_TSASUM-OSEL-NYINGTHIG-P9-C:2052	mthing skya mig gi bung ba gting du lhung //	205	mthing skya mig gi bung ba gting du lhung 
BO_TZ_TSASUM-OSEL-NYINGTHIG-P9-C:2053	'khyogs pa'i sor mo sga shing ltar gyur kyang //	205	khyogs ba sor mo sga shing ltar gyur kyang 
BO_TZ_TSASUM-OSEL-NYINGTHIG-P9-C:2054	legs bshad bzang gos 'chi khar tshhems drub 'di //	205	legs chad bzang gos chi khar tshhems drub di 
BO_TZ_TSASUM-OSEL-NYINGTHIG-P9-C:2055	chos sras na tshhod gzhon la skyes su 'bul //	205	chos sras na tshhod gzhon la skye su bul 
BO_TZ_TSASUM-OSEL-NYINGTHIG-P9-C:2056	gser gyi rgya phibs mdzes pa'i tshhon ris can //	205	gser gyi rgya phibs mdzes ba tshhon ris can 
BO_TZ_TSASUM-OSEL-NYINGTHIG-P9-C:2057	rin chen dar zab mchod rdzas kyis g.yogs pa'i //	205	rin chen dar zab mchod rdzas kyis g.yogs ba 
BO_TZ_TSASUM-OSEL-NYINGTHIG-P9-C:2058	gtshug lag bshig kyang snga 'gyur dbang chu bzhi //	205	gtshug lag jig kyang snga gyur dbang chu bzhi 
BO_TZ_TSASUM-OSEL-NYINGTHIG-P9-C:2059	slar yang 'phags yul chas 'di bdag kyang spro //	205	slar yang phag yul cha di bdag kyang spro 
BO_TZ_TSASUM-OSEL-NYINGTHIG-P9-C:2060	rig 'dzin grub pa'i nu zhos gsos pa yi //	206	rig dzin grub ba nu zhos gsos ba yi 
BO_TZ_TSASUM-OSEL-NYINGTHIG-P9-C:2061	seng phrug bdag kyang theg mchog gangs ri'i spor //	206	seng phrug bdag kyang theg mchog gangs ri spor 
BO_TZ_TSASUM-OSEL-NYINGTHIG-P9-C:2062	dga' bas rtshen pa'i zlos gar 'di yin pas //	206	dga ba rtshen ba zlos gar di yin ba 
BO_TZ_TSASUM-OSEL-NYINGTHIG-P9-C:2063	mkhas grub bye bas byams brtshes gzigs mdzod kye //	206	mkhas grub bye ba byams brtshes gzigs mdzod kye 
BO_TZ_TSASUM-OSEL-NYINGTHIG-P9-C:2064	g.yon can grogs ldan 'du 'dzi log 'tshhos g.yengs //	206	g.yon can grogs ldan du dzi log tshhos g.yengs 
BO_TZ_TSASUM-OSEL-NYINGTHIG-P9-C:2065	bskyed rdzogs gdeng bral ltar snang chos kyis 'tshho //	206	skyed rdzogs gdeng bral ltar snang chos kyis tshho 
BO_TZ_TSASUM-OSEL-NYINGTHIG-P9-C:2066	sha chang khyim gyi grong gseb sngags rgan gyi //	206	sha chang khyim gyi grong gseb sngags rgan gyi 
BO_TZ_TSASUM-OSEL-NYINGTHIG-P9-C:2067	'dam las ngo mtshhar pad+ma'i 'dzum 'di byung //	206	dam las ngo mtshhar pad+ma dzum di byung 
BO_TZ_TSASUM-OSEL-NYINGTHIG-P9-C:2068	legs byas gang mchis dam pa'i bung ba yis //	206	legs byed gang mchis dam ba bung ba yis 
BO_TZ_TSASUM-OSEL-NYINGTHIG-P9-C:2069	dgyes par bzhes la srid dang ngan song gi	206	dgyes ba bzhes la srid dang ngan gro gi 
BO_TZ_TSASUM-OSEL-NYINGTHIG-P9-C:2070	/g.yang sar phyogs pa bdag gi co to nas //	207	sar phyogs ba bdag gi co to nas 
BO_TZ_TSASUM-OSEL-NYINGTHIG-P9-C:2071	bzung ste bde chen gling du 'khrid mdzad gsol //	207	bzung ste bde chen gling du khrid mdzad gsol 
BO_TZ_TSASUM-OSEL-NYINGTHIG-P9-C:2072	de skad gangs can bod kyi shar phyogs char //	207	de skad gangs can bod kyi char phyogs char 
BO_TZ_TSASUM-OSEL-NYINGTHIG-P9-C:2073	mdo khams dam chos bdud rtshi'i dga' ston la //	207	mdo khams dam chos bdud rtshi dga ston la 
BO_TZ_TSASUM-OSEL-NYINGTHIG-P9-C:2074	ci dgar rol pa'i skal pa mi dman pa //	207	ci dgar rol ba skal ba mi dman ba 
BO_TZ_TSASUM-OSEL-NYINGTHIG-P9-C:2075	mkhyen brtshe'i 'od zer bung bas bstan nas song //	207	mkhyen brtshe d zer bung ba ston nas gro 
BO_TZ_TSASUM-OSEL-NYINGTHIG-P9-C:2076	yab gcig bla ma'i bzhed pa bdag gis skong //	207	yab gcig bla ma bzhed ba bdag gis skong 
BO_TZ_TSASUM-OSEL-NYINGTHIG-P9-C:2077	yum gcig mkha' 'gro'i gsang mdzod dad pas spyod //	207	yum gcig mkha gro gsang mdzod dad ba spyod 
BO_TZ_TSASUM-OSEL-NYINGTHIG-P9-C:2078	las gcig byas pa don ldan 'di gyur nas //	207	las gcig byed ba don ldan di gyur nas 
BO_TZ_TSASUM-OSEL-NYINGTHIG-P9-C:2079	phyam gcig sku gsum gling du rtshen par shog	207	phyam gcig sku gsum gling du rtshen ba shog 
BO_TZ_TSASUM-OSEL-NYINGTHIG-P9-C:2080	/nam zhig d+hu ma tha la'i grong khyer na //	208	jig d+hu ma tha la grong khyer na 
BO_TZ_TSASUM-OSEL-NYINGTHIG-P9-C:2081	mkha' spyod mig yangs 'dzum pa'i pho nya bcas //	208	mkha spyod mig yangs dzum ba pho nya cha 
BO_TZ_TSASUM-OSEL-NYINGTHIG-P9-C:2082	chos nyid rang sgra'i rgyud kyi gling bu len //	208	chos nyid rang sgra brgyud kyi gling bu len 
BO_TZ_TSASUM-OSEL-NYINGTHIG-P9-C:2083	zab don 'gram chang 'thung la mi ngal shog	208	zab don grams chang thung la mi ngal shog 
BO_TZ_TSASUM-OSEL-NYINGTHIG-P9-C:2084	/sangs rgyas gnyis pa'i thugs bskyed dpung tshhogs bzhi'i //	208	rgya gnyis ba thugs skyed dpung tshhogs bzhi 
BO_TZ_TSASUM-OSEL-NYINGTHIG-P9-C:2085	dpal la dbang bsgyur drag shul rdo rje'i char //	208	dpal la dbang sgyur drag shul rdo rje char 
BO_TZ_TSASUM-OSEL-NYINGTHIG-P9-C:2086	nag phyogs rdzong la 'beb pa'i dmag dpon du //	208	nag phyogs rdzong la beb ba dmag dpon du 
BO_TZ_TSASUM-OSEL-NYINGTHIG-P9-C:2087	bdag gyur yid srubs rgol ngan mthar byed shog	208	bdag gyur yid srubs rgol ngan mthar byed shog 
BO_TZ_TSASUM-OSEL-NYINGTHIG-P9-C:2088	/'phags pa'i cho rigs gtshang zhing thos bsam sgom //	208	ba cho rigs gtshang zhing thos bsam sgom 
BO_TZ_TSASUM-OSEL-NYINGTHIG-P9-C:2089	lang tshho'i me tog bzhad la 'di 'bul bas //	208	lang tshho me tog bzhad la di bul ba 
BO_TZ_TSASUM-OSEL-NYINGTHIG-P9-C:2090	bshad sgrub las kyi 'khor lo'i zlos gar gyis //	209	chad sgrub las kyi khor lo zlos gar gyis 
BO_TZ_TSASUM-OSEL-NYINGTHIG-P9-C:2091	thub bstan kun dga'i skyed tshhal mdzes par mdzod //	209	thub ston kun dga skyed tshhal mdzes ba mdzod 
BO_TZ_TSASUM-OSEL-NYINGTHIG-P9-C:2092	bdag kyang thos pa'i mdzod bsags bsam pas spel //	209	bdag kyang thos ba mdzod bsags bsam ba spel 
BO_TZ_TSASUM-OSEL-NYINGTHIG-P9-C:2093	sgom stobs gnad kyi nyams len srog gi zungs //	209	sgom stobs gnad kyi nyams len srog gi zungs 
BO_TZ_TSASUM-OSEL-NYINGTHIG-P9-C:2094	yid 'ong dben pa'i ngogs nas smin gyur te //	209	yid ng dben ba ngogs nas smin gyur te 
BO_TZ_TSASUM-OSEL-NYINGTHIG-P9-C:2095	thub pa'i bstan la bya ba byed nus shog	209	thub ba ston la byed ba byed nus shog 
BO_TZ_TSASUM-OSEL-NYINGTHIG-P9-C:2096	/bkra shis gang zhig rtsha gsum dgyes pa'i nyin mor byed //	209	shis gang jig rtsha gsum dgyes ba nyin mor byed 
BO_TZ_TSASUM-OSEL-NYINGTHIG-P9-C:2097	byin rlabs snang ba 'bum gyis sgeg pa'i 'od phreng gis //	209	byin rlabs snang ba bum gyis sgeg ba d phreng gis 
BO_TZ_TSASUM-OSEL-NYINGTHIG-P9-C:2098	dngos grub pad+mo'i 'dzum g.yo phrin las dri bsung khyab //	209	dngos grub pad+mo dzum g.yo phrin las dri bsung khyab 
BO_TZ_TSASUM-OSEL-NYINGTHIG-P9-C:2099	phan bde'i bung bas zlos gar brtshe bas mdzes gyur cig	209	phan bde bung ba zlos gar brtshe ba mdzes gyur cig 
BO_TZ_TSASUM-OSEL-NYINGTHIG-P9-C:2100	/ces shar mdo khams sde dge'i chos rgyal chen po'i mnga' ris kyi shar phyogs shri na len+d+ra gnyis pa rdzong sar bkra	210	char mdo khams sde dge chos rgyal chen po mnga ris kyi char phyogs shri na len+d+ra gnyis ba rdzong sar bkra 
BO_TZ_TSASUM-OSEL-NYINGTHIG-P9-C:2101	shis lha rtshe'i gzims spyil 'og min gnyis pa sprin gyi skyed tshhal bkra shis 'chi med grub pa'i dga' tshhal nas /	210	shis lha rtshe gzims spyil g min gnyis ba sprin gyi skyed tshhal bkra shis chi med grub ba dga tshhal nas 
BO_TZ_TSASUM-OSEL-NYINGTHIG-P9-C:2102	thub bstan yongs rdzogs kyi mnga' bdag khyab bdag rdo rje sems dngos 7'jam dbyangs chos kyi blo gros mchog gi zhal snga nas zab rgyas chos kyi 'khor lo'i dge mtshhan nyi zla khor yug tu 'char ba'i skabs /	210	thub ston yongs rdzogs kyi mnga bdag khyab bdag rdo rje sems dngos 7jam dbyangs chos kyi blo gros mchog gi zhal snga nas zab rgya chos kyi khor lo dge mtshhan nyi zla khor yug tu char ba skabs 
BO_TZ_TSASUM-OSEL-NYINGTHIG-P9-C:2103	thun mong ma yin pa'i zab chos 'di dag gi smin grol gyis bdag kyang rjes su bzung ba'i skal bzang thob pa'i skabs 'di bzhin zhabs tog srid zhu spel 'os kyi bka' phun sum tshhogs pa'i rten dang bcas dgyes brtshes tshhangs gnas kyi rgyan du bstshal ba dang	210	thun mong ma yin ba zab chos di dag gi smin grol gyis bdag kyang rjes su bzung ba skal bzang thob ba skabs di bzhin zhabs tog srid ju spel s kyi bka phun sum tshhogs ba rten dang cha dgyes brtshes tshhangs gnas kyi rgyan du bstshal ba dang 
BO_TZ_TSASUM-OSEL-NYINGTHIG-P9-C:2104	chabs cig /gter chen rol pa'i rdo rje'i mchog sprul dwags rnying gi bstan pa'i snang byed chen po karma dri med 'od zer zhabs kyis kyang smin grol bdud rtshi lhan cig bzhes par rje bla ma'i bka' bzhin myur du sgrub 'os pa'i bskul ma rten dang bcas yang yang bstshal	210	chabs cig chen rol ba rdo rje mchog sprul dwags rnying gi ston ba snang byed chen po karma dri med d zer zhabs kyis kyang smin grol bdud rtshi lhan cig bzhes ba rje bla ma bka bzhin myur du sgrub s ba skul ma rten dang cha yang yang bstshal 
BO_TZ_TSASUM-OSEL-NYINGTHIG-P9-C:2105	pa dang / rang nyid kyis kyang dad spros bsnyen sgrub kyi zhor la zin tho kha shas btab kyang /	210	ba dang rang nyid kyis kyang dad spros snyen sgrub kyi zhor la zin tho kha shas debs kyang 
BO_TZ_TSASUM-OSEL-NYINGTHIG-P9-C:2106	mtha' mi'i log spyod kyis khams bod thams cad rnga thog gi sran ma bzhin nyams nyes su gyur pas zab chos 'di nyid kyi rtsha ba'i gzhung yang dbyings kyi mkha' 'gro'i phyag mtshhan du bzhes pa la nye bar rtshom skabs /	210	mtha mi log spyod kyis khams bod thams cad rnga thogs gi sran ma bzhin nyams nyes su gyur ba zab chos di nyid kyi rtsha ba gzhung yang dbyings kyi mkha gro phyag mtshhan du bzhes ba la nye ba rtshom skabs 
BO_TZ_TSASUM-OSEL-NYINGTHIG-P9-C:2107	rgyal ba'i phrin las kyi re kha bsub tu med pas rje bla ma rin po che'i phyag dpe 'phags yul du gdan 'dren zhu thub pa'i bka' drin las rim gyis dpe rgyun 'phel ba la /	210	rgyal ba phrin las kyi re kha bsub tu med ba rje bla ma rin po che phyag dpe phag yul du gdan bgrang ju thub ba bka drin las rim gyis dpe rgyun phel ba la 
BO_TZ_TSASUM-OSEL-NYINGTHIG-P9-C:2108	theg mchog snying po'i bstan dang bstan 'dzin la mchog tu gus pa byang gnam mtshho'i do skya mchog sprul 'gyur med pad+ma dri med nas rtsha dpe zhal bshus kyi glegs bam dbus 'gyur rdo rje gdan gyi gtshug lag khang nas gnang ba'i rten 'brel gyis mtshhams sbyar te	210	theg mchog snying po ston dang ston dzin la mchog tu gus ba byang gnam mtshho do skya mchog sprul gyur med pad+ma dri med nas rtsha dpe zhal bshus kyi glegs bam dbus gyur rdo rje gdan gyi gtshug lag khang nas gnang ba rten brel gyis mtshhams sbyor te 
BO_TZ_TSASUM-OSEL-NYINGTHIG-P9-C:2109	/ shar mdo khams sde dge'i rgyal khams kyi mu to ba 'du shes gsum gyi g.yar dam 'chang bas grong gseb tu 'khyams pa'i rnying sngags rgan po snyan la brjid pa'i ming mang po'i khur gyis non pa'i rmongs brtul gyi zog pos /	210	char mdo khams sde dge rgyal khams kyi mu to ba du shes gsum gyi g.yar dam chang ba grong gseb tu khyam ba rnying sngags rgan po snyan la brjid ba ming mang po khur gyis non ba rmongs brtul gyi zog pos 
BO_TZ_TSASUM-OSEL-NYINGTHIG-P9-C:2110	rgya gar gyi yul gru mtha' dbus kun tu rgyu ba'i skabs su rang blos dpog tshhod ji ltar nus pa'i zhabs tog zhus pa la /	211	rgya gar gyi yul gru mtha dbus kun tu rgyu ba skabs su rang blos dpog tshhod ji ltar nus ba zhabs tog zhus ba la 
BO_TZ_TSASUM-OSEL-NYINGTHIG-P9-C:2111	rdul bral chos spyan mnga' zhing nges don gyi bstan pa rin po che thugs la bcags pa'i gzur gnas mkhas grub rnams kyis dpyad zhus dang / smin grol gyi srog rtsha mi chad pa'i g.yar dam bzhes grub snying nas gsol ba 'debs pa dang / yi ge'i mthun sbyor byang phyogs reb kong rig pa'i 'byung gnas kyi sngags ban 'jigs med skal bzang bde chen grub pa'i rdo rjes dad gus kyi brtshon pas bgyis pa'i ngal ba'i khur 'dis kyang /	211	rdul bral chos spyan mnga zhing nges don gyi ston ba rin po che thugs la jags ba gzur gnas mkhas grub rnams kyis dpyod zhus dang smin grol gyi srog rtsha mi chad ba g.yar dam bzhes grub snying nas gsol ba debs ba dang yi ge mthun sbyor byang phyogs reb kong rig ba byung gnas kyi sngags ban jigs med skal bzang bde chen grub ba rdo rjes dad gus kyi brtshon ba bgyid ba ngal ba khur dis kyang 
BO_TZ_TSASUM-OSEL-NYINGTHIG-P9-C:2112	bstan 'gro'i dge mtshhan nyin byed phyogs kyi tha gru kun tu 'phel rgyas brtan pa'i rgyur 'gyur bar bla ma rgyal ba sras dang bcas pas byin gyis brlab par mdzad du gsol /	211	ston gro dge mtshhan nyin byed phyogs kyi tha gru kun tu phel rgya brtan ba rgyur gyur ba bla ma rgyal ba sras dang cha ba byin gyis brlab ba mdzad du gsol 
BO_TZ_TSASUM-OSEL-NYINGTHIG-P9-C:2113	sarba da su shri ye b+ha wan+tu ///	211	sarba da su shri ye b+ha wan+tu 
BO_TZ_TSASUM-OSEL-NYINGTHIG-P9-C:2114	/'dir gleng bar bya ba ni /	211	gleng ba byed ba ni 
BO_TZ_TSASUM-OSEL-NYINGTHIG-P9-C:2115	'phags yul smin gling gdan sa'i chos 'bangs pa pad bkod sgam po 'am dwags po sprul skur 'bod pa ngos /	211	phag yul smin gling gdan sa chos bang ba pad bkod sgam po mang dwags po sprul skur bod ba ngos 
BO_TZ_TSASUM-OSEL-NYINGTHIG-P9-C:2116	sngon chad rje bla ma'i zhabs gral yun mi thung tsham bcar sdod skabs /	211	sngon chad rje bla ma zhabs gral yun mi thung tsham gcer sdod skabs 
BO_TZ_TSASUM-OSEL-NYINGTHIG-P9-C:2117	rje'i zhal nas khyod zhib cha che zhing cho ga'i rgyus kyang cung zad 'dug pas /	211	rje zhal nas khyod zhib cha che zhing cho ga rgyus kyang cung zad dug ba 
BO_TZ_TSASUM-OSEL-NYINGTHIG-P9-C:2118	ngos kyis bris pa'i yig dpe rnams stan gnas dus gcig tu dpyad bsam mthar phyin pas bri ba'i skabs phal cher ma rnyed cing /	211	ngos kyis bri ba yig dpe rnams stan gnas dus gcig tu dpyod bsam mthar phyin ba bri ba skabs phal cher ma rnyed cing 
BO_TZ_TSASUM-OSEL-NYINGTHIG-P9-C:2119	rnam mang bya ba'i zhor khoms nam byung la bri dgos par gyur pas gtshang dag tu gyur nges kyi blo bde ba zhig med pas /	211	rnam mang byed ba zhor khoms nam byung la bri dgos ba gyur ba gtshang dag tu gyur nges kyi blo bde ba jig med ba 
BO_TZ_TSASUM-OSEL-NYINGTHIG-P9-C:2120	khyod kyis zhib bltas gyis zhes phebs shing /	212	khyod kyis zhib lta gyis zhes phebs shing 
BO_TZ_TSASUM-OSEL-NYINGTHIG-P9-C:2121	de ltar ngos rang	212	de ltar ngos rang 
BO_TZ_TSASUM-OSEL-NYINGTHIG-P9-C:2122	gis kyang zla shas ring rje yi zab gter gnyags phur gyi rigs bdag rdor sems phyi nang gsang ba yang gsang gi sgrub thabs dang dbang gi chog khrigs sogs chos tshhan 'ga' zhig zhib mjal gyis /	212	gis kyang zla shas ring rje yi zab gter gnyeg phur gyi rigs bdag rdar sems phyi nang gsang ba yang gsang gi sgrub thabs dang dbang gi chog khrigs sogs chos tshhan ga jig zhib mjal gyis 
BO_TZ_TSASUM-OSEL-NYINGTHIG-P9-C:2123	sa bcad dang tshhig don snga phyi sogs mthong dang dran tshhad spyan zhus kyis bris bsub mang tsham byung bar /	212	sa gcod dang tshhig don snga phyi sogs mthong dang dran tshhad spyan zhus kyis bri bsub mang tsham byung ba 
BO_TZ_TSASUM-OSEL-NYINGTHIG-P9-C:2124	dad dang mos gus dag snang shin tu che ba'i zhal slob 'gas rje bla ma'i gsung la rang bzos bcos sgyur byed par bsgrags shing /	212	dad dang mos gus dag snang shin tu che ba zhal slob gas rje bla ma gsung la rang bzos chos sgyur byed ba sgrog shing 
BO_TZ_TSASUM-OSEL-NYINGTHIG-P9-C:2125	ngos kyi las don de la gal chen gyis ram 'degs kyang che phra su yang ma byung bas spyir dang / bye brag 'don sgrub kyi bya ba'i zhabs zhu mang dgos dang rang nyid las lhod che ba bcas kyis kyang de skabs de 'drar lus /	212	ngos kyi las don de la gal chen gyis ram degs kyang che phra su yang ma byung ba spyir dang bye brag don sgrub kyi byed ba zhabs ju mang dgos dang rang nyid las lhod che ba cha kyis kyang de skabs de drar lus 
BO_TZ_TSASUM-OSEL-NYINGTHIG-P9-C:2126	da cha 7skyabs rje rab 'byams rin po che dang / rje'i yang srid rin po che /	212	da cha 7skyabs rje rab byam rin po che dang rje yang srid rin po che 
BO_TZ_TSASUM-OSEL-NYINGTHIG-P9-C:2127	khyad par rje'i dngos slob thugs skyed gzhan phan rmad du byung ba pha ran sa'i dge slong dkon mchog bstan 'dzin rnams kyi bka' dang thugs re bzhin /	212	khyad ba rje dngos slob thugs skyed gzhan phan rmad du byung ba pha ran sa dge slong dkon(d) mchog ston dzin rnams kyi bka dang thugs re bzhin 
BO_TZ_TSASUM-OSEL-NYINGTHIG-P9-C:2128	rin chen gter mdzod chen po kha skong snga phyi da lta bar bcas pod chen bdun cu skor 'phrul par zhu dag tha ma'i sri zhu zhib par lo mang ring sgrub skabs /	212	rin chen gter mdzod chen po kha skong snga phyi da lta ba cha pod chen bdun cu skor phrul ba ju dag tha ma sri ju zhib ba lo mang ring sgrub skabs 
BO_TZ_TSASUM-OSEL-NYINGTHIG-P9-C:2129	chos tshhul 'di srid pa ji srid bar der bzhugs dgos par brten /	212	chos tshhul di srid ba ji srid ba der bzhugs dgos ba rten 
BO_TZ_TSASUM-OSEL-NYINGTHIG-P9-C:2130	sngon rje'i spyan sngar zhus dpyad rgyus mnga' lta bu'i rgyu dang / nyid mdzad rnams la zhib dpyad dgos tshhul sngon gsungs kyi rkyen byas nas /	213	sngon rje spyan sngar zhus dpyod rgyus mnga lta bu rgyu dang nyid mdzad rnams la zhib dpyod dgos tshhul sngon gsungs kyi rkyen byed nas 
BO_TZ_TSASUM-OSEL-NYINGTHIG-P9-C:2131	chos tshhul 'di'i gter gzhung phyag bri dngos dus 'gyur skabs sku gdung gtor bshig gis phyir gyar 'phrul par da lta dngos su mjal rgyu yod pa dang / chog sgrig khungs gang la gzigs pa'i dpe sogs la gtug nas dpyad zhus gang nus byas pas sngar bzhin bris bsub mang du gyur pa /	213	chos tshhul di gter gzhung phyag bri dngos dus gyur skabs sku gdung thor jig gis phyir gyar phrul ba da lta dngos su mjal rgyu yod ba dang chog sgrig khungs gang la gzigs ba dpe sogs la gtug nas dpyod zhus gang nus byed ba sngar bzhin bri bsub mang du gyur ba 
BO_TZ_TSASUM-OSEL-NYINGTHIG-P9-C:2132	rang nyid gzhon dus shes bya'i gnas la sbyangs pa gang yang bya ba'i bsod nams dang mthun rkyen ma byung bas ma myong zhing /	213	rang nyid gzhon dus shes byed gnas la sbyong ba gang yang byed ba bsod nams dang mthun rkyen ma byung ba ma myong zhing 
BO_TZ_TSASUM-OSEL-NYINGTHIG-P9-C:2133	bka' 'dri zhu yul kyang yul dus kyi gnas skabs dang mthun rkyen sogs kyis bskal bas ma rnyed pas ma sbyang mu cor smra ba'i ngang tshhul gyis bcos nyes gyur pa ni spyir mthol lo bshags shing /	213	bka bri ju yul kyang yul dus kyi gnas skabs dang mthun rkyen sogs kyis bskal ba ma rnyed ba ma sbyong mu cor smra ba ngang tshhul gyis chos nyes gyur ba ni spyir mthol lo chags shing 
BO_TZ_TSASUM-OSEL-NYINGTHIG-P9-C:2134	rang gis ni tshhig skyon tsham yang med par rnam dag tu spel ba'i 'bad pa chen po'i zhabs zhu bsgrubs par rloms pa yin zhing /	213	rang gis ni tshhig skyon tsham yang med ba rnam dag tu spel ba bad ba chen po zhabs ju sgrub ba rloms ba yin zhing 
BO_TZ_TSASUM-OSEL-NYINGTHIG-P9-C:2135	sems dge ba la nyes pa med par bshad pas dge legs 'phel bar gyur cig	213	sems dge ba la nyes ba med ba chad ba dge legs phel ba gyur cig 
BO_TZ_TSASUM-OSEL-NYINGTHIG-P9-C:2136	/ces byung ba brjod pa 'di tsham byed pos gleng zhing gsol ba yin pas zol stabs 'ol tshhul du khrom gshog gis mi bklag par dpyod ldan do gal can srid na par dpe snga phyi mi mtshhungs pa cung zad yod pa rgyu mtshhan de ltar thugs nges dang	213	byung ba rjod ba di tsham byed pos gleng zhing gsol ba yin ba zol stabs l tshhul du khrom gshog gis mi klog ba dpyod ldan do gal can srid na ba dpe snga phyi mi mtshhungs ba cung zad yod ba rgyu mtshhan de ltar thugs nges dang 
BO_TZ_TSASUM-OSEL-NYINGTHIG-P9-C:2137	thugs dpyad gnang skyong yod pa zhu zhu zhu //	213	thugs dpyod gnang skyong yod ba ju ju ju 
BO_TZ_TSASUM-OSEL-NYINGTHIG-P9-C:2138	mkhyen mkhyen mkhyen ///	213	mkhyen mkhyen mkhyen 
