segmentnr	original	folio	stemmed
BO_TZ_DZOGCHEN-DESUM-P25:0	\u0f01\u0f83: dam chos rdzogs pa chen po sde gsum las :spyi la gces pa rig 'dzin bla ma'i zab dbang bzhugs so :	0	\u0f01\u0f83: dam chos rdzogs ba chen po sde gsum las :spyi la gces ba rig dzin bla ma zab dbang bzhugs so 
BO_TZ_DZOGCHEN-DESUM-P25:1	nyi zla'i rgya can /	0	nyi zla rgya can 
BO_TZ_DZOGCHEN-DESUM-P25:2	sde gsum spyi skor /	0	sde gsum spyi skor 
BO_TZ_DZOGCHEN-DESUM-P25:3	\u0f88\u0f88\u0f88\u0f88\u0f88\u0f88 na mo gu ru shri sim ha :	0	\u0f88\u0f88\u0f88\u0f88\u0f88\u0f88 na mo gu ru shri sim ha 
BO_TZ_DZOGCHEN-DESUM-P25:4	nam mkha'i mthar thug rgyal ba sras dang bcas :	0	nam mkha mthar thug rgyal ba sras dang cha 
BO_TZ_DZOGCHEN-DESUM-P25:5	ma lus gcig tu bsdus pa thugs rje'i gter :	0	ma lus gcig tu sdud ba thugs rje gter 
BO_TZ_DZOGCHEN-DESUM-P25:6	'byung ba'i rgya mtshho yon tan mtha' klas pa :	0	byung ba rgya mtshho yon tan mtha klas ba 
BO_TZ_DZOGCHEN-DESUM-P25:7	rje btshun dpal gyi seng ger gus pas 'dud :	0	rje btshun dpal gyi seng ger gus ba dud 
BO_TZ_DZOGCHEN-DESUM-P25:8	de yi thugs bcud rdzogs chen sde gsum gyi :	0	de yi thugs bcud rdzogs chen sde gsum gyi 
BO_TZ_DZOGCHEN-DESUM-P25:9	spyi la gces pa rtsha ba'i sgrub thabs las :	0	spyi la gces ba rtsha ba sgrub thabs las 
BO_TZ_DZOGCHEN-DESUM-P25:10	zab mo'i dbang gi gdams pa rnam bzhi ste :	1	zab mo dbang gi doms ba rnam bzhi ste 
BO_TZ_DZOGCHEN-DESUM-P25:11	de la sngon du dkyil 'khor bsham pa ni :	1	de la sngon du dkyil khor bsham ba ni 
BO_TZ_DZOGCHEN-DESUM-P25:12	gzhal yas khang pa pad 'dab khri 'u'i khar :	1	jal yas khang ba pad dab khri u khar 
BO_TZ_DZOGCHEN-DESUM-P25:13	bum pa bcud ldan rig ma chas ldan dang : ngo sprod rdzas kyi bye brag sman raka gtor :	1	bum ba bcud ldan rig ma cha ldan dang ngo sprod rdzas kyi bye brag sman raka thor 
BO_TZ_DZOGCHEN-DESUM-P25:14	mchod pa'i tshhogs dang rgyan gyis rnam bkra bya :	1	mchod ba tshhogs dang rgyan gyis rnam bkra byed 
BO_TZ_DZOGCHEN-DESUM-P25:15	sgrub cing tshhogs mchod dbang blangs mdun bskyed la :	1	sgrub cing tshhogs mchod dbang blangs mdun skyed la 
BO_TZ_DZOGCHEN-DESUM-P25:16	ho : rang byung rig pa ye shes lha tshhogs rnams :	1	ho rang byung rig ba ye shes lha tshhogs rnams 
BO_TZ_DZOGCHEN-DESUM-P25:17	thugs rje rmad byung brtshe bas dgongs su gsol :	1	thugs rje rmad byung brtshe ba dgongs su gsol 
BO_TZ_DZOGCHEN-DESUM-P25:18	gsang ba bla na med pa'i dkyil 'khor du :	1	gsang ba bla na med ba dkyil khor du 
BO_TZ_DZOGCHEN-DESUM-P25:19	bdag gi slob ma yang dag 'dzin par mdzod :	1	bdag gi slob ma yang dag dzin ba mdzod 
BO_TZ_DZOGCHEN-DESUM-P25:20	bde chen ye shes bla med 'phel ba dang : grol ba mthar phyin dgongs pas gzung du gsol :	2	bde chen ye shes bla med phel ba dang grol ba mthar phyin dgongs ba gzung du gsol 
BO_TZ_DZOGCHEN-DESUM-P25:21	zhes gsol lha rnams dgyes pa chen po yis :	2	zhes gsol lha rnams dgyes ba chen po yis 
BO_TZ_DZOGCHEN-DESUM-P25:22	de ltar yin na rig pa 'dzin pa gang :	2	de ltar yin na rig ba dzin ba gang 
BO_TZ_DZOGCHEN-DESUM-P25:23	blo chen skal par ldan pa'i slob ma dag :	2	blo chen skal ba ldan ba slob ma dag 
BO_TZ_DZOGCHEN-DESUM-P25:24	bde chen ye shes dkyil 'khor 'dir khrid la :	2	bde chen ye shes dkyil khor dir khrid la 
BO_TZ_DZOGCHEN-DESUM-P25:25	smin cing grol ba bla na med par byos :	2	smin cing grol ba bla na med ba byos 
BO_TZ_DZOGCHEN-DESUM-P25:26	a la la ho :	2	a la la ho 
BO_TZ_DZOGCHEN-DESUM-P25:27	slob ma mdun du dgug cing khrus byas te :	2	slob ma mdun du gugs cing khru byed te 
BO_TZ_DZOGCHEN-DESUM-P25:28	bgegs bskrad srung ba'i skud pa dmar po la :	2	bgegs skrod srung ba skud ba dmar po la 
BO_TZ_DZOGCHEN-DESUM-P25:29	a+o~m ha ha hu~m hu~m hrihhrihphata? phata?:	2	a+o~m ha ha hu~m hu~m hrihhrihphata? phata?: 
BO_TZ_DZOGCHEN-DESUM-P25:30	bsngags pa gdags shing srung ba'i 'khor lo bsgom :	3	bsngags ba dogs shing srung ba khor lo bsgom 
BO_TZ_DZOGCHEN-DESUM-P25:31	slob mas gser gyi yon 'bul phyag bcas pas :	3	slob mas gser gyi yon bul phyag cha ba 
BO_TZ_DZOGCHEN-DESUM-P25:32	ho : bde gshegs rgyal ba'i gdung 'tshhob he ru ka :	3	ho bde gshegs rgyal ba gdung tshhob he ru ka 
BO_TZ_DZOGCHEN-DESUM-P25:33	'jigs bral dpa' bo shri sim ha dang : gnyis su med pa'i rdo rje slob dpon dgongs :	3	jigs bral dpa bo shri sim ha dang gnyis su med ba rdo rje slob dpon dgongs 
BO_TZ_DZOGCHEN-DESUM-P25:34	bdag cag grol ba mthar phyin mdzad du gsol :	3	bdag cag grol ba mthar phyin mdzad du gsol 
BO_TZ_DZOGCHEN-DESUM-P25:35	slob dpon rdo rje 'phyar zhing spro bskyed ni :	3	slob dpon rdo rje phyor zhing spro skyed ni 
BO_TZ_DZOGCHEN-DESUM-P25:36	ho : thar pa bla na med pa'i grong khyer du :	3	ho thar ba bla na med ba grong khyer du 
BO_TZ_DZOGCHEN-DESUM-P25:37	'dus pa'i gtsho bo shri sim ha bzhugs :	3	du ba gtsho bo shri sim ha bzhugs 
BO_TZ_DZOGCHEN-DESUM-P25:38	'di na mos pa'i skal ldan skyes bu khyod :	3	di na mos ba skal ldan skye bu khyod 
BO_TZ_DZOGCHEN-DESUM-P25:39	'jug pa legs shing dngos grub ci la dga':	3	jug ba legs shing dngos grub ci la dga: 
BO_TZ_DZOGCHEN-DESUM-P25:40	de nyid sbyin cing 'di na bla med pa'i :	4	de nyid sbyin cing di na bla med ba 
BO_TZ_DZOGCHEN-DESUM-P25:41	tshhe gcig sangs rgyas sgrub la spro ba skyed :	4	tshhe gcig sangs rgya sgrub la spro ba skyed 
BO_TZ_DZOGCHEN-DESUM-P25:42	dam tshhig ma lus yongs su gzung bar gyis :	4	dam tshhig ma lus yongs su gzung ba gyis 
BO_TZ_DZOGCHEN-DESUM-P25:43	slob mas thal mo sbyar zhing 'di skad gsol :	4	slob mas thal mo sbyor zhing di skad gsol 
BO_TZ_DZOGCHEN-DESUM-P25:44	ho : khyab bdag dpal ldan bla ma dgongs su gsol :	4	ho khyab bdag dpal ldan bla ma dgongs su gsol 
BO_TZ_DZOGCHEN-DESUM-P25:45	bdag ni dus gsum rgyal ba'i dgongs pa'i mthil :	4	bdag ni dus gsum rgyal ba dgongs ba mthil 
BO_TZ_DZOGCHEN-DESUM-P25:46	bde ba chen po'i ye shes la dga' bas :	4	bde ba chen po ye shes la dga ba 
BO_TZ_DZOGCHEN-DESUM-P25:47	de nyid myur stshol gsang sngags rigs mchog gi :	4	de nyid myur stshol gsang sngags rigs mchog gi 
BO_TZ_DZOGCHEN-DESUM-P25:48	rtsha ba sku gsung thugs kyi dam tshhig dang : nyi shu rtsha lnga'i dam tshhig ches 'phags pa :	4	rtsha ba sku gsung thugs kyi dam tshhig dang nyi shu rtsha lnga dam tshhig ches phag ba 
BO_TZ_DZOGCHEN-DESUM-P25:49	srog gi phyir yang mi gtang gzung bar bgyi :	4	srog gi phyir yang mi gtong gzung ba bgyid 
BO_TZ_DZOGCHEN-DESUM-P25:50	slob dpon rdo rje mgor bzhag bdud rtshi sbyin :	5	slob dpon rdo rje mgor jog bdud rtshi sbyin 
BO_TZ_DZOGCHEN-DESUM-P25:51	'di ni gsang ba bla na med pa yi :	5	di ni gsang ba bla na med ba yi 
BO_TZ_DZOGCHEN-DESUM-P25:52	thar pa'i go 'phang tshhe 'dir thob 'gyur bas :	5	thar ba go phen tshhe dir thob gyur ba 
BO_TZ_DZOGCHEN-DESUM-P25:53	nye ba'i lam mchog bde ba lam byed yin :	5	nye ba lam mchog bde ba lam byed yin 
BO_TZ_DZOGCHEN-DESUM-P25:54	khyed rnams rdo rje'i dam tshhig thub par gyis :	5	khyed rnams rdo rje dam tshhig thub ba gyis 
BO_TZ_DZOGCHEN-DESUM-P25:55	ma thub rdo rje'i dmyal ba chen por ltung :	5	ma thub rdo rje dmyal ba chen por ltung 
BO_TZ_DZOGCHEN-DESUM-P25:56	srog gi phyir yang yongs su ma gtang zhig :	5	srog gi phyir yang yongs su ma gtong jig 
BO_TZ_DZOGCHEN-DESUM-P25:57	badzra sa ma ya rak+sha si hu~m:	5	badzra sa ma ya rak+sha si hu~m: 
BO_TZ_DZOGCHEN-DESUM-P25:58	slob mas dam chu 'thung zhing bro bor ba :	5	slob mas dam chu thung zhing bro bor ba 
BO_TZ_DZOGCHEN-DESUM-P25:59	ma ha su kha badzra sa ma ya hu~m:	5	ma ha su kha badzra sa ma ya hu~m: 
BO_TZ_DZOGCHEN-DESUM-P25:60	i dan na ra kan :	6	i dan na ra kan 
BO_TZ_DZOGCHEN-DESUM-P25:61	de nas dngos gzhir byin rlabs chas zhugs ni :	6	de nas dngos gzhir byin rlabs cha jug ni 
BO_TZ_DZOGCHEN-DESUM-P25:62	lus gnad bsrang zhing mig 'ching rlung bzung la :	6	lus gnad bsrang zhing mig ching rlung bzung la 
BO_TZ_DZOGCHEN-DESUM-P25:63	rna ba rol mo'i sgras bkag sbyar spos kyis :	6	rna ba rol mo sgras gog sbyor spros kyis 
BO_TZ_DZOGCHEN-DESUM-P25:64	myong ba'i rtog 'dzin gcig tu byas nas su :	6	myong ba rtogs dzin gcig tu byed nas su 
BO_TZ_DZOGCHEN-DESUM-P25:65	yid kyi dmigs pa rtshe gcig brda sprad ni :	6	yid kyi dmigs ba rtshe gcig brda sprod ni 
BO_TZ_DZOGCHEN-DESUM-P25:66	shri sim ha rnal 'byor gzhon nu'i tshhul :	6	shri sim ha rnal byor gzhon nu tshhul 
BO_TZ_DZOGCHEN-DESUM-P25:67	dkar dmar mdangs ldan zhal gcig phyag gnyis pa :	6	dkar dmar mdangs ldan zhal gcig phyag gnyis ba 
BO_TZ_DZOGCHEN-DESUM-P25:68	gcer bu rus pa'i rgyan drug gar stabs sgyur :	6	bcer bu rus ba rgyan drug gar stabs sgyur 
BO_TZ_DZOGCHEN-DESUM-P25:69	rtsha gsum 'khor lo bzhi ldan lte ba'i mdor :	6	rtsha gsum khor lo bzhi ldan lte ba mdor 
BO_TZ_DZOGCHEN-DESUM-P25:70	gtum mo a shad dbyibs can rab 'bar ba :	7	thum mo a shad dbyibs can rab bar ba 
BO_TZ_DZOGCHEN-DESUM-P25:71	spyi bor thig le ha~m yig mgo thur bstan :	7	spyi bor thig le ha~m yig mgo thur ston 
BO_TZ_DZOGCHEN-DESUM-P25:72	snying gar rnam shes ngo bo a dkar po :	7	snying gar rnam shes ngo bo a dkar po 
BO_TZ_DZOGCHEN-DESUM-P25:73	slob mas slob dpon la ni mos gus bskyed :	7	slob mas slob dpon la ni mos gus skyed 
BO_TZ_DZOGCHEN-DESUM-P25:74	slob dpon shri sim ha yab yum du :	7	slob dpon shri sim ha yab yum du 
BO_TZ_DZOGCHEN-DESUM-P25:75	gsal ba'i sbyor mtshhams las ni 'od 'phros pa :	7	gsal ba sbyor mtshhams las ni d phro ba 
BO_TZ_DZOGCHEN-DESUM-P25:76	slob ma'i gsang ba nas zhugs gtum mo sbar :	7	slob ma gsang ba nas jug thum mo sbor 
BO_TZ_DZOGCHEN-DESUM-P25:77	spyi bo'i thig le zhu zhing gsal ba las :	7	spyi bo thig le ju zhing gsal ba las 
BO_TZ_DZOGCHEN-DESUM-P25:78	lus kyi stod smad dwangs ma dkar dmar gyis :	7	lus kyi stod smad dwangs ma dkar dmar gyis 
BO_TZ_DZOGCHEN-DESUM-P25:79	gang zhing snying ga'i thad du go skabs can :	7	gang zhing snying ga thad du go skabs can 
BO_TZ_DZOGCHEN-DESUM-P25:80	bde ba bsgom zhing bde ba cher 'phel tshhe :	8	bde ba bsgom zhing bde ba cher phel tshhe 
BO_TZ_DZOGCHEN-DESUM-P25:81	dkar dmar 'dres shing a yig la thim pas :	8	dkar dmar dre shing a yig la thim ba 
BO_TZ_DZOGCHEN-DESUM-P25:82	thig le cher 'phel bde ba chen por bsgom :	8	thig le cher phel bde ba chen por bsgom 
BO_TZ_DZOGCHEN-DESUM-P25:83	rgyal ba'i tshhogs rnams bde ba chen por zhu :	8	rgyal ba tshhogs rnams bde ba chen por ju 
BO_TZ_DZOGCHEN-DESUM-P25:84	bdud rtshi'i rang bzhin spyi bo'i gtshug nas byung :	8	bdud rtshi rang bzhin spyi bo gtshug nas byung 
BO_TZ_DZOGCHEN-DESUM-P25:85	snying gi nang zhugs lus kun mer gyis gang :	8	snying gi nang jug lus kun mer gyis gang 
BO_TZ_DZOGCHEN-DESUM-P25:86	bde ba chen po'i ye shes rtshe gcig bsgom :	8	bde ba chen po ye shes rtshe gcig bsgom 
BO_TZ_DZOGCHEN-DESUM-P25:87	ye shes brtan pa'i sngags kyis brtan par bya :	8	ye shes brtan ba sngags kyis brtan ba byed 
BO_TZ_DZOGCHEN-DESUM-P25:88	slob dpon bum pa bzung zhing gnyis ka yis :	8	slob dpon bum ba bzung zhing gnyis ka yis 
BO_TZ_DZOGCHEN-DESUM-P25:89	bum nang shri sim ha'i spyi bo yi :	8	bum nang shri sim ha spyi bo yi 
BO_TZ_DZOGCHEN-DESUM-P25:90	a+o~m yig gsal zhing yab yum sbyor ba yis :	9	a+o~m yig gsal zhing yab yum sbyor ba yis 
BO_TZ_DZOGCHEN-DESUM-P25:91	a+o~m las dga' ba'i bdud rtshi dkar gsal babs :	9	a+o~m las dga ba bdud rtshi dkar gsal bab 
BO_TZ_DZOGCHEN-DESUM-P25:92	sku gang sbyor mtshhams nas babs bum pa gang :	9	sku gang sbyor mtshhams nas bab bum ba gang 
BO_TZ_DZOGCHEN-DESUM-P25:93	kha nas lud cing slob ma'i spyi bor babs :	9	kha nas lud cing slob ma spyi bor bab 
BO_TZ_DZOGCHEN-DESUM-P25:94	bde chen 'khor lo'i rtsha khengs bde chen bsgom :	9	bde chen khor lo rtsha kheng bde chen bsgom 
BO_TZ_DZOGCHEN-DESUM-P25:95	de bzhin mgrin dang thugs ka'i ahhu~m las :	9	de bzhin mgrin dang thugs ka ahhu~m las 
BO_TZ_DZOGCHEN-DESUM-P25:96	bdud rtshi dmar mthing dga' chen khyad dga' yi :	9	bdud rtshi dmar mthing dga chen khyad dga yi 
BO_TZ_DZOGCHEN-DESUM-P25:97	ngo bor babs shing slob ma'i mgrin pa dang : snying ga gang bas bde mchog rgyas par bsgom :	9	ngo bor bab shing slob ma mgrin ba dang snying ga gang ba bde mchog rgya ba bsgom 
BO_TZ_DZOGCHEN-DESUM-P25:98	de rjes lte ba'i hrihlas lhan skyes kyi :	9	de rjes lte ba hrihlas lhan skye kyi 
BO_TZ_DZOGCHEN-DESUM-P25:99	bdud rtshi babs shing slob ma'i lte ba khengs :	9	bdud rtshi bab shing slob ma lte ba kheng 
BO_TZ_DZOGCHEN-DESUM-P25:100	sku yi gnas rnams ma lus thams cad nas :	10	sku yi gnas rnams ma lus thams cad nas 
BO_TZ_DZOGCHEN-DESUM-P25:101	bdud rtshi 'od lnga'i mdangs ldan babs pa yis :	10	bdud rtshi d lnga mdangs ldan bab ba yis 
BO_TZ_DZOGCHEN-DESUM-P25:102	slob ma'i lus gang bdud rtshi gyen 'khyil bas :	10	slob ma lus gang bdud rtshi gyen khyil ba 
BO_TZ_DZOGCHEN-DESUM-P25:103	spyi bo'i gtshug tu rdo rje sems dpa' bsam :	10	spyi bo gtshug tu rdo rje sems dpa bsam 
BO_TZ_DZOGCHEN-DESUM-P25:104	hu~m: rang byung bde ba chen po'i bum pa ru :	10	hu~m: rang byung bde ba chen po bum ba ru 
BO_TZ_DZOGCHEN-DESUM-P25:105	lhan cig skyes pa'i bla ma yab yum bzhugs :	10	lhan cig skye ba bla ma yab yum bzhugs 
BO_TZ_DZOGCHEN-DESUM-P25:106	bde chen sbyor ba'i bdud rtshi bsam mi khyab :	10	bde chen sbyor ba bdud rtshi bsam mi khyab 
BO_TZ_DZOGCHEN-DESUM-P25:107	rang grol bde chen ye shes bskyed pa'i phyir :	10	rang grol bde chen ye shes skyed ba phyir 
BO_TZ_DZOGCHEN-DESUM-P25:108	bla na med pa bum pas dbang bskur ro :	10	bla na med ba bum ba dbang skur ro 
BO_TZ_DZOGCHEN-DESUM-P25:109	a+o~m ahhu~m gu ru shri sim ha sid+d+hi hu~m:	10	a+o~m ahhu~m gu ru shri sim ha sid+d+hi hu~m: 
BO_TZ_DZOGCHEN-DESUM-P25:110	ka ya wa ka tshit+ta gu na karma a b+hi shiny+tsha hu~m:	11	ka ya wa ka tshit+ta gu na karma a b+hi shiny+tsha hu~m: 
BO_TZ_DZOGCHEN-DESUM-P25:111	slob dpon yab yum shri sim ha ni :	11	slob dpon yab yum shri sim ha ni 
BO_TZ_DZOGCHEN-DESUM-P25:112	mnyam par sbyor bar gsal ba'i gnas rnams su :	11	mnyam ba sbyor ba gsal ba gnas rnams su 
BO_TZ_DZOGCHEN-DESUM-P25:113	bum dbang bzhin du yig 'bru gsal bar bsgom :	11	bum dbang bzhin du yig bru gsal ba bsgom 
BO_TZ_DZOGCHEN-DESUM-P25:114	dga' ba bzhi dang yongs rdzogs bdud rtshi babs :	11	dga ba bzhi dang yongs rdzogs bdud rtshi bab 
BO_TZ_DZOGCHEN-DESUM-P25:115	slob ma'i khar sbyin rtsha bzhi lus kun gang :	11	slob ma khar sbyin rtsha bzhi lus kun gang 
BO_TZ_DZOGCHEN-DESUM-P25:116	bde chen bzhi dang yongs rdzogs thob par bsgom :	11	bde chen bzhi dang yongs rdzogs thob ba bsgom 
BO_TZ_DZOGCHEN-DESUM-P25:117	hu~m: yul snang rnam par dag pa'i thod pa ru :	11	hu~m: yul snang rnam ba dag ba thod ba ru 
BO_TZ_DZOGCHEN-DESUM-P25:118	rnam par dag pa'i dbang po sbyor pa yis :	11	rnam ba dag ba dbang po sbyor ba yis 
BO_TZ_DZOGCHEN-DESUM-P25:119	rnam shes ye shes sgyur ba'i byang sems bskyil :	11	rnam shes ye shes sgyur ba byang sems skyil 
BO_TZ_DZOGCHEN-DESUM-P25:120	kun gzhi rnam par grol phyir dbang bskur ro :	12	kun gzhi rnam ba grol phyir dbang skur ro 
BO_TZ_DZOGCHEN-DESUM-P25:121	a+o~m ahhu~m gu ru shri sogs /	12	a+o~m ahhu~m gu ru shri sogs 
BO_TZ_DZOGCHEN-DESUM-P25:122	ka ya wa ka sogs /	12	ka ya wa ka sogs 
BO_TZ_DZOGCHEN-DESUM-P25:123	slob bu rig ma bla ma yab yum gsal :	12	slob bu rig ma bla ma yab yum gsal 
BO_TZ_DZOGCHEN-DESUM-P25:124	'du shes gsum gyis snyoms par 'jug par bslab :	12	du shes gsum gyis snyom ba jug ba bslab 
BO_TZ_DZOGCHEN-DESUM-P25:125	yab yum gnas bzhir yig 'bru bzhi gsal ba :	12	yab yum gnas bzhir yig bru bzhi gsal ba 
BO_TZ_DZOGCHEN-DESUM-P25:126	de las rim bzhin thig le 'phel ba yang :	12	de las rim bzhin thig le phel ba yang 
BO_TZ_DZOGCHEN-DESUM-P25:127	rtsha bzhi la babs gyen du drangs pa yis :	12	rtsha bzhi la bab gyen du drangs ba yis 
BO_TZ_DZOGCHEN-DESUM-P25:128	dga' bzhi yongs rdzogs nyid du bsgom par bya :	12	dga bzhi yongs rdzogs nyid du bsgom ba byed 
BO_TZ_DZOGCHEN-DESUM-P25:129	hu~m: snang zhing stong la gsal ba'i rig ma la :	12	hu~m: snang zhing stong la gsal ba rig ma la 
BO_TZ_DZOGCHEN-DESUM-P25:130	mi rtog ngang du mnyam par sbyor ba las :	13	mi rtogs ngang du mnyam ba sbyor ba las 
BO_TZ_DZOGCHEN-DESUM-P25:131	bde ba'i ye shes nam mkha' gang bar 'phel :	13	bde ba ye shes nam mkha gang ba phel 
BO_TZ_DZOGCHEN-DESUM-P25:132	dbyer med lhun grub chen por rtogs par shog :	13	dbyer med lhun grub chen por rtogs ba shog 
BO_TZ_DZOGCHEN-DESUM-P25:133	a+o~m ahhu~m gu ru shri sim ha sogs /	13	a+o~m ahhu~m gu ru shri sim ha sogs 
BO_TZ_DZOGCHEN-DESUM-P25:134	ka ya wa ka sogs /	13	ka ya wa ka sogs 
BO_TZ_DZOGCHEN-DESUM-P25:135	rang byung rdo rje sems dpa'i me long bstan :	13	rang byung rdo rje sems dpa me long ston 
BO_TZ_DZOGCHEN-DESUM-P25:136	hu~m: phyi nang zang thal ka nas dag pa la :	13	hu~m: phyi nang zang thal ka nas dag ba la 
BO_TZ_DZOGCHEN-DESUM-P25:137	lhun gyis grub pa'i 'ja' tshhon ci yang 'char :	13	lhun gyis grub ba ja tshhon ci yang char 
BO_TZ_DZOGCHEN-DESUM-P25:138	rnam par 'phrul pa'i bye brag cir snang yang :	13	rnam ba phrul ba bye brag cir snang yang 
BO_TZ_DZOGCHEN-DESUM-P25:139	rang byung dbyings las 'gyur ba med pa 'o :	13	rang byung dbyings las gyur ba med ba mang 
BO_TZ_DZOGCHEN-DESUM-P25:140	a+o~m ahhu~m gu ru shri sim ha sogs /	14	a+o~m ahhu~m gu ru shri sim ha sogs 
BO_TZ_DZOGCHEN-DESUM-P25:141	ka ya\u0f8e rma bya'i mdongs sgro me long bstan byas la :	14	ka ya\u0f8e rma byed mdongs sgro me long ston byed la 
BO_TZ_DZOGCHEN-DESUM-P25:142	a : dbyings ni rnam par dag pa'i rang bzhin la :	14	a dbyings ni rnam ba dag ba rang bzhin la 
BO_TZ_DZOGCHEN-DESUM-P25:143	thig le gsal ba'i sgron ma rang las byung :	14	thig le gsal ba sgron ma rang las byung 
BO_TZ_DZOGCHEN-DESUM-P25:144	gnyis su med pa'i rang gdangs ngo mtshhar can :	14	gnyis su med ba rang gdang ngo mtshhar can 
BO_TZ_DZOGCHEN-DESUM-P25:145	lhun gyis grub pa'i ngang du blta bar bya :	14	lhun gyis grub ba ngang du lta ba byed 
BO_TZ_DZOGCHEN-DESUM-P25:146	a+o~m ahhu~m gu ru shri sim ha\u0f8e	14	a+o~m ahhu~m gu ru shri sim ha\u0f8e 
BO_TZ_DZOGCHEN-DESUM-P25:147	ka ya\u0f8e mdun gyi nam mkha'i gnas su bltar bcug la :	14	ka ya\u0f8e mdun gyi nam mkha gnas su bltar jug la 
BO_TZ_DZOGCHEN-DESUM-P25:148	hu~m: phyi nang dbyings rig gnyis su med pa la :	14	hu~m: phyi nang dbyings rig gnyis su med ba la 
BO_TZ_DZOGCHEN-DESUM-P25:149	gnyis su 'dzin pa'i kun btags blo las 'das :	14	gnyis su dzin ba kun dogs blo las da 
BO_TZ_DZOGCHEN-DESUM-P25:150	chos dbyings khyab brdal 'od gsal zang thal le :	15	chos dbyings khyab rdal d gsal zang thal le 
BO_TZ_DZOGCHEN-DESUM-P25:151	'di zhes brjod tshhig bral bar dbyings rig bsres :	15	di zhes rjod tshhig bral ba dbyings rig bsres 
BO_TZ_DZOGCHEN-DESUM-P25:152	a+o~m ahhu~m gu ru shri sim ha\u0f8e	15	a+o~m ahhu~m gu ru shri sim ha\u0f8e 
BO_TZ_DZOGCHEN-DESUM-P25:153	ka ya\u0f8e a a a :	15	ka ya\u0f8e a a a 
BO_TZ_DZOGCHEN-DESUM-P25:154	rang bzhin lhug par gnas pa bltar gzhug la :	15	rang bzhin lhug ba gnas ba bltar jug la 
BO_TZ_DZOGCHEN-DESUM-P25:155	hu~m: ye nas rnam par dag pa'i gzhi thog tu :	15	hu~m: ye nas rnam ba dag ba gzhi thogs tu 
BO_TZ_DZOGCHEN-DESUM-P25:156	bya rtshol bral ba'i bde chen mthar phyin nas :	15	byed rtshol bral ba bde chen mthar phyin nas 
BO_TZ_DZOGCHEN-DESUM-P25:157	'bras bu rang las rnyed pa ngo mtshhar che :	15	bras bu rang las rnyed ba ngo mtshhar che 
BO_TZ_DZOGCHEN-DESUM-P25:158	don dam dmigs med myong ba ngos gzung bral :	15	don dam dmigs med myong ba ngos gzung bral 
BO_TZ_DZOGCHEN-DESUM-P25:159	ngo bo rang bzhin thugs rje rnam pa gsum :	15	ngo bo rang bzhin thugs rje rnam ba gsum 
BO_TZ_DZOGCHEN-DESUM-P25:160	dbyer med mi phyed dbyings rig gnyis su med :	16	dbyer med mi phyed dbyings rig gnyis su med 
BO_TZ_DZOGCHEN-DESUM-P25:161	mthar thug 'bras bu'i sa la phyin pa 'o :	16	mthar thug bras bu sa la phyin ba mang 
BO_TZ_DZOGCHEN-DESUM-P25:162	a+o~m ahhu~m gu ru shri sim ha\u0f8e	16	a+o~m ahhu~m gu ru shri sim ha\u0f8e 
BO_TZ_DZOGCHEN-DESUM-P25:163	d+harma ka ya a :	16	d+harma ka ya a 
BO_TZ_DZOGCHEN-DESUM-P25:164	slob mas lus dang longs spyod dge rtsha 'bul :	16	slob mas lus dang longs spyod dge rtsha bul 
BO_TZ_DZOGCHEN-DESUM-P25:165	de ltar rnam pa nyi shus byang chub pa'i :	16	de ltar rnam ba nyi shus byang chub ba 
BO_TZ_DZOGCHEN-DESUM-P25:166	bde ba chen po'i zab dbang bskur ba ni :	16	bde ba chen po zab dbang skur ba ni 
BO_TZ_DZOGCHEN-DESUM-P25:167	kun la ma yin blo chen ldan la gtad :	16	kun la ma yin blo chen ldan la gtod 
BO_TZ_DZOGCHEN-DESUM-P25:168	khyad par 'don pa'i skyes bu'i chos skal dang : yongs rdzogs dbang ba'i 'brug lo a yu'i ming :	16	khyad ba don ba skye bu chos skal dang yongs rdzogs dbang ba brug lo a yu ming 
BO_TZ_DZOGCHEN-DESUM-P25:169	gtshang lung phyogs nas rta lo bde ba'i ming :	16	gtshang lung phyogs nas rta lo bde ba ming 
BO_TZ_DZOGCHEN-DESUM-P25:170	yar 'brog phyogs nas sprel lo pad+ma'i ming :	17	yar brog phyogs nas sprel lo pad+ma ming 
BO_TZ_DZOGCHEN-DESUM-P25:171	lho zla'i phyogs nas rta lo d+harma'i ming :	17	lho zla phyogs nas rta lo d+harma ming 
BO_TZ_DZOGCHEN-DESUM-P25:172	de dag rnams la 'di nyid 'phrod par gyis :	17	de dag rnams la di nyid phrod ba gyis 
BO_TZ_DZOGCHEN-DESUM-P25:173	gong ma'i dbang rnams bskur ba'i snod min te :	17	gong ma dbang rnams skur ba snod min te 
BO_TZ_DZOGCHEN-DESUM-P25:174	dad pa can la gtor ma'i dbang bskur te :	17	dad ba can la thor ma dbang skur te 
BO_TZ_DZOGCHEN-DESUM-P25:175	gtor ma rten dang brten pa'i dkyil 'khor bsgom :	17	thor ma rten dang rten ba dkyil khor bsgom 
BO_TZ_DZOGCHEN-DESUM-P25:176	slob mas man+dal 'bul zhing gsol ba gdab :	17	slob mas man+dal bul zhing gsol ba gdab 
BO_TZ_DZOGCHEN-DESUM-P25:177	rgyud sbyong lhar bsgom sku gsung thugs bstim zhing :	17	brgyud sbyong lhar bsgom sku gsung thugs stim zhing 
BO_TZ_DZOGCHEN-DESUM-P25:178	gtor ma spyi bor bzung ste dbyangs snyan pos :	17	thor ma spyi bor bzung ste dbyangs snyan pos 
BO_TZ_DZOGCHEN-DESUM-P25:179	hu~m: gtor ma'i rang bzhin rin chen gzhal yas khang :	17	hu~m: thor ma rang bzhin rin chen jal yas khang 
BO_TZ_DZOGCHEN-DESUM-P25:180	nang du bla ma shri sim ha dang : rig 'dzin grub thob rgya mtshho'i tshhogs rnams bzhugs :	18	nang du bla ma shri sim ha dang rig dzin grub thob rgya mtshho tshhogs rnams bzhugs 
BO_TZ_DZOGCHEN-DESUM-P25:181	yi dam lha tshhogs thams cad sprin ltar gtibs :	18	yi dam lha tshhogs thams cad sprin ltar gtibs 
BO_TZ_DZOGCHEN-DESUM-P25:182	ma dang mkha' 'gro bu yug bzhin du 'tshhubs :	18	ma dang mkha gro bu yug bzhin du tshhubs 
BO_TZ_DZOGCHEN-DESUM-P25:183	rtsha gsum rgyal ba'i dkyil 'khor chen po 'dis :	18	rtsha gsum rgyal ba dkyil khor chen po dis 
BO_TZ_DZOGCHEN-DESUM-P25:184	skal ldan slob ma rnams la dbang bskur bas :	18	skal ldan slob ma rnams la dbang skur ba 
BO_TZ_DZOGCHEN-DESUM-P25:185	phyi nang gsang ba'i bar chad bsal ba dang : sku gsung thugs kyi dbang chen yongs su rdzogs :	18	phyi nang gsang ba ba chad bsal ba dang sku gsung thugs kyi dbang chen yongs su rdzogs 
BO_TZ_DZOGCHEN-DESUM-P25:186	mchog dang thun mong dngos grub bstshal du gsol :	18	mchog dang thun mong dngos grub bstshal du gsol 
BO_TZ_DZOGCHEN-DESUM-P25:187	a+o~m ahhu~m gu ru shri sim ha sid+d+hi hu~m:	18	a+o~m ahhu~m gu ru shri sim ha sid+d+hi hu~m: 
BO_TZ_DZOGCHEN-DESUM-P25:188	ka ya wa ka tshit+ta a b+hi shiny+tsha hu~m:	18	ka ya wa ka tshit+ta a b+hi shiny+tsha hu~m: 
BO_TZ_DZOGCHEN-DESUM-P25:189	rjes 'brel sku gsung thugs kyi rjes gnang ni :	18	rjes brel sku gsung thugs kyi rjes gnang ni 
BO_TZ_DZOGCHEN-DESUM-P25:190	rig 'dzin bla ma'i sku 'bag spyi bor bzhag :	19	rig dzin bla ma sku bag spyi bor jog 
BO_TZ_DZOGCHEN-DESUM-P25:191	a+o~m: rdo rje sems dpa' bde ba'i lhums su zhugs :	19	a+o~m: rdo rje sems dpa bde ba lhums su jug 
BO_TZ_DZOGCHEN-DESUM-P25:192	mi yi yul 'khrungs thos bsam mthar phyin mdzad :	19	mi yi yul khrung thos bsam mthar phyin mdzad 
BO_TZ_DZOGCHEN-DESUM-P25:193	rgyal ba'i gsang gsum ma lus 'dus pa'i sku :	19	rgyal ba gsang gsum ma lus du ba sku 
BO_TZ_DZOGCHEN-DESUM-P25:194	dpal chen rig 'dzin shri sim ha yi :	19	dpal chen rig dzin shri sim ha yi 
BO_TZ_DZOGCHEN-DESUM-P25:195	sku yi phyag rgya sgom pa'i dbang bskur ro :	19	sku yi phyag rgya sgom ba dbang skur ro 
BO_TZ_DZOGCHEN-DESUM-P25:196	a+o~m ahhu~m gu ru shri sim ha sid+d+hi hu~m:	19	a+o~m ahhu~m gu ru shri sim ha sid+d+hi hu~m: 
BO_TZ_DZOGCHEN-DESUM-P25:197	ka ya a b+hi shiny+tsha a+o~m:	19	ka ya a b+hi shiny+tsha a+o~m: 
BO_TZ_DZOGCHEN-DESUM-P25:198	bzlas lung bya zhing sngags phreng gtad :	19	bzlas lung byed zhing sngags phreng gtod 
BO_TZ_DZOGCHEN-DESUM-P25:199	a: rig 'dzin gtsho bo grub pa'i dbang phyug rje :	19	a: rig dzin gtsho bo grub ba dbang phyug rje 
BO_TZ_DZOGCHEN-DESUM-P25:200	rgyal kun gsang gsum 'dus pa gsung gi mchog :	20	rgyal kun gsang gsum du ba gsung gi mchog 
BO_TZ_DZOGCHEN-DESUM-P25:201	rlung sngags grags stong sngags su 'gyur ba'i phyir :	20	rlung sngags grags stong sngags su gyur ba phyir 
BO_TZ_DZOGCHEN-DESUM-P25:202	yan lag drug cu ldan pa'i dbang bskur ro :	20	yan lag drug cu ldan ba dbang skur ro 
BO_TZ_DZOGCHEN-DESUM-P25:203	a+o~m ahhu~m gu ru shri sim ha sid+d+hi hu~m:	20	a+o~m ahhu~m gu ru shri sim ha sid+d+hi hu~m: 
BO_TZ_DZOGCHEN-DESUM-P25:204	wa ka a b+hi shiny+tsha a:	20	wa ka a b+hi shiny+tsha a: 
BO_TZ_DZOGCHEN-DESUM-P25:205	bla ma'i thugs dang bsre zhing mnyam par bzhag :	20	bla ma thugs dang bsre zhing mnyam ba jog 
BO_TZ_DZOGCHEN-DESUM-P25:206	hu~m: rig 'dzin bla ma shri sim ha'i thugs :	20	hu~m: rig dzin bla ma shri sim ha thugs 
BO_TZ_DZOGCHEN-DESUM-P25:207	spros pa kun bral sems nyid ye shes che :	20	spros ba kun bral sems nyid ye shes che 
BO_TZ_DZOGCHEN-DESUM-P25:208	bde gsal mi rtogs dbyer med klong du chub :	20	bde gsal mi rtogs dbyer med klong du chub 
BO_TZ_DZOGCHEN-DESUM-P25:209	dbyings rig zung du 'jug pa'i dbang thob shog :	20	dbyings rig zung du jug ba dbang thob shog 
BO_TZ_DZOGCHEN-DESUM-P25:210	a+o~m ahhu~m gu ru shri sim ha sid+d+hi hu~m:	21	a+o~m ahhu~m gu ru shri sim ha sid+d+hi hu~m: 
BO_TZ_DZOGCHEN-DESUM-P25:211	tshit+ta a b+hi shiny+tsha hu~m:	21	tshit+ta a b+hi shiny+tsha hu~m: 
BO_TZ_DZOGCHEN-DESUM-P25:212	de nas dam tshhig khas blang gtang rag 'bul :	21	de nas dam tshhig khas blang gtong rag bul 
BO_TZ_DZOGCHEN-DESUM-P25:213	rjes kyi bya ba thams cad mtha' rdzogs bya :	21	rjes kyi byed ba thams cad mtha rdzogs byed 
BO_TZ_DZOGCHEN-DESUM-P25:214	'di yi gdams pa slob bu'i snod brtag cing :	21	di yi doms ba slob bu snod rtog cing 
BO_TZ_DZOGCHEN-DESUM-P25:215	blo dang 'tshham par rim bzhin bstan pa las :	21	blo dang tshham ba rim bzhin ston ba las 
BO_TZ_DZOGCHEN-DESUM-P25:216	pad+ma'i snying khrag yin pas spel bar phangs :	21	pad+ma snying khrag yin ba spel ba phang 
BO_TZ_DZOGCHEN-DESUM-P25:217	spyir yang de dus bod kyi rgyal khams 'dir :	21	spyir yang de dus bod kyi rgyal khams dir 
BO_TZ_DZOGCHEN-DESUM-P25:218	mnga' bdag rgyal po'i gdung rabs dmangs su 'beb :	21	mnga bdag rgyal po gdung rabs dmangs su beb 
BO_TZ_DZOGCHEN-DESUM-P25:219	mtha' mi mang pos rje bo byed pa'i dus :	21	mtha mi mang pos rje bo byed ba dus 
BO_TZ_DZOGCHEN-DESUM-P25:220	bod rnams phyi nang 'khrugs shing nad mtshhon dar :	22	bod rnams phyi nang khrugs shing nad mtshhon dar 
BO_TZ_DZOGCHEN-DESUM-P25:221	sa bcud nyams nas bsod nams mar 'grib dus :	22	sa bcud nyams nas bsod nams mar grib dus 
BO_TZ_DZOGCHEN-DESUM-P25:222	glo bo dge skar phyogs su gtshug lag 'byung :	22	glo bo dge skar phyogs su gtshug lag byung 
BO_TZ_DZOGCHEN-DESUM-P25:223	tsha ri'i gnas su 'khrugs shor mi mang 'gum :	22	tsha ri gnas su khrugs chor mi mang gum 
BO_TZ_DZOGCHEN-DESUM-P25:224	de nas lo ni bcu gnyis skor tsham dus :	22	de nas lo ni chu gnyis skor tsham dus 
BO_TZ_DZOGCHEN-DESUM-P25:225	dbus gtshang bar nas rgyal po khyi yi mgo :	22	dbus gtshang ba nas rgyal po khyi yi mgo 
BO_TZ_DZOGCHEN-DESUM-P25:226	lha sar phyin nas chos lugs mi 'dra byed :	22	lha sar phyin nas chos lugs mi dra byed 
BO_TZ_DZOGCHEN-DESUM-P25:227	rgyal ba'i bstan pa sum cha tsham zhig nub :	22	rgyal ba ston ba sum cha tsham jig nub 
BO_TZ_DZOGCHEN-DESUM-P25:228	smad kyi mdo khams sgang gi byang stod du :	22	smad kyi mdo khams sgang gi byang stod du 
BO_TZ_DZOGCHEN-DESUM-P25:229	nyam thag cho nge gnam la 'bod pa 'byung :	22	nyam thag cho nge gnam la bod ba byung 
BO_TZ_DZOGCHEN-DESUM-P25:230	tshha ba rong gi byang khams stod kyi char :	23	tshha ba rong gi byang khams stod kyi char 
BO_TZ_DZOGCHEN-DESUM-P25:231	mdung thogs gnyis kyis zal mo sgang rnams 'khrugs :	23	mdung thogs gnyis kyis zal mo sgang rnams khrugs 
BO_TZ_DZOGCHEN-DESUM-P25:232	dge ba'i bshes gnyen zhig la sun dbyung byed :	23	dge ba bshes gnyen jig la sun byin byed 
BO_TZ_DZOGCHEN-DESUM-P25:233	lho zla'i smad kyi rong chen nag po ru :	23	lho zla smad kyi rong chen nag po ru 
BO_TZ_DZOGCHEN-DESUM-P25:234	zog po zhig gis o rgyan bstan la smad :	23	zog po jig gis o rgyan ston la smad 
BO_TZ_DZOGCHEN-DESUM-P25:235	de yi rkyen gyis khrag gi mtshho zhig brdol :	23	de yi rkyen gyis khrag gi mtshho jig rdol 
BO_TZ_DZOGCHEN-DESUM-P25:236	tre shod phyogs su lo gsum 'khrug pa 'byung :	23	tre shod phyogs su lo gsum khrug ba byung 
BO_TZ_DZOGCHEN-DESUM-P25:237	khyad par gdug pa can zhig yul du 'ong :	23	khyad ba gdug ba can jig yul du ng 
BO_TZ_DZOGCHEN-DESUM-P25:238	kha rlangs nag po gtam ngan gnam du 'byung :	23	kha rlangs nag po dam ngan gnam du byung 
BO_TZ_DZOGCHEN-DESUM-P25:239	sa khad yangs pa'i rgyal khams nad yams 'phel :	23	sa khad yangs ba rgyal khams nad yams phel 
BO_TZ_DZOGCHEN-DESUM-P25:240	khyi yi lo pa zhwa mo mtha' bzhir can :	24	khyi yi lo ba zhwa mo mtha bzhir can 
BO_TZ_DZOGCHEN-DESUM-P25:241	spyi zlum byas pa bod 'dir slebs nas su :	24	spyi zlum byed ba bod dir slebs nas su 
BO_TZ_DZOGCHEN-DESUM-P25:242	bstan pa yin zer bstan pa'i rkang 'dren byed :	24	ston ba yin zer ston ba rkang bgrang byed 
BO_TZ_DZOGCHEN-DESUM-P25:243	sog po'i yul nas bstan pa rgyal mtshhan zhes :	24	sog po yul nas ston ba rgyal mtshhan zhes 
BO_TZ_DZOGCHEN-DESUM-P25:244	lha sar thugs rje chen po sgrub pas phan :	24	lha sar thugs rje chen po sgrub ba phan 
BO_TZ_DZOGCHEN-DESUM-P25:245	zal sgang bar gyi chab kyi mdo dag tu :	24	zal sgang ba gyi chab kyi mdo dag tu 
BO_TZ_DZOGCHEN-DESUM-P25:246	ma 'ongs chos sde chen po 'byung ba la :	24	ma ngs chos sde chen po byung ba la 
BO_TZ_DZOGCHEN-DESUM-P25:247	lo yi skor der gdug 'dre'i tshha rag rgyug :	24	lo yi skor der gdug dre tshha rag rgyug 
BO_TZ_DZOGCHEN-DESUM-P25:248	byang khams phyogs kyi 'bri klung stod dag tu :	24	byang khams phyogs kyi bri klung stod dag tu 
BO_TZ_DZOGCHEN-DESUM-P25:249	rgyal bstan sems can rnams la sun 'byin pa'i :	24	rgyal ston sems can rnams la sun byin ba 
BO_TZ_DZOGCHEN-DESUM-P25:250	rmu rgod skye bo mdung thogs rgyug par 'gyur :	25	rmu rgod skye bo mdung thogs rgyug ba gyur 
BO_TZ_DZOGCHEN-DESUM-P25:251	bdud nag sprul pa zog po chos ming can :	25	bdud nag sprul ba zog po chos ming can 
BO_TZ_DZOGCHEN-DESUM-P25:252	grub pa'i ming 'dzin zhig gis phung sbyor byed :	25	grub ba ming dzin jig gis phung sbyor byed 
BO_TZ_DZOGCHEN-DESUM-P25:253	de nyid bsad pas gdug 'dre nag por 'gyur :	25	de nyid bsad ba gdug dre nag por gyur 
BO_TZ_DZOGCHEN-DESUM-P25:254	rgyal 'gong bdun gyi gtsho bo 'di yis byed :	25	rgyal gong bdun gyi gtsho bo di yis byed 
BO_TZ_DZOGCHEN-DESUM-P25:255	'bri klung phyogs dang lho zla'i phyogs rnams su :	25	bri klung phyogs dang lho zla phyogs rnams su 
BO_TZ_DZOGCHEN-DESUM-P25:256	de yi gdug pa'i dbal gyis sdug bsngal 'gyur :	25	de yi gdug ba dbal gyis sdug sngal gyur 
BO_TZ_DZOGCHEN-DESUM-P25:257	'bri klung smad kyi gnyan thang phyogs dag tu :	25	bri klung smad kyi gnyan thang phyogs dag tu 
BO_TZ_DZOGCHEN-DESUM-P25:258	bstan pa'i phung sel byed pa'i 'gong po 'byung :	25	ston ba phung sel byed ba gong po byung 
BO_TZ_DZOGCHEN-DESUM-P25:259	shi ba'i tshhe na gson 'dre pho mor 'gyur :	25	chi ba tshhe na gson dre pho mor gyur 
BO_TZ_DZOGCHEN-DESUM-P25:260	ma 'ongs dus su yul phyogs de 'dzin pa'i :	26	ma ngs dus su yul phyogs de dzin ba 
BO_TZ_DZOGCHEN-DESUM-P25:261	rgyal po ka pa'i ming can 'byung ba'i tshhe :	26	rgyal po ka ba ming can byung ba tshhe 
BO_TZ_DZOGCHEN-DESUM-P25:262	lo skor de la shar phyogs nas 'ongs pa'i :	26	lo skor de la char phyogs nas ngs ba 
BO_TZ_DZOGCHEN-DESUM-P25:263	nag po bdud kyi pho nya zhig gis gnod :	26	nag po bdud kyi pho nya jig gis gnod 
BO_TZ_DZOGCHEN-DESUM-P25:264	'bri klung smad kyi kahthog phyogs nye bar :	26	bri klung smad kyi kahthog phyogs nye ba 
BO_TZ_DZOGCHEN-DESUM-P25:265	bdud kyi sprul pa cha shad nyams pa 'byung :	26	bdud kyi sprul ba cha shad nyams ba byung 
BO_TZ_DZOGCHEN-DESUM-P25:266	mdo khams smad kyi bstan 'gro yongs la gnod :	26	mdo khams smad kyi ston gro yongs la gnod 
BO_TZ_DZOGCHEN-DESUM-P25:267	da ni de la phan thabs bshad pa ni :	26	da ni de la phan thabs chad ba ni 
BO_TZ_DZOGCHEN-DESUM-P25:268	la stod phyogs nas dar dkar brkyangs 'dra'i rir :	26	la stod phyogs nas dar dkar rkyong dra rir 
BO_TZ_DZOGCHEN-DESUM-P25:269	phug pa'i mdo ru mchod rten dkar po brtshegs :	26	bugs ba mdo ru mchod rten dkar po brtshegs 
BO_TZ_DZOGCHEN-DESUM-P25:270	lha sa'i lcags po ri yi ri sna mthud :	27	lha sa lcags po ri yi ri sna mthud 
BO_TZ_DZOGCHEN-DESUM-P25:271	rtshe thang mgon po ri la gnas rten bzhengs :	27	rtshe thang mgon po ri la gnas rten bzhengs 
BO_TZ_DZOGCHEN-DESUM-P25:272	yar lung stod du sman gyi sgrub pa bya :	27	yar lung stod du sman gyi sgrub ba byed 
BO_TZ_DZOGCHEN-DESUM-P25:273	de yis dbus gtshang phyogs 'di bde thabs 'byung :	27	de yis dbus gtshang phyogs di bde thabs byung 
BO_TZ_DZOGCHEN-DESUM-P25:274	khams kyi gnyen thang phyogs su mchod rten bzhengs :	27	khams kyi gnyen thang phyogs su mchod rten bzhengs 
BO_TZ_DZOGCHEN-DESUM-P25:275	ri nag srin po khros 'dra'i ri gsum 'dabs :	27	ri nag srin po khro dra ri gsum dabs 
BO_TZ_DZOGCHEN-DESUM-P25:276	e yi dbyings su mchod rten nag po brtshegs :	27	e yi dbyings su mchod rten nag po brtshegs 
BO_TZ_DZOGCHEN-DESUM-P25:277	lho zla'i phyogs kyi ri bo gcan gzan mgo :	27	lho zla phyogs kyi ri bo gcan gzan mgo 
BO_TZ_DZOGCHEN-DESUM-P25:278	de yi zhol du tshhom bu tshhogs sgrub bya :	27	de yi zhol du tshhom bu tshhogs sgrub byed 
BO_TZ_DZOGCHEN-DESUM-P25:279	lho zla'i bar sgang chu bo nag po'i rgyud :	27	lho zla ba sgang chu bo nag po brgyud 
BO_TZ_DZOGCHEN-DESUM-P25:280	mtshho nag chen po zhol gyi smad dag tu :	28	mtshho nag chen po zhol gyi smad dag tu 
BO_TZ_DZOGCHEN-DESUM-P25:281	seng ge khyi tshhug 'dra ba'i brag ri la :	28	seng ge khyi tshhug dra ba brag ri la 
BO_TZ_DZOGCHEN-DESUM-P25:282	gter chen sbas shing gnas chen byin 'beb bya :	28	gter chen sbed shing gnas chen byin beb byed 
BO_TZ_DZOGCHEN-DESUM-P25:283	de yis khams phyogs bstan 'gro cung zhig bde :	28	de yis khams phyogs ston gro cung jig bde 
BO_TZ_DZOGCHEN-DESUM-P25:284	gzhan yang zhib par lung bstan mdo byang ltos :	28	gzhan yang zhib ba lung ston mdo byang ltos 
BO_TZ_DZOGCHEN-DESUM-P25:285	sgrub thabs lung byang pad+ma'i snying gtam 'di :	28	sgrub thabs lung byang pad+ma snying dam di 
BO_TZ_DZOGCHEN-DESUM-P25:286	ma 'ongs skal ldan bu dang 'phrad par shog :	28	ma ngs skal ldan bu dang phrad ba shog 
BO_TZ_DZOGCHEN-DESUM-P25:287	sa ma ya rgya rgya :	28	sa ma ya rgya rgya 
BO_TZ_DZOGCHEN-DESUM-P25:288	zab rgya : sbas rgya :	28	zab rgya sbed rgya 
BO_TZ_DZOGCHEN-DESUM-P25:289	gter rgya : kha tham:	28	gter rgya kha tham: 
BO_TZ_DZOGCHEN-DESUM-P25:290	gu h+ya :sprul pa'i gter chen mchog gyur gling pas bde chen pad+ma shel phug nas spyan drangs pa'i shog ser las gtan la phab rim bzhin du mtshho skyes bla ma dgyes pa'i 'bangs mkhyen brtshe'i dbang pos bris pa dge	29	gu h+ya :sprul ba gter chen mchog gyur gling ba bde chen pad+ma shel bugs nas spyan drangs ba shog ser las gtan la bebs rim bzhin du mtshho skye bla ma dgyes ba bang mkhyen brtshe dbang pos bri ba dge 
BO_TZ_DZOGCHEN-DESUM-P25:291	/zhus so /// /	29	so 
