segmentnr	original	folio	stemmed
BO_TZ_DZOGCHEN-DESUM-P28:0	\u0f01\u0f83: rdzogs pa chen po sde gsum las :	0	\u0f01\u0f83: rdzogs ba chen po sde gsum las 
BO_TZ_DZOGCHEN-DESUM-P28:1	phyi skor yi dam zhi ba'i sgrub pa bzhugs so :	0	phyi skor yi dam zhi ba sgrub ba bzhugs so 
BO_TZ_DZOGCHEN-DESUM-P28:2	sde gsum phyi skor sems sde /	0	sde gsum phyi skor sems sde 
BO_TZ_DZOGCHEN-DESUM-P28:3	\u0f88\u0f88\u0f88 na mo gu ru :	0	\u0f88\u0f88\u0f88 na mo gu ru 
BO_TZ_DZOGCHEN-DESUM-P28:4	phyi skor yi dam sgrub pa ni :	0	phyi skor yi dam sgrub ba ni 
BO_TZ_DZOGCHEN-DESUM-P28:5	sems nyid ka nas dag pa'i ngang :	0	sems nyid ka nas dag ba ngang 
BO_TZ_DZOGCHEN-DESUM-P28:6	ma bcos lhun grub cir yang gsal :	0	ma chos lhun grub cir yang gsal 
BO_TZ_DZOGCHEN-DESUM-P28:7	sgom med ngang du rang shar du :	0	sgom med ngang du rang char du 
BO_TZ_DZOGCHEN-DESUM-P28:8	ye shes chen po'i gzhal yas khang :	0	ye shes chen po jal yas khang 
BO_TZ_DZOGCHEN-DESUM-P28:9	nang du tshhom bu dgu yi tshhul :	0	nang du tshhom bu dgu yi tshhul 
BO_TZ_DZOGCHEN-DESUM-P28:10	dbus su rnam par snang mdzad ni :	1	dbus su rnam ba snang mdzad ni 
BO_TZ_DZOGCHEN-DESUM-P28:11	dkar gsal zhal gsum phyag drug pa :	1	dkar gsal zhal gsum phyag drug ba 
BO_TZ_DZOGCHEN-DESUM-P28:12	g.yas g.yon 'khor lo rdo rje dang : rin chen pad+ma rgya gram dril :	1	g.yas g.yon khor lo rdo rje dang rin chen pad+ma rgya grams dril 
BO_TZ_DZOGCHEN-DESUM-P28:13	yum ni dbyings phyug ma dang 'khril :	1	yum ni dbyings phyug ma dang khril 
BO_TZ_DZOGCHEN-DESUM-P28:14	rigs bzhi yab yum gtsho 'khor bcu :	1	rigs bzhi yab yum gtsho khor chu 
BO_TZ_DZOGCHEN-DESUM-P28:15	a+o~m hu~m tram hriha:	1	a+o~m hu~m tram hriha: 
BO_TZ_DZOGCHEN-DESUM-P28:16	mum lam mam pam tam:	1	mum lam mam pam tam: 
BO_TZ_DZOGCHEN-DESUM-P28:17	dz+nya na satwa hu~m:	1	dz+nya na satwa hu~m: 
BO_TZ_DZOGCHEN-DESUM-P28:18	shar gyi dkyil 'khor chen po'i dbus :	1	char gyi dkyil khor chen po dbus 
BO_TZ_DZOGCHEN-DESUM-P28:19	rdo rje sems dpa' dkar gsal mdangs :	1	rdo rje sems dpa dkar gsal mdangs 
BO_TZ_DZOGCHEN-DESUM-P28:20	zhal gsum phyag drug longs sku'i chas :	2	zhal gsum phyag drug longs sku cha 
BO_TZ_DZOGCHEN-DESUM-P28:21	rdo rje gtshor gyur phyag mtshhan 'dzin :	2	rdo rje gtshor gyur phyag mtshhan dzin 
BO_TZ_DZOGCHEN-DESUM-P28:22	yum ni snyems ma gnyis med sbyor :	2	yum ni snyems ma gnyis med sbyor 
BO_TZ_DZOGCHEN-DESUM-P28:23	rigs chung gtsho 'khor bcu ru gsal :	2	rigs chung gtsho khor chu ru gsal 
BO_TZ_DZOGCHEN-DESUM-P28:24	a+o~m badzra satwa a:	2	a+o~m badzra satwa a: 
BO_TZ_DZOGCHEN-DESUM-P28:25	lho yi dkyil 'khor chen po ru :	2	lho yi dkyil khor chen po ru 
BO_TZ_DZOGCHEN-DESUM-P28:26	'jam dpal gzhon nu ser gsal mdangs :	2	jam dpal gzhon nu ser gsal mdangs 
BO_TZ_DZOGCHEN-DESUM-P28:27	zhal gsum phyag drug longs sku'i chas :	2	zhal gsum phyag drug longs sku cha 
BO_TZ_DZOGCHEN-DESUM-P28:28	ral gri gtshor gyur phyag mtshhan 'dzin :	2	ral gri gtshor gyur phyag mtshhan dzin 
BO_TZ_DZOGCHEN-DESUM-P28:29	yum ni gnyis med girti ma :	2	yum ni gnyis med girti ma 
BO_TZ_DZOGCHEN-DESUM-P28:30	rigs chung gtsho 'khor bcu ru gsal :	3	rigs chung gtsho khor chu ru gsal 
BO_TZ_DZOGCHEN-DESUM-P28:31	a+o~m many+dzu shri mum:	3	a+o~m many+dzu shri mum: 
BO_TZ_DZOGCHEN-DESUM-P28:32	nub kyi dkyil 'khor chen po ru :	3	nub kyi dkyil khor chen po ru 
BO_TZ_DZOGCHEN-DESUM-P28:33	'jig rten dbang phyug sku mdog dmar :	3	jig rten dbang phyug sku mdog dmar 
BO_TZ_DZOGCHEN-DESUM-P28:34	zhal gsum phyag drug longs sku'i chas :	3	zhal gsum phyag drug longs sku cha 
BO_TZ_DZOGCHEN-DESUM-P28:35	pad+ma gtshor gyur phyag mtshhan 'dzin :	3	pad+ma gtshor gyur phyag mtshhan dzin 
BO_TZ_DZOGCHEN-DESUM-P28:36	yum ni gnyis med ma l+ya ma :	3	yum ni gnyis med ma l+ya ma 
BO_TZ_DZOGCHEN-DESUM-P28:37	rigs chung gtsho 'khor bcu ru gsal :	3	rigs chung gtsho khor chu ru gsal 
BO_TZ_DZOGCHEN-DESUM-P28:38	a+o~m ar+ya a wa lo ki shwa ra hri:	3	a+o~m ar+ya a wa lo ki shwa ra hri: 
BO_TZ_DZOGCHEN-DESUM-P28:39	byang gi dkyil 'khor chen po ru :	3	byang gi dkyil khor chen po ru 
BO_TZ_DZOGCHEN-DESUM-P28:40	phyag na rdo rje sku mdog mthing :	4	phyag na rdo rje sku mdog mthing 
BO_TZ_DZOGCHEN-DESUM-P28:41	zhal gsum phyag drug longs sku'i chas :	4	zhal gsum phyag drug longs sku cha 
BO_TZ_DZOGCHEN-DESUM-P28:42	rdo rje gtshor gyur phyag mtshhan 'dzin :	4	rdo rje gtshor gyur phyag mtshhan dzin 
BO_TZ_DZOGCHEN-DESUM-P28:43	yum ni gnyis med nirti ma :	4	yum ni gnyis med nirti ma 
BO_TZ_DZOGCHEN-DESUM-P28:44	rigs chung gtsho 'khor bcu ru gsal :	4	rigs chung gtsho khor chu ru gsal 
BO_TZ_DZOGCHEN-DESUM-P28:45	a+o~m badzra pa ni hu~m:	4	a+o~m badzra ba ni hu~m: 
BO_TZ_DZOGCHEN-DESUM-P28:46	shar lhor kun bzang rdo rje 'chang :	4	char lhor kun bzang rdo rje chang 
BO_TZ_DZOGCHEN-DESUM-P28:47	mthing gsal zhal gsum phyag drug pa :	4	mthing gsal zhal gsum phyag drug ba 
BO_TZ_DZOGCHEN-DESUM-P28:48	rdo rje gtshor gyur phyag mtshhan 'dzin :	4	rdo rje gtshor gyur phyag mtshhan dzin 
BO_TZ_DZOGCHEN-DESUM-P28:49	yum ni gnyis med me tog ma :	4	yum ni gnyis med me tog ma 
BO_TZ_DZOGCHEN-DESUM-P28:50	rigs chung gtsho 'khor bcu ru gsal :	5	rigs chung gtsho khor chu ru gsal 
BO_TZ_DZOGCHEN-DESUM-P28:51	a+o~m sa man+ta b+ha dra hu~m:	5	a+o~m sa man+ta b+ha dra hu~m: 
BO_TZ_DZOGCHEN-DESUM-P28:52	lho nub dkyil 'khor chen po ru :	5	lho nub dkyil khor chen po ru 
BO_TZ_DZOGCHEN-DESUM-P28:53	nam mkha'i snying po sku mdog ser :	5	nam mkha snying po sku mdog ser 
BO_TZ_DZOGCHEN-DESUM-P28:54	zhal gsum phyag drug longs sku'i chas :	5	zhal gsum phyag drug longs sku cha 
BO_TZ_DZOGCHEN-DESUM-P28:55	rin chen gtshor gyur phyag mtshhan 'dzin :	5	rin chen gtshor gyur phyag mtshhan dzin 
BO_TZ_DZOGCHEN-DESUM-P28:56	yum ni gnyis med bdug spos ma :	5	yum ni gnyis med bdug spros ma 
BO_TZ_DZOGCHEN-DESUM-P28:57	rigs chung gtsho 'khor bcu ru gsal :	5	rigs chung gtsho khor chu ru gsal 
BO_TZ_DZOGCHEN-DESUM-P28:58	a+o~m kha gar+b+ha tram:	5	a+o~m kha gar+b+ha tram: 
BO_TZ_DZOGCHEN-DESUM-P28:59	nub byang dkyil 'khor chen po ru :	5	nub byang dkyil khor chen po ru 
BO_TZ_DZOGCHEN-DESUM-P28:60	sa yi snying po sku mdog dkar :	6	sa yi snying po sku mdog dkar 
BO_TZ_DZOGCHEN-DESUM-P28:61	zhal gsum phyag drug longs sku'i chas :	6	zhal gsum phyag drug longs sku cha 
BO_TZ_DZOGCHEN-DESUM-P28:62	pad+ma gtshor gyur phyag mtshhan 'dzin :	6	pad+ma gtshor gyur phyag mtshhan dzin 
BO_TZ_DZOGCHEN-DESUM-P28:63	yum ni gnyis med mar me ma :	6	yum ni gnyis med mar me ma 
BO_TZ_DZOGCHEN-DESUM-P28:64	rigs chung gtsho 'khor bcu ru gsal :	6	rigs chung gtsho khor chu ru gsal 
BO_TZ_DZOGCHEN-DESUM-P28:65	a+o~m k+shim hi ra dza hu~m:	6	a+o~m k+shim hi ra dza hu~m: 
BO_TZ_DZOGCHEN-DESUM-P28:66	byang shar dkyil 'khor chen po ru :	6	byang char dkyil khor chen po ru 
BO_TZ_DZOGCHEN-DESUM-P28:67	byams pa mgon po sku mdog ljang :	6	byams ba mgon po sku mdog ljang 
BO_TZ_DZOGCHEN-DESUM-P28:68	zhal gsum phyag drug longs sku'i chas :	6	zhal gsum phyag drug longs sku cha 
BO_TZ_DZOGCHEN-DESUM-P28:69	ral gri gtshor gyur phyag mtshhan 'dzin :	6	ral gri gtshor gyur phyag mtshhan dzin 
BO_TZ_DZOGCHEN-DESUM-P28:70	yum ni gnyis med dri chab ma :	7	yum ni gnyis med dri chab ma 
BO_TZ_DZOGCHEN-DESUM-P28:71	rigs chung gtsho 'khor bcu ru gsal :	7	rigs chung gtsho khor chu ru gsal 
BO_TZ_DZOGCHEN-DESUM-P28:72	a+o~m mai tri d+ha ra a:	7	a+o~m mai tri d+ha ra a: 
BO_TZ_DZOGCHEN-DESUM-P28:73	khyams kyi phyogs mtshhams thams cad du :	7	khyams kyi phyogs mtshhams thams cad du 
BO_TZ_DZOGCHEN-DESUM-P28:74	bya byed thub pa drug bcas gsal :	7	byed byed thub ba drug cha gsal 
BO_TZ_DZOGCHEN-DESUM-P28:75	sgo bzhir ta kr-ita? yab yum brgyad :	7	sgo bzhir ta kr-ita? yab yum brgyad 
BO_TZ_DZOGCHEN-DESUM-P28:76	zhi ba dbyings kyi dkyil 'khor gsal :	7	zhi ba dbyings kyi dkyil khor gsal 
BO_TZ_DZOGCHEN-DESUM-P28:77	bskyed pa'i sngags rnams dzapa? tu bzlas :	7	skyed ba sngags rnams dzapa? tu bzlas 
BO_TZ_DZOGCHEN-DESUM-P28:78	phyi skor yi dam sgrub pa 'o :	7	phyi skor yi dam sgrub ba mang 
BO_TZ_DZOGCHEN-DESUM-P28:79	sa ma ya rgya rgya :gter chen mchog gyur gling pas pad+ma shel phug nas spyan drangs pa'i shog ser las phab rim bzhin mkhyen brtshe'i dbang pos bris pa dge	7	sa ma ya rgya rgya :gter chen mchog gyur gling ba pad+ma shel bugs nas spyan drangs ba shog ser las bebs rim bzhin mkhyen brtshe dbang pos bri ba dge 
BO_TZ_DZOGCHEN-DESUM-P28:80	/sarba da mang+ga lam///	8	da mang+ga 
