segmentnr	original	folio	stemmed
BO_TZ_DZOGCHEN-DESUM-P97:0	sde gsum phyi skor /	0	sde gsum phyi skor 
BO_TZ_DZOGCHEN-DESUM-P97:1	drwa ma lnga /	0	drwa ma lnga 
BO_TZ_DZOGCHEN-DESUM-P97:2	rgyal po dzah dga' rab rdo rje /	0	rgyal po dzah dga rab rdo rje 
BO_TZ_DZOGCHEN-DESUM-P97:3	'jam dpal bshes gnyen bcas kyi mthar /	0	jam dpal bshes gnyen cha kyi mthar 
BO_TZ_DZOGCHEN-DESUM-P97:4	rdor gling lta ba klong yangs mkhas pa nyer lnga'i glu las /	0	rdar gling lta ba klong yangs mkhas ba nyer lnga glu las 
BO_TZ_DZOGCHEN-DESUM-P97:5	sems sde'i mkhas pa bco brgyad kyi dgongs nyams ni /khyung chen gyi dgongs pa /	0	sems sde mkhas ba chos brgyad kyi dgongs nyams ni chen gyi dgongs ba 
BO_TZ_DZOGCHEN-DESUM-P97:6	chos nyid klong rdol glu yi bsam gtan /	0	chos nyid klong rdol glu yi bsam gtan 
BO_TZ_DZOGCHEN-DESUM-P97:7	tshan+dan gyi nags tshhal du nam gyi gung la /	0	tshan+dan gyi nags tshhal du nam gyi gung la 
BO_TZ_DZOGCHEN-DESUM-P97:8	rgyal po d+ha hi na ta los 'di skad lo //	0	rgyal po d+ha hi na ta los di skad lo 
BO_TZ_DZOGCHEN-DESUM-P97:9	ho : bdag ni d+ha he ta lo ste :	0	ho bdag ni d+ha he ta lo ste 
BO_TZ_DZOGCHEN-DESUM-P97:10	rig pa bde brdal byang chub sems :	1	rig ba bde rdal byang chub sems 
BO_TZ_DZOGCHEN-DESUM-P97:11	dbang bskur dkyil 'khor cho ga med :	1	dbang skur dkyil khor cho ga med 
BO_TZ_DZOGCHEN-DESUM-P97:12	rang gis rang nyid rang gsal bas :	1	rang gis rang nyid rang gsal ba 
BO_TZ_DZOGCHEN-DESUM-P97:13	'khor 'das chos tshhig der zad do :	1	khor da chos tshhig der zad do 
BO_TZ_DZOGCHEN-DESUM-P97:14	g+hi ta ma ko sa la a ho :rig pa'i khu byug gi dgongs pa /	1	g+hi ta ma ko sa la a ho :rig ba khu byug gi dgongs ba 
BO_TZ_DZOGCHEN-DESUM-P97:15	rig pa klong rdol glu'i bsam gtan /	1	rig ba klong rdol glu bsam gtan 
BO_TZ_DZOGCHEN-DESUM-P97:16	tshan+dan gor shir+sha'i tshhal du nam gyi cha stod la /	1	tshan+dan gor shir+sha tshhal du nam gyi cha stod la 
BO_TZ_DZOGCHEN-DESUM-P97:17	sras thu bo ra dza hastis 'di skad lo //	1	sras thu bo ra dza hastis di skad lo 
BO_TZ_DZOGCHEN-DESUM-P97:18	ho : bdag ni ra dza hasti ste :	1	ho bdag ni ra dza hasti ste 
BO_TZ_DZOGCHEN-DESUM-P97:19	dmyal ba btsho sreg snang yang rang sems mdangs :	1	dmyal ba btsho sreg snang yang rang sems mdangs 
BO_TZ_DZOGCHEN-DESUM-P97:20	sangs rgyas zhing khams snang yang rang sems rtshal :	2	sangs rgya zhing khams snang yang rang sems rtshal 
BO_TZ_DZOGCHEN-DESUM-P97:21	gnyis med gnyis su byar med tha mi dad :	2	gnyis med gnyis su byar med tha mi dad 
BO_TZ_DZOGCHEN-DESUM-P97:22	dgongs pa'i don dril tshhig de'i bcud khug cig :	2	dgongs ba don dril tshhig de bcud khug cig 
BO_TZ_DZOGCHEN-DESUM-P97:23	g+hi ta ma ko la sa a hohnam mkha' che'i dgongs pa /	2	g+hi ta ma ko la sa a hohnam mkha che dgongs ba 
BO_TZ_DZOGCHEN-DESUM-P97:24	ye shes klong rdol glu yi bsam gtan /	2	ye shes klong rdol glu yi bsam gtan 
BO_TZ_DZOGCHEN-DESUM-P97:25	me tog u dum ba ra'i tshhal du nam smad kyi cha la /	2	me tog u dum ba ra tshhal du nam smad kyi cha la 
BO_TZ_DZOGCHEN-DESUM-P97:26	sras mo sa ra nis 'di skad lo //	2	sras mo sa ra nis di skad lo 
BO_TZ_DZOGCHEN-DESUM-P97:27	ho : bdag ni sras mo dran pa ste :	2	ho bdag ni sras mo dran ba ste 
BO_TZ_DZOGCHEN-DESUM-P97:28	byang chub sems la bzang ngan med :	2	byang chub sems la bzang ngan med 
BO_TZ_DZOGCHEN-DESUM-P97:29	snang ba'i yul la nye ring med :	2	snang ba yul la nye ring med 
BO_TZ_DZOGCHEN-DESUM-P97:30	nyams len snying por ma gyur med :	3	nyams len snying por ma gyur med 
BO_TZ_DZOGCHEN-DESUM-P97:31	tshhogs drug ma spang gsal 'debs yin :	3	tshhogs drug ma spong gsal debs yin 
BO_TZ_DZOGCHEN-DESUM-P97:32	g+hi ta ma ko la hohthig le drug pa'i dgongs pa /	3	g+hi ta ma ko la hohthig le drug ba dgongs ba 
BO_TZ_DZOGCHEN-DESUM-P97:33	bde ba klong rdol glu'i bsam gtan /	3	bde ba klong rdol glu bsam gtan 
BO_TZ_DZOGCHEN-DESUM-P97:34	skya rengs dang po shar tsham na /	3	skya rengs dang po char tsham na 
BO_TZ_DZOGCHEN-DESUM-P97:35	rgya mtshho'i gting rum du klu'i rgyal pos 'di skad do //	3	rgya mtshho gting rum du klu rgyal pos di skad do 
BO_TZ_DZOGCHEN-DESUM-P97:36	ho : bdag ni klu rgyal dga' bo ste :	3	ho bdag ni klu rgyal dga bo ste 
BO_TZ_DZOGCHEN-DESUM-P97:37	rmad byung rdzogs pa chen po 'di :	3	rmad byung rdzogs ba chen po di 
BO_TZ_DZOGCHEN-DESUM-P97:38	khams gsum sems can kun la khyab :	3	khams gsum sems can kun la khyab 
BO_TZ_DZOGCHEN-DESUM-P97:39	stong gsal 'dzin med snying nang nas :	3	stong gsal dzin med snying nang nas 
BO_TZ_DZOGCHEN-DESUM-P97:40	yul drug kun la 'char zhing spro :	4	yul drug kun la char zhing spro 
BO_TZ_DZOGCHEN-DESUM-P97:41	rang grol chen po a la la :	4	rang grol chen po a la la 
BO_TZ_DZOGCHEN-DESUM-P97:42	g+hi ta ma ko la sa a hohrtshal chen gyi dgongs pa /	4	g+hi ta ma ko la sa a hohrtshal chen gyi dgongs ba 
BO_TZ_DZOGCHEN-DESUM-P97:43	byang sems klong rdol glu yi bsam gtan /	4	byang sems klong rdol glu yi bsam gtan 
BO_TZ_DZOGCHEN-DESUM-P97:44	skya rengs gnyis pa shar tsham na /	4	skya rengs gnyis ba char tsham na 
BO_TZ_DZOGCHEN-DESUM-P97:45	rgya mtshho'i gling du khyi yi rgyal po ku ku ra dzas 'di skad lo //	4	rgya mtshho gling du khyi yi rgyal po ku ku ra dzas di skad lo 
BO_TZ_DZOGCHEN-DESUM-P97:46	ho : bdag ni khyi yi mkhan po snga ma ste :	4	ho bdag ni khyi yi mkhan po snga ma ste 
BO_TZ_DZOGCHEN-DESUM-P97:47	tshhe 'dir lta sgom mthar phyin bar do chod :	4	tshhe dir lta sgom mthar phyin ba do chod 
BO_TZ_DZOGCHEN-DESUM-P97:48	'chi khar nam mkha' phyi nang 'dres pa 'dra :	4	chi khar nam mkha phyi nang dre ba dra 
BO_TZ_DZOGCHEN-DESUM-P97:49	skye ba rang gar mi 'khyams rang snang rang dbang thob :	4	skye ba rang gar mi khyam rang snang rang dbang thob 
BO_TZ_DZOGCHEN-DESUM-P97:50	g+hi ta ma ko la hohsems sgom gyi dgongs pa /	5	g+hi ta ma ko la hohsems sgom gyi dgongs ba 
BO_TZ_DZOGCHEN-DESUM-P97:51	dbyings rdol glu yi bsam gtan /	5	dbyings rdol glu yi bsam gtan 
BO_TZ_DZOGCHEN-DESUM-P97:52	rgyan chags dpal gyi ri'i nags su skya rengs gsum pa shar tsham na /	5	rgyan chags dpal gyi ri nags su skya rengs gsum ba char tsham na 
BO_TZ_DZOGCHEN-DESUM-P97:53	na gardzu nas 'di skad do //	5	na gardzu nas di skad do 
BO_TZ_DZOGCHEN-DESUM-P97:54	ho : bdag ni 'phags pa klu sgrub ste :	5	ho bdag ni phag ba klu sgrub ste 
BO_TZ_DZOGCHEN-DESUM-P97:55	rang sems nga bdag rtshad bcad pas :	5	rang sems nga bdag rtshad gcod ba 
BO_TZ_DZOGCHEN-DESUM-P97:56	phyi nang thams cad stong par grol :	5	phyi nang thams cad stong ba grol 
BO_TZ_DZOGCHEN-DESUM-P97:57	stong nyid bco brgyad gtan la phebs :	5	stong nyid chos brgyad gtan la phebs 
BO_TZ_DZOGCHEN-DESUM-P97:58	skye 'chi 'pho 'gyur gang dga' mdzod :	5	skye chi pho gyur gang dga mdzod 
BO_TZ_DZOGCHEN-DESUM-P97:59	g+hi ta ma ko la sa hohrmad byung gi dgongs pa /	5	g+hi ta ma ko la sa hohrmad byung gi dgongs ba 
BO_TZ_DZOGCHEN-DESUM-P97:60	'byung lnga ye shes klong rdol glu yi bsam gtan /	6	byung lnga ye shes klong rdol glu yi bsam gtan 
BO_TZ_DZOGCHEN-DESUM-P97:61	dmar rengs dang po shar tsham na rgya mtshho'i 'gram du khyi yi rgyal po phyi mas 'di skad lo //	6	dmar rengs dang po char tsham na rgya mtshho grams du khyi yi rgyal po phyi mas di skad lo 
BO_TZ_DZOGCHEN-DESUM-P97:62	ho : bdag ni khyi yi mkhan po phyi ma ste :	6	ho bdag ni khyi yi mkhan po phyi ma ste 
BO_TZ_DZOGCHEN-DESUM-P97:63	yod par 'dzin na rtag pa'i mtha':	6	yod ba dzin na rtag ba mtha: 
BO_TZ_DZOGCHEN-DESUM-P97:64	med par 'dzin na chad pa'i mtha':	6	med ba dzin na chad ba mtha: 
BO_TZ_DZOGCHEN-DESUM-P97:65	yod min med min ma yin par :	6	yod min med min ma yin ba 
BO_TZ_DZOGCHEN-DESUM-P97:66	stong gsal 'dzin med rjen ce re :	6	stong gsal dzin med rjen ce re 
BO_TZ_DZOGCHEN-DESUM-P97:67	de las bdag la bshad rgyu med :	6	de las bdag la chad rgyu med 
BO_TZ_DZOGCHEN-DESUM-P97:68	g+hi ta ma ko la sa a hohyid bzhin nor bu'i dgongs pa /	6	g+hi ta ma ko la sa a hohyid bzhin nor bu dgongs ba 
BO_TZ_DZOGCHEN-DESUM-P97:69	dngos grub klong rdol glu yi bsam gtan /	6	dngos grub klong rdol glu yi bsam gtan 
BO_TZ_DZOGCHEN-DESUM-P97:70	dmar rengs gnyis pa shar tsham na /	7	dmar rengs gnyis ba char tsham na 
BO_TZ_DZOGCHEN-DESUM-P97:71	gnod sbyin mo byang chub 'di skad lo //	7	gnod sbyin mo byang chub di skad lo 
BO_TZ_DZOGCHEN-DESUM-P97:72	ho : bdag ni gnod sbyin byang chub mo :	7	ho bdag ni gnod sbyin byang chub mo 
BO_TZ_DZOGCHEN-DESUM-P97:73	yul drug mi 'gegs rang grol spyod :	7	yul drug mi gegs rang grol spyod 
BO_TZ_DZOGCHEN-DESUM-P97:74	ji ltar rol yang bogs su che :	7	ji ltar rol yang bogs su che 
BO_TZ_DZOGCHEN-DESUM-P97:75	rang rig rgyal po'i dbang chen thob :	7	rang rig rgyal po dbang chen thob 
BO_TZ_DZOGCHEN-DESUM-P97:76	tshhogs drug lhug bzhag a la la :	7	tshhogs drug lhug jog a la la 
BO_TZ_DZOGCHEN-DESUM-P97:77	g+hi ta ma ko la sa a hohrtshe mo byung rgyal gyi dgongs pa /	7	g+hi ta ma ko la sa a hohrtshe mo byung rgyal gyi dgongs ba 
BO_TZ_DZOGCHEN-DESUM-P97:78	rtshol med klong rdol glu'i bsam gtan /	7	rtshol med klong rdol glu bsam gtan 
BO_TZ_DZOGCHEN-DESUM-P97:79	shing nal byi sa la'i rtshar dmar rengs gsum pa shar tsham na /	7	shing nal byi sa la rtshar dmar rengs gsum ba char tsham na 
BO_TZ_DZOGCHEN-DESUM-P97:80	smad 'tshhong ma bud+d+ha ma tis 'di skad lo //	8	smad tshhong ma bud+d+ha ma tis di skad lo 
BO_TZ_DZOGCHEN-DESUM-P97:81	ho : bdag ni smad tshhong bdag nyid ma :	8	ho bdag ni smad tshhong bdag nyid ma 
BO_TZ_DZOGCHEN-DESUM-P97:82	ci yang yid la mi byed pas :	8	ci yang yid la mi byed ba 
BO_TZ_DZOGCHEN-DESUM-P97:83	shes rab pha rol phyin ma yin :	8	shes rab pha rol phyin ma yin 
BO_TZ_DZOGCHEN-DESUM-P97:84	lus sems gang la'ang mi chags pa :	8	lus sems gang la mi chags ba 
BO_TZ_DZOGCHEN-DESUM-P97:85	tshhul khrims kun gyi mthar thug yin :	8	tshhul khrims kun gyi mthar thug yin 
BO_TZ_DZOGCHEN-DESUM-P97:86	gang la'ang re dogs bral ba 'di :	8	gang la re dogs bral ba di 
BO_TZ_DZOGCHEN-DESUM-P97:87	lam lnga sa bcu'i mthar thug yin :	8	lam lnga sa chu mthar thug yin 
BO_TZ_DZOGCHEN-DESUM-P97:88	g+hi ta ma ko la sa a hohspyi gcod kyi dgongs pa /	8	g+hi ta ma ko la sa a hohspyi gcod kyi dgongs ba 
BO_TZ_DZOGCHEN-DESUM-P97:89	gsang ba klong rdol glu'i bsam gtan /	8	gsang ba klong rdol glu bsam gtan 
BO_TZ_DZOGCHEN-DESUM-P97:90	shing n+ya gro d+ha'i rtsha bar srod thun la 'jam dpal bshes gnyen phyi mas 'di skad lo //	9	shing n+ya gro d+ha rtsha ba srod thun la jam dpal bshes gnyen phyi mas di skad lo 
BO_TZ_DZOGCHEN-DESUM-P97:91	ho : bdag ni 'jam dpal gshes gnyen phyi ma ste :	9	ho bdag ni jam dpal gshes gnyen phyi ma ste 
BO_TZ_DZOGCHEN-DESUM-P97:92	rgyu dag pad+ma'i rtshe las skyes :	9	rgyu dag pad+ma rtshe las skye 
BO_TZ_DZOGCHEN-DESUM-P97:93	rkyen dag a ti'i don rnams rtogs :	9	rkyen dag a ti don rnams rtogs 
BO_TZ_DZOGCHEN-DESUM-P97:94	'bras bu dag pas sku gsum thob :	9	bras bu dag ba sku gsum thob 
BO_TZ_DZOGCHEN-DESUM-P97:95	bsgom bya'i rtshol ba skyur thongs la :	9	bsgom byed rtshol ba skyur thongs la 
BO_TZ_DZOGCHEN-DESUM-P97:96	sgom byed sems kyi zel ma 'jug :	9	sgom byed sems kyi zel ma jug 
BO_TZ_DZOGCHEN-DESUM-P97:97	pad+ma ko la sha a hohspyi chings kyi dgongs pa /	9	pad+ma ko la sha a hohspyi ching kyi dgongs ba 
BO_TZ_DZOGCHEN-DESUM-P97:98	nam mkha' klong rdol glu'i bsam gtan /	9	nam mkha klong rdol glu bsam gtan 
BO_TZ_DZOGCHEN-DESUM-P97:99	dpag bsam shing gi grib ma la /	9	dpog bsam shing gi grib ma la 
BO_TZ_DZOGCHEN-DESUM-P97:100	tho rengs khar ar+ya pa los 'di skad lo //	10	tho rengs khar ar+ya ba los di skad lo 
BO_TZ_DZOGCHEN-DESUM-P97:101	hoh byang chub sems ni nam mkha' lta bu'i klong //	10	hoh byang chub sems ni nam mkha lta bu klong 
BO_TZ_DZOGCHEN-DESUM-P97:102	gsal la rtog pa med pa'i ye shes ni //	10	gsal la rtogs ba med ba ye shes ni 
BO_TZ_DZOGCHEN-DESUM-P97:103	phyi dang nang med kun la gsal bar gnas //	10	phyi dang nang med kun la gsal ba gnas 
BO_TZ_DZOGCHEN-DESUM-P97:104	sangs rgyas dgongs pa 'di las med par mjal //	10	sangs rgya dgongs ba di las med ba mjal 
BO_TZ_DZOGCHEN-DESUM-P97:105	e ma ko la sha a hohbde ba phra bkod kyi dgongs pa /	10	e ma ko la sha a hohbde ba phra bkod kyi dgongs ba 
BO_TZ_DZOGCHEN-DESUM-P97:106	phrin las klong rdol glu'i bsam gtan /	10	phrin las klong rdol glu bsam gtan 
BO_TZ_DZOGCHEN-DESUM-P97:107	rin po che'i gling du nam gung yol la /	10	rin po che gling du nam gung yol la 
BO_TZ_DZOGCHEN-DESUM-P97:108	o rgyan gyi mkhan po d+ha hes 'di skad lo //	10	o rgyan gyi mkhan po d+ha hes di skad lo 
BO_TZ_DZOGCHEN-DESUM-P97:109	ho : bdag ni o rgyan mkhan po ste :	10	ho bdag ni o rgyan mkhan po ste 
BO_TZ_DZOGCHEN-DESUM-P97:110	ma ha ra dzas dgongs pa dril te bstan :	11	ma ha ra dzas dgongs ba dril te ston 
BO_TZ_DZOGCHEN-DESUM-P97:111	sems la rtsha ba gcad rgyu med :	11	sems la rtsha ba gcod rgyu med 
BO_TZ_DZOGCHEN-DESUM-P97:112	med pa de ka chod pa yin :	11	med ba de ka chod ba yin 
BO_TZ_DZOGCHEN-DESUM-P97:113	sems la bltas pas mthong rgyu med :	11	sems la lta ba mthong rgyu med 
BO_TZ_DZOGCHEN-DESUM-P97:114	med pa de ka rang mthong yin :	11	med ba de ka rang mthong yin 
BO_TZ_DZOGCHEN-DESUM-P97:115	mthong med ngang la ma yengs skyongs :	11	mthong med ngang la ma yengs skyongs 
BO_TZ_DZOGCHEN-DESUM-P97:116	karmako la sha a hohsrog gi 'khor lo'i dgongs pa /	11	karmako la sha a hohsrog gi khor lo dgongs ba 
BO_TZ_DZOGCHEN-DESUM-P97:117	rang byung klong rdol glu'i bsam gtan /	11	rang byung klong rdol glu bsam gtan 
BO_TZ_DZOGCHEN-DESUM-P97:118	n+ya gro d+ha'i dgon par srod yol gyi dus su /	11	n+ya gro d+ha dgon ba srod yol gyi dus su 
BO_TZ_DZOGCHEN-DESUM-P97:119	drang srong b+hi shwa tis 'di skad lo //	11	dren srong b+hi shwa tis di skad lo 
BO_TZ_DZOGCHEN-DESUM-P97:120	ho : bdag ni drang srong b+ha shi ste :	12	ho bdag ni dren srong b+ha chi ste 
BO_TZ_DZOGCHEN-DESUM-P97:121	khregs chod don la rtshol med bzhag :	12	khregs chod don la rtshol med jog 
BO_TZ_DZOGCHEN-DESUM-P97:122	thod rgal ngang la yengs med bzhag :	12	thod rgal ngang la yengs med jog 
BO_TZ_DZOGCHEN-DESUM-P97:123	snang ba rig mdangs rtshal rdzogs nas :	12	snang ba rig mdangs rtshal rdzogs nas 
BO_TZ_DZOGCHEN-DESUM-P97:124	rang dbang skye 'jug 'od lus thob :	12	rang dbang skye jug d lus thob 
BO_TZ_DZOGCHEN-DESUM-P97:125	a ka sha ko la ma d+ha a hohrin chen kun 'dus kyi dgongs pa /	12	a ka sha ko la ma d+ha a hohrin chen kun du kyi dgongs ba 
BO_TZ_DZOGCHEN-DESUM-P97:126	skye med klong rdol glu'i bsam gtan /	12	skye med klong rdol glu bsam gtan 
BO_TZ_DZOGCHEN-DESUM-P97:127	rgyal ba'i dgon gnas su nam smad la sras mo go ma de bis 'di skad lo //	12	rgyal ba dgon gnas su nam smad la sras mo go ma de bis di skad lo 
BO_TZ_DZOGCHEN-DESUM-P97:128	ho : bdag ni sras mo go ma d+he byi ste :	12	ho bdag ni sras mo go ma d+he byi ste 
BO_TZ_DZOGCHEN-DESUM-P97:129	'byung lnga rigs kyi yum lnga la :	12	byung lnga rigs kyi yum lnga la 
BO_TZ_DZOGCHEN-DESUM-P97:130	phung lnga rigs kyi yab lnga yin :	13	phung lnga rigs kyi yab lnga yin 
BO_TZ_DZOGCHEN-DESUM-P97:131	khams dang skye mched sems dpa' sems ma yin :	13	khams dang skye mched sems dpa sems ma yin 
BO_TZ_DZOGCHEN-DESUM-P97:132	kun gzhi skye med kun bzang yum :	13	kun gzhi skye med kun bzang yum 
BO_TZ_DZOGCHEN-DESUM-P97:133	yid kyi rtog pa kun bzang yab :	13	yid kyi rtogs ba kun bzang yab 
BO_TZ_DZOGCHEN-DESUM-P97:134	rin chen gser gling rdo btshal ltar :	13	rin chen gser gling rdo btshal ltar 
BO_TZ_DZOGCHEN-DESUM-P97:135	'khrul yul 'khrul rgyu btshal mi rnyed :	13	khrul yul khrul rgyu btshal mi rnyed 
BO_TZ_DZOGCHEN-DESUM-P97:136	ka pa la ka ma pa sha a hohskye med rang rig gi dgongs pa /	13	ka ba la ka ma ba sha a hohskye med rang rig gi dgongs ba 
BO_TZ_DZOGCHEN-DESUM-P97:137	chos sku klong rdol glu'i bsam gtan /	13	chos sku klong rdol glu bsam gtan 
BO_TZ_DZOGCHEN-DESUM-P97:138	tshan+dan sdong po'i rtshar gung thun la /	13	tshan+dan sdong po rtshar gung thun la 
BO_TZ_DZOGCHEN-DESUM-P97:139	kha che'i rgyal po rab snang mdzad 'di skad lo //	13	kha che rgyal po rab snang mdzad di skad lo 
BO_TZ_DZOGCHEN-DESUM-P97:140	ho : bdag ni mkhan po rab snang ste :	14	ho bdag ni mkhan po rab snang ste 
BO_TZ_DZOGCHEN-DESUM-P97:141	sems la skye shi med par rab rtogs pas :	14	sems la skye chi med ba rab rtogs ba 
BO_TZ_DZOGCHEN-DESUM-P97:142	lus la shi dang ma shi med par grol :	14	lus la chi dang ma chi med ba grol 
BO_TZ_DZOGCHEN-DESUM-P97:143	lung las ma byung gdams ngag kho bos rnyed :	14	lung las ma byung doms ngag kho bod rnyed 
BO_TZ_DZOGCHEN-DESUM-P97:144	sgom la mi re 'dod zhig ngang na bde :	14	sgom la mi re dod jig ngang na bde 
BO_TZ_DZOGCHEN-DESUM-P97:145	ka la pa ko sha a hohbde ba rab 'byams kyi dgongs pa /	14	ka la ba ko sha a hohbde ba rab byam kyi dgongs ba 
BO_TZ_DZOGCHEN-DESUM-P97:146	sku gsum klong rdol glu'i bsam gtan /	14	sku gsum klong rdol glu bsam gtan 
BO_TZ_DZOGCHEN-DESUM-P97:147	grong khyer dpal yon du srod kyi dus su rgyal po de ba ra dzas 'di skad lo //	14	grong khyer dpal yon du srod kyi dus su rgyal po de ba ra dzas di skad lo 
BO_TZ_DZOGCHEN-DESUM-P97:148	hoh snang srid thams cad ye nas kun tu bzang //	14	hoh snang srid thams cad ye nas kun tu bzang 
BO_TZ_DZOGCHEN-DESUM-P97:149	kun bzang gud na med de ma lus snying po'i rgyu //	14	kun bzang gud na med de ma lus snying po rgyu 
BO_TZ_DZOGCHEN-DESUM-P97:150	snang ba mtha' dag skye med bdud rtshi sku gsung thugs //	15	snang ba mtha dag skye med bdud rtshi sku gsung thugs 
BO_TZ_DZOGCHEN-DESUM-P97:151	skye med ngang las ma yengs mnyam bzhag pas //	15	skye med ngang las ma yengs mnyam jog ba 
BO_TZ_DZOGCHEN-DESUM-P97:152	bsgom par bya ba 'di las med par rtogs //	15	bsgom ba byed ba di las med ba rtogs 
BO_TZ_DZOGCHEN-DESUM-P97:153	lus ni sgyu ma'i phung po mi gtshang ste //	15	lus ni sgyu ma phung po mi gtshang ste 
BO_TZ_DZOGCHEN-DESUM-P97:154	sems ni ye shes chen por shar //	15	sems ni ye shes chen por char 
BO_TZ_DZOGCHEN-DESUM-P97:155	tshan+d+ra de wa ko sa la a hohnam mkha' rgyal po'i dgongs pa /	15	tshan+d+ra de wa ko sa la a hohnam mkha rgyal po dgongs ba 
BO_TZ_DZOGCHEN-DESUM-P97:156	grol ba klong rdol glu'i bsam gtan /	15	grol ba klong rdol glu bsam gtan 
BO_TZ_DZOGCHEN-DESUM-P97:157	me tog gi tshhal du nam gyi cha stod la /	15	me tog gi tshhal du nam gyi cha stod la 
BO_TZ_DZOGCHEN-DESUM-P97:158	d+harma ra dzas 'di skad do //	15	d+harma ra dzas di skad do 
BO_TZ_DZOGCHEN-DESUM-P97:159	hoh sems kyi rang bzhin ye nas mdzod chen las //	15	hoh sems kyi rang bzhin ye nas mdzod chen las 
BO_TZ_DZOGCHEN-DESUM-P97:160	gang ltar btags shing ci ltar snang ba kun //	16	gang ltar dogs shing ci ltar snang ba kun 
BO_TZ_DZOGCHEN-DESUM-P97:161	'byung 'jug thams cad ye nas kun tu bzang //	16	byung jug thams cad ye nas kun tu bzang 
BO_TZ_DZOGCHEN-DESUM-P97:162	de ltar gnyis su med pa'i rig pa de //	16	de ltar gnyis su med ba rig ba de 
BO_TZ_DZOGCHEN-DESUM-P97:163	kun tu bzang po'i sems la gnas //	16	kun tu bzang po sems la gnas 
BO_TZ_DZOGCHEN-DESUM-P97:164	rig pa'i dbyings la ma bslad pas //	16	rig ba dbyings la ma bslad ba 
BO_TZ_DZOGCHEN-DESUM-P97:165	bsgom zhing bzlas pa 'di las med //	16	bsgom zhing bzlas ba di las med 
BO_TZ_DZOGCHEN-DESUM-P97:166	kye ma ma rtogs snying re rje //	16	kye ma ma rtogs snying re rje 
BO_TZ_DZOGCHEN-DESUM-P97:167	e ma bdag nyid rang sar grol ba a la la //	16	e ma bdag nyid rang sar grol ba a la la 
BO_TZ_DZOGCHEN-DESUM-P97:168	d+ho ha ko pa sha a hohrje btshun dam pa'i dgongs pa /	16	d+ho ha ko ba sha a hohrje btshun dam ba dgongs ba 
BO_TZ_DZOGCHEN-DESUM-P97:169	shes rab klong rdol glu'i bsam gtan /	16	shes rab klong rdol glu bsam gtan 
BO_TZ_DZOGCHEN-DESUM-P97:170	dben pa chen po'i gnas su bud+d+ha gup+tas 'di skad lo //	17	dben ba chen po gnas su bud+d+ha gup+tas di skad lo 
BO_TZ_DZOGCHEN-DESUM-P97:171	hoh chos rnams byang chub sems ma bcos //	17	hoh chos rnams byang chub sems ma chos 
BO_TZ_DZOGCHEN-DESUM-P97:172	ye nas kun tu bzang po la //	17	ye nas kun tu bzang po la 
BO_TZ_DZOGCHEN-DESUM-P97:173	gsal la 'gyur ba med pa'i byang chub sems de la //	17	gsal la gyur ba med ba byang chub sems de la 
BO_TZ_DZOGCHEN-DESUM-P97:174	mtshhan ma'i rnam par rtog pas ma bslad de //	17	mtshhan ma rnam ba rtogs ba ma bslad de 
BO_TZ_DZOGCHEN-DESUM-P97:175	rnam rtog rang byung rang zhir gnas pa las //	17	rnam rtogs rang byung rang zhir gnas ba las 
BO_TZ_DZOGCHEN-DESUM-P97:176	gnyen pos sgom du med par 'khums //	17	gnyen pos sgom du med ba khums 
BO_TZ_DZOGCHEN-DESUM-P97:177	sems kyi me long ma bltas na //	17	sems kyi me long ma lta na 
BO_TZ_DZOGCHEN-DESUM-P97:178	rnam rtog dri mas gos ta re //	17	rnam rtogs dri mas gos ta re 
BO_TZ_DZOGCHEN-DESUM-P97:179	pradz+nya ko sa la a hoh	17	pradz+nya ko sa la a hoh 
BO_TZ_DZOGCHEN-DESUM-P97:180	skabs 'dir mkhas pa 'ga' zhig gi glu gter ma la cung zad 'dra min bzhugs pas de dag 'dir bka' ma ltar la cung zad bsdus te bkod pa'o //	18	skabs dir mkhas ba ga jig gi glu gter ma la cung zad dra min bzhugs ba de dag dir bka ma ltar la cung zad sdud te bkod ba 
BO_TZ_DZOGCHEN-DESUM-P97:181	nang skor nas /	18	nang skor nas 
BO_TZ_DZOGCHEN-DESUM-P97:182	bai ro mtshho rgyal khri srong g.yu sgra rnams kyi rdo rje'i glu blang pas sum cu rtsha gcig ste /	18	bai ro mtshho rgyal khri srong g.yu sgra rnams kyi rdo rje glu blang ba sum cu rtsha gcig ste 
BO_TZ_DZOGCHEN-DESUM-P97:183	de thams cad kyi sku gsung thugs kyi byin rlabs phog la rtogs pa bskyed pa'i mthar /	18	de thams cad kyi sku gsung thugs kyi byin rlabs bogs la rtogs ba skyed ba mthar 
BO_TZ_DZOGCHEN-DESUM-P97:184	rjes kyi shes pa gzung 'dzin gyi dri ma mtha' dag dang bral nas /	18	rjes kyi shes ba gzung dzin gyi dri ma mtha dag dang bral nas 
BO_TZ_DZOGCHEN-DESUM-P97:185	'gag med kyi rang rtshal 'khor 'das kyi snang ba cir snang ci srid cir shar yang ngos gzung las 'das pa'i rang rig yul med rang gsal gyi ngang la gnas pa med pa'i tshhul gyis gnas par bya'o /	18	gag med kyi rang rtshal khor da kyi snang ba cir snang ci srid cir char yang ngos gzung las da ba rang rig yul med rang gsal gyi ngang la gnas ba med ba tshhul gyis gnas ba byed 
BO_TZ_DZOGCHEN-DESUM-P97:186	/dpe ji ltar na /	18	ji ltar na 
BO_TZ_DZOGCHEN-DESUM-P97:187	g.yo sgyu dang bral ba'i mi lta bu ste /	18	g.yo sgyu dang bral ba mi lta bu ste 
BO_TZ_DZOGCHEN-DESUM-P97:188	ma bcos lhun grub kyi man ngag gis rig pa rtshal gyi dbang skur ba thob pa'i stobs kyis bslu mi srid de /	18	ma chos lhun grub kyi man ngag gis rig ba rtshal gyi dbang skur ba thob ba stobs kyis bslu mi srid de 
BO_TZ_DZOGCHEN-DESUM-P97:189	gnas lugs rang ngo shes /	18	gnas lugs rang ngo shes 
BO_TZ_DZOGCHEN-DESUM-P97:190	rang sa zin /	19	rang sa zin 
BO_TZ_DZOGCHEN-DESUM-P97:191	rang sar grol ba mtshhon pa'o //	19	rang sar grol ba mtshhon ba 
BO_TZ_DZOGCHEN-DESUM-P97:192	slob ma'i rna bar sbub mchu btshugs te /	19	slob ma rna ba sbub mchu btshugs te 
BO_TZ_DZOGCHEN-DESUM-P97:193	bum pa khungs gtor\u0f8e	19	bum ba khungs gtor\u0f8e 
BO_TZ_DZOGCHEN-DESUM-P97:194	btshal du med pa'o :	19	btshal du med ba 
BO_TZ_DZOGCHEN-DESUM-P97:195	zhes brjod / slar yang snying dang 'dra ba'i slob ma gcig la sbyin pa'i chig brgyud ni /	19	zhes rjod slar yang snying dang dra ba slob ma gcig la sbyin ba chig brgyud ni 
BO_TZ_DZOGCHEN-DESUM-P97:196	zhes bskul la slob dpon 'bol stan dgu brtshegs su gnas pa'i steng nas slob ma'i rna bar sbub mchu btshugs te /	19	zhes skul la slob dpon bol stan dgu brtshegs su gnas ba steng nas slob ma rna ba sbub mchu btshugs te 
BO_TZ_DZOGCHEN-DESUM-P97:197	dang po thug sa sogs tshhig rkang gsum lan gsum brjod /	19	dang po thug sa sogs tshhig rkang gsum lan gsum rjod 
BO_TZ_DZOGCHEN-DESUM-P97:198	de lta bu'i sngon 'gro byin rlabs kyi rim pa song nas /	19	de lta bu sngon gro byin rlabs kyi rim ba gro nas 
BO_TZ_DZOGCHEN-DESUM-P97:199	gdams ngag gi dgongs 'grel dngos gzhi khrid kyi rim pa stong nyid chos dbyings khyab brdal gyi gdams pa bshad pa ni /	19	doms ngag gi dgongs grel dngos gzhi khrid kyi rim ba stong nyid chos dbyings khyab rdal gyi doms ba chad ba ni 
BO_TZ_DZOGCHEN-DESUM-P97:200	slob dpon gyis tshhig dal la skabs phyed pas /	20	slob dpon gyis tshhig dal la skabs phyed ba 
BO_TZ_DZOGCHEN-DESUM-P97:201	phyi skor dngos gzhi'i khrid rim ltar /	20	phyi skor dngos gzhi khrid rim ltar 
BO_TZ_DZOGCHEN-DESUM-P97:202	dang po thug sa\u0f8e	20	dang po thug sa\u0f8e 
BO_TZ_DZOGCHEN-DESUM-P97:203	'bras bu'o : zhes pa'i rjes su dngos gzhi'i khrid kyi bsdus don ltar /	20	bras bu zhes ba rjes su dngos gzhi khrid kyi sdud don ltar 
BO_TZ_DZOGCHEN-DESUM-P97:204	phyi skor khrid kyi rjes 'brel dgongs pa rang gsal lta ba klong yang ston pa la /	20	phyi skor khrid kyi rjes brel dgongs ba rang gsal lta ba klong yang ston ba la 
BO_TZ_DZOGCHEN-DESUM-P97:205	lta sgom spyod gsum\u0f8e	20	lta sgom spyod gsum\u0f8e 
BO_TZ_DZOGCHEN-DESUM-P97:206	grub pa 'o :	20	grub ba mang 
BO_TZ_DZOGCHEN-DESUM-P97:207	zhes pa'i bar bshad /	20	zhes ba ba chad 
BO_TZ_DZOGCHEN-DESUM-P97:208	de ltar bsgom bya sgom byed bral ba'i ngang la gnas pa med pa'i tshhul gyis gnas pas /	20	de ltar bsgom byed sgom byed bral ba ngang la gnas ba med ba tshhul gyis gnas ba 
BO_TZ_DZOGCHEN-DESUM-P97:209	rang bzhin gyi gnas lugs rgyu rkyen med par /	20	rang bzhin gyi gnas lugs rgyu rkyen med ba 
BO_TZ_DZOGCHEN-DESUM-P97:210	byed pa po med par lhun gyis grub pas blang ba med cing dor ba med pa'i phyir /	21	byed ba po med ba lhun gyis grub ba blang ba med cing dor ba med ba phyir 
BO_TZ_DZOGCHEN-DESUM-P97:211	kun tu bzang po zhes tha snyad du btags te /	21	kun tu bzang po zhes tha snyad du dogs te 
BO_TZ_DZOGCHEN-DESUM-P97:212	rang byung gi ye shes thig le nyag cig sgra ji bzhin pa ma yin pa /	21	rang byung gi ye shes thig le nyag cig sgra ji bzhin ba ma yin ba 
BO_TZ_DZOGCHEN-DESUM-P97:213	don thun mong min pa /	21	don thun mong min ba 
BO_TZ_DZOGCHEN-DESUM-P97:214	dgos ched kyi dbang gis ji ltar btags kyang /	21	dgos ched kyi dbang gis ji ltar dogs kyang 
BO_TZ_DZOGCHEN-DESUM-P97:215	'khor 'das kyi chos thams cad de bzhin nyid dang gzhan du brjod du med par thag chod na dbang thams cad rdzogs pa yin no //	21	khor da kyi chos thams cad de bzhin nyid dang gzhan du rjod du med ba thag chod na dbang thams cad rdzogs ba yin no 
BO_TZ_DZOGCHEN-DESUM-P97:216	zhes rtogs pa bskyed /	21	zhes rtogs ba skyed 
BO_TZ_DZOGCHEN-DESUM-P97:217	de ltar dbang bskur rdzogs par gyur pa la sogs shis brjod kyi mtshhams sbyar /	21	de ltar dbang skur rdzogs ba gyur ba la sogs shis rjod kyi mtshhams sbyor 
BO_TZ_DZOGCHEN-DESUM-P97:218	! mchog sprul o rgyan rin po che'i thugs dam sde gsum phyag dpe 'bral spang lta bu'i nang /	21	mchog sprul o rgyan rin po che thugs dam sde gsum phyag dpe bral spong lta bu nang 
BO_TZ_DZOGCHEN-DESUM-P97:219	rje chos blo'i phyag bris yin nges su 'di ltar bzhugs pa zhal bshus pa'o ///	21	rje chos blo phyag bri yin nges su di ltar bzhugs ba zhal bshus ba 
